;competencia;municipio;secao;subclasse;admitidos;desligados;saldo
208;202007;352590;C;2229399;0;1;-1
400;202007;352590;G;4751201;3;1;2
1109;202007;352590;Q;8640202;3;0;3
2025;202007;352590;G;4772500;1;0;1
2245;202007;352590;C;2599399;27;7;20
2253;202007;352590;G;4771701;0;1;-1
2431;202007;352590;G;4744005;1;0;1
2871;202007;352590;C;2812700;2;1;1
3268;202007;352590;C;2222600;0;1;-1
3285;202007;352590;C;1629301;0;1;-1
3380;202007;352590;C;2949299;1;6;-5
3976;202007;352590;N;7911200;0;1;-1
4183;202007;352590;C;2040100;4;9;-5
4283;202007;352590;N;7739099;2;2;0
4339;202007;352590;H;4924800;0;1;-1
4358;202007;352590;N;7810800;26;13;13
4511;202007;352590;K;6622300;2;1;1
5460;202007;352590;C;1732000;8;3;5
5910;202007;352590;G;4753900;14;1;13
6403;202007;352590;C;2229303;0;1;-1
6851;202007;352590;C;2710402;0;2;-2
6886;202007;352590;G;4712100;1;0;1
7230;202007;352590;Q;8711502;0;1;-1
7388;202007;352590;I;5620102;0;1;-1
7638;202007;352590;J;5829800;0;1;-1
8710;202007;352590;G;4530703;0;1;-1
8744;202007;352590;G;4789099;1;0;1
9330;202007;352590;N;8299706;1;2;-1
9756;202007;352590;G;4530703;1;1;0
9982;202007;352590;H;5211799;8;5;3
10456;202007;352590;G;4772500;0;1;-1
10649;202007;352590;G;4530703;0;1;-1
10671;202007;352590;I;5611203;0;1;-1
10758;202007;352590;Q;8610101;1;6;-5
11220;202007;352590;C;1610201;0;1;-1
11880;202007;352590;G;4771702;1;2;-1
11884;202007;352590;H;4929902;10;0;10
11898;202007;352590;R;9313100;0;5;-5
12022;202007;352590;S;9601703;1;1;0
12026;202007;352590;S;9601703;12;25;-13
12268;202007;352590;C;1413401;1;0;1
12587;202007;352590;C;2651500;0;1;-1
12645;202007;352590;C;2341900;2;0;2
12987;202007;352590;G;4789099;2;0;2
13106;202007;352590;J;6319400;0;2;-2
14017;202007;352590;P;8511200;1;2;-1
14018;202007;352590;Q;8640299;2;0;2
14213;202007;352590;H;5229002;1;0;1
14475;202007;352590;G;4755502;1;1;0
14715;202007;352590;S;9601701;0;1;-1
14905;202007;352590;M;6920601;0;2;-2
14920;202007;352590;G;4753900;0;1;-1
15253;202007;352590;G;4781400;0;1;-1
15726;202007;352590;C;2731700;0;3;-3
15830;202007;352590;G;4693100;17;5;12
15880;202007;352590;G;4511101;5;2;3
16024;202007;352590;N;8230001;1;0;1
16511;202007;352590;G;4644301;31;22;9
16579;202007;352590;M;7112000;2;4;-2
17088;202007;352590;H;5250804;0;1;-1
17226;202007;352590;K;6424703;0;1;-1
17313;202007;352590;G;4752100;2;0;2
17328;202007;352590;I;5611201;0;1;-1
17376;202007;352590;C;1031700;0;1;-1
17705;202007;352590;F;4330499;0;2;-2
17732;202007;352590;N;8299701;1;4;-3
18810;202007;352590;G;4724500;0;2;-2
19283;202007;352590;C;2229302;0;1;-1
19332;202007;352590;G;4781400;0;1;-1
19455;202007;352590;N;8299799;2;0;2
20033;202007;352590;C;2822402;1;2;-1
20377;202007;352590;C;3102100;3;2;1
20754;202007;352590;H;4930203;23;7;16
20758;202007;352590;H;4930202;0;2;-2
20954;202007;352590;I;5510803;1;1;0
20989;202007;352590;G;4689301;1;1;0
21000;202007;352590;M;6920601;0;1;-1
21001;202007;352590;Q;8640299;1;2;-1
21010;202007;352590;F;4329104;3;2;1
21308;202007;352590;G;4751201;0;1;-1
21959;202007;352590;Q;8630503;1;1;0
22182;202007;352590;G;4649499;0;2;-2
23222;202007;352590;H;4930202;9;1;8
23401;202007;352590;C;1062700;1;1;0
23450;202007;352590;M;6920601;1;0;1
23799;202007;352590;G;4789099;1;0;1
24014;202007;352590;C;1081302;2;0;2
24481;202007;352590;M;6920601;2;0;2
24507;202007;352590;G;4755502;1;1;0
24538;202007;352590;H;5250804;0;1;-1
24950;202007;352590;C;3250705;1;1;0
25169;202007;352590;G;4721104;1;0;1
25274;202007;352590;C;3101200;0;1;-1
25609;202007;352590;G;4687703;0;1;-1
26014;202007;352590;P;8512100;2;3;-1
26096;202007;352590;N;8211300;12;15;-3
26097;202007;352590;G;4634601;4;10;-6
26674;202007;352590;C;2219600;2;0;2
26732;202007;352590;G;4712100;1;1;0
26826;202007;352590;C;2222600;1;0;1
27590;202007;352590;I;5611201;0;1;-1
28242;202007;352590;I;5611201;0;1;-1
29120;202007;352590;G;4530702;0;2;-2
29319;202007;352590;G;4687703;1;0;1
29494;202007;352590;C;2599399;0;2;-2
29598;202007;352590;S;9430800;1;0;1
29757;202007;352590;C;2640000;1;0;1
30253;202007;352590;G;4637106;0;1;-1
30839;202007;352590;F;4313400;0;24;-24
31377;202007;352590;G;4731800;0;2;-2
32035;202007;352590;G;4639701;4;1;3
32050;202007;352590;C;2539001;1;3;-2
32621;202007;352590;G;4751201;0;1;-1
32662;202007;352590;G;4771701;1;1;0
32909;202007;352590;P;8511200;0;1;-1
33697;202007;352590;C;1081302;5;13;-8
33906;202007;352590;N;8011101;4;1;3
34221;202007;352590;C;1721400;6;4;2
34420;202007;352590;B;810007;1;0;1
34623;202007;352590;N;8211300;0;1;-1
34706;202007;352590;G;4744001;0;1;-1
35142;202007;352590;F;4110700;1;0;1
35477;202007;352590;C;1340501;0;1;-1
35584;202007;352590;F;4120400;1;0;1
35656;202007;352590;G;4511101;0;1;-1
35688;202007;352590;H;5221400;18;32;-14
35779;202007;352590;C;2941700;0;1;-1
36503;202007;352590;G;4784900;1;2;-1
36599;202007;352590;G;4619200;1;0;1
36657;202007;352590;G;4789099;1;0;1
36972;202007;352590;C;2751100;3;2;1
37404;202007;352590;G;4673700;0;1;-1
37439;202007;352590;I;5611203;0;1;-1
37976;202007;352590;G;4530703;0;1;-1
38877;202007;352590;H;4930202;1;0;1
38925;202007;352590;S;9430800;1;1;0
39051;202007;352590;Q;8630502;1;0;1
39095;202007;352590;C;3329501;1;0;1
40043;202007;352590;N;7820500;1;2;-1
40103;202007;352590;G;4511101;0;1;-1
40370;202007;352590;G;4511101;0;1;-1
40387;202007;352590;Q;8640205;1;0;1
40485;202007;352590;G;4511102;0;1;-1
40530;202007;352590;C;2219600;1;0;1
41008;202007;352590;G;4789099;0;1;-1
41243;202007;352590;C;2091600;2;5;-3
41387;202007;352590;P;8512100;0;19;-19
41590;202007;352590;F;4211101;0;2;-2
41907;202007;352590;H;4930202;16;9;7
41936;202007;352590;Q;8800600;0;2;-2
41982;202007;352590;G;4721102;2;0;2
42278;202007;352590;H;5211799;5;3;2
42453;202007;352590;N;8211300;2;2;0
43346;202007;352590;H;4930202;0;1;-1
43804;202007;352590;C;1013901;30;13;17
43852;202007;352590;G;4722901;0;1;-1
44310;202007;352590;G;4754701;1;0;1
44316;202007;352590;G;4754701;2;0;2
44319;202007;352590;G;4754701;0;1;-1
44477;202007;352590;H;5223100;2;0;2
44700;202007;352590;L;6821802;1;0;1
44767;202007;352590;G;4781400;0;1;-1
44845;202007;352590;C;3314799;0;1;-1
44913;202007;352590;G;4789099;2;0;2
45626;202007;352590;G;4511102;0;1;-1
45763;202007;352590;G;4781400;0;1;-1
45893;202007;352590;C;3312103;0;3;-3
46025;202007;352590;G;4741500;1;0;1
46244;202007;352590;H;4930202;1;0;1
46314;202007;352590;G;4782201;0;1;-1
46672;202007;352590;H;4930202;9;5;4
46988;202007;352590;M;7119701;1;0;1
46992;202007;352590;G;4789099;1;0;1
47080;202007;352590;N;8121400;12;10;2
47149;202007;352590;N;8291100;0;2;-2
47388;202007;352590;C;2222600;5;4;1
47672;202007;352590;G;4771701;1;0;1
48133;202007;352590;G;4689399;1;0;1
48591;202007;352590;G;4639701;1;0;1
49147;202007;352590;F;4330499;0;1;-1
49148;202007;352590;F;4330499;2;2;0
49228;202007;352590;G;4729699;0;1;-1
49578;202007;352590;G;4633801;0;1;-1
50507;202007;352590;G;4646001;1;7;-6
50730;202007;352590;N;8299706;0;1;-1
51009;202007;352590;I;5620101;1;0;1
51020;202007;352590;Q;8720401;7;11;-4
51112;202007;352590;G;4754703;0;1;-1
52113;202007;352590;G;4789099;0;1;-1
52472;202007;352590;C;2811900;1;0;1
52745;202007;352590;S;9430800;0;1;-1
52781;202007;352590;P;8513900;0;1;-1
53498;202007;352590;G;4744099;0;1;-1
53531;202007;352590;G;4781400;0;2;-2
54346;202007;352590;G;4711302;1;0;1
54687;202007;352590;G;4754701;1;0;1
54760;202007;352590;F;4391600;0;2;-2
55314;202007;352590;G;4633801;0;1;-1
55510;202007;352590;G;4520005;1;0;1
56394;202007;352590;I;5611203;0;1;-1
56646;202007;352590;C;1093702;3;0;3
56698;202007;352590;I;5611201;0;1;-1
57003;202007;352590;N;7820500;447;168;279
58153;202007;352590;Q;8800600;0;2;-2
58298;202007;352590;G;4751201;2;1;1
58696;202007;352590;H;4930202;3;1;2
58770;202007;352590;N;8299706;1;0;1
58971;202007;352590;P;8599699;0;1;-1
59272;202007;352590;N;7820500;263;443;-180
60113;202007;352590;P;8512100;0;1;-1
60228;202007;352590;P;8599699;0;1;-1
60509;202007;352590;P;8599699;1;0;1
60525;202007;352590;P;8599699;0;1;-1
60526;202007;352590;P;8599699;2;0;2
60697;202007;352590;Q;8630502;0;1;-1
60750;202007;352590;F;4399199;1;0;1
61340;202007;352590;G;4633801;0;2;-2
61607;202007;352590;N;8129000;41;67;-26
61663;202007;352590;G;4744005;0;3;-3
61707;202007;352590;C;2222600;0;5;-5
61724;202007;352590;C;2439300;0;1;-1
62083;202007;352590;G;4721104;1;0;1
62356;202007;352590;H;4930202;1;2;-1
62357;202007;352590;H;4930202;13;9;4
62456;202007;352590;G;4731800;0;1;-1
62600;202007;352590;H;5120000;0;1;-1
63280;202007;352590;G;4637106;7;3;4
63727;202007;352590;G;4744005;0;1;-1
63985;202007;352590;M;6920601;1;0;1
64423;202007;352590;I;5510803;2;1;1
65280;202007;352590;G;4649499;1;0;1
65630;202007;352590;N;8211300;0;1;-1
65855;202007;352590;N;8291100;0;2;-2
66305;202007;352590;G;4530703;2;0;2
66648;202007;352590;G;4672900;6;5;1
66721;202007;352590;I;5611201;6;8;-2
66919;202007;352590;N;8299799;4;6;-2
66920;202007;352590;N;8299799;0;4;-4
66961;202007;352590;Q;8711502;1;5;-4
67367;202007;352590;N;7820500;1;0;1
67761;202007;352590;F;4120400;5;0;5
67958;202007;352590;D;3514000;10;1;9
69129;202007;352590;H;4930201;3;1;2
69216;202007;352590;J;6209100;0;1;-1
69643;202007;352590;H;5112901;2;2;0
70370;202007;352590;P;8593700;0;2;-2
70383;202007;352590;G;4723700;0;1;-1
70406;202007;352590;G;4781400;1;0;1
70546;202007;352590;P;8532500;0;5;-5
70633;202007;352590;P;8599699;3;9;-6
71043;202007;352590;G;4541202;1;0;1
71392;202007;352590;C;3314707;3;0;3
73040;202007;352590;N;7711000;0;1;-1
73242;202007;352590;F;4299599;25;5;20
73621;202007;352590;Q;8640210;0;1;-1
74044;202007;352590;M;7112000;1;0;1
74097;202007;352590;C;2599399;0;2;-2
74119;202007;352590;G;4639701;9;9;0
74619;202007;352590;G;4789001;1;0;1
75230;202007;352590;N;8219999;0;1;-1
75636;202007;352590;N;8299799;1;3;-2
76071;202007;352590;I;5620101;2;0;2
77300;202007;352590;P;8512100;0;1;-1
78000;202007;352590;H;5250804;15;15;0
78184;202007;352590;G;4789002;1;0;1
78210;202007;352590;G;4789099;0;1;-1
78291;202007;352590;N;8211300;0;2;-2
78299;202007;352590;C;3321000;1;2;-1
79553;202007;352590;H;4930202;0;1;-1
79933;202007;352590;C;2399199;0;1;-1
80304;202007;352590;F;4399105;2;1;1
80583;202007;352590;G;4520001;1;0;1
80686;202007;352590;E;3600602;0;1;-1
80764;202007;352590;K;6622300;0;2;-2
81039;202007;352590;Q;8650099;9;7;2
81215;202007;352590;G;4789007;0;1;-1
81235;202007;352590;C;2949299;0;3;-3
81308;202007;352590;G;4753900;1;1;0
81678;202007;352590;F;4120400;0;1;-1
82057;202007;352590;J;6202300;0;1;-1
83195;202007;352590;H;4930201;14;1;13
83271;202007;352590;M;6920601;0;1;-1
83281;202007;352590;G;4771701;1;1;0
83474;202007;352590;N;7810800;0;1;-1
84083;202007;352590;C;2222600;2;2;0
84101;202007;352590;C;1032599;1;0;1
84316;202007;352590;N;8299799;0;1;-1
84692;202007;352590;G;4712100;2;0;2
84982;202007;352590;I;5611201;0;1;-1
85314;202007;352590;G;4511101;1;0;1
85755;202007;352590;C;2424501;2;1;1
86299;202007;352590;G;4672900;1;0;1
86335;202007;352590;Q;8630501;0;1;-1
87124;202007;352590;G;4520002;1;1;0
87202;202007;352590;S;9430800;3;1;2
88037;202007;352590;S;9601701;0;1;-1
88280;202007;352590;H;4930202;0;1;-1
88432;202007;352590;G;4729699;1;0;1
88982;202007;352590;N;8299706;0;1;-1
89211;202007;352590;N;8112500;1;0;1
89784;202007;352590;I;5611201;0;2;-2
90236;202007;352590;G;4530703;8;2;6
90254;202007;352590;F;4110700;1;0;1
90261;202007;352590;C;2950600;1;0;1
90363;202007;352590;Q;8640205;0;1;-1
90393;202007;352590;G;4687701;0;1;-1
90494;202007;352590;H;4930202;4;1;3
90657;202007;352590;G;4731800;1;0;1
90671;202007;352590;F;4313400;1;1;0
90683;202007;352590;G;4784900;3;0;3
90914;202007;352590;I;5611203;0;1;-1
91020;202007;352590;G;4723700;0;2;-2
91089;202007;352590;F;4313400;0;17;-17
91138;202007;352590;P;8512100;2;1;1
91214;202007;352590;G;4511101;4;6;-2
91830;202007;352590;I;5611201;1;3;-2
92832;202007;352590;J;6201501;4;0;4
93338;202007;352590;G;4687703;0;1;-1
93582;202007;352590;N;8112500;1;0;1
93958;202007;352590;G;4722901;1;0;1
94012;202007;352590;N;7820500;150;86;64
94212;202007;352590;L;6810201;0;1;-1
94293;202007;352590;I;5620101;0;1;-1
94912;202007;352590;Q;8712300;5;6;-1
94978;202007;352590;N;8299799;0;1;-1
95493;202007;352590;J;6202300;1;0;1
96018;202007;352590;G;4755502;0;1;-1
96045;202007;352590;M;6920601;1;0;1
96652;202007;352590;G;4731800;0;1;-1
97091;202007;352590;M;7311400;0;1;-1
97478;202007;352590;G;4639701;1;0;1
97622;202007;352590;G;4633801;0;1;-1
98018;202007;352590;P;8511200;0;5;-5
98555;202007;352590;Q;8630503;0;1;-1
98806;202007;352590;I;5611201;0;1;-1
98811;202007;352590;N;8299799;1;1;0
99178;202007;352590;G;4744099;0;1;-1
99180;202007;352590;M;6920601;1;0;1
100205;202007;352590;G;4711302;13;4;9
100235;202007;352590;G;4774100;2;0;2
100236;202007;352590;G;4774100;2;0;2
100438;202007;352590;G;4649499;0;1;-1
100481;202007;352590;G;4771701;0;2;-2
100488;202007;352590;M;6920601;1;1;0
100782;202007;352590;G;4751201;0;1;-1
101598;202007;352590;M;6920601;1;2;-1
101723;202007;352590;G;4686902;1;1;0
102039;202007;352590;C;2825900;1;0;1
102209;202007;352590;H;4929902;1;1;0
102390;202007;352590;M;7500100;2;1;1
102762;202007;352590;G;4741500;0;1;-1
102982;202007;352590;C;2399101;0;1;-1
102984;202007;352590;G;4530703;0;1;-1
103366;202007;352590;G;4759899;0;1;-1
103373;202007;352590;G;4649499;0;2;-2
103454;202007;352590;G;4761001;1;0;1
103511;202007;352590;G;4744099;1;1;0
103581;202007;352590;G;4520001;0;2;-2
103989;202007;352590;G;4753900;2;0;2
104011;202007;352590;G;4744002;1;0;1
104584;202007;352590;C;1099699;1;1;0
104804;202007;352590;G;4645101;2;0;2
105005;202007;352590;F;4120400;1;0;1
105526;202007;352590;G;4711302;19;2;17
105660;202007;352590;G;4711301;181;14;167
105948;202007;352590;G;4689399;0;1;-1
105980;202007;352590;G;4754702;1;1;0
106314;202007;352590;C;2829199;1;1;0
106352;202007;352590;G;4530703;1;0;1
106359;202007;352590;I;5611203;0;1;-1
106570;202007;352590;P;8531700;0;1;-1
106936;202007;352590;Q;8650004;0;1;-1
107224;202007;352590;G;4744002;1;0;1
107675;202007;352590;C;2591800;1;5;-4
108372;202007;352590;G;4530703;1;0;1
109293;202007;352590;C;2542000;0;1;-1
109467;202007;352590;F;4120400;5;1;4
109596;202007;352590;L;6821801;0;1;-1
109755;202007;352590;G;4530703;0;1;-1
109794;202007;352590;G;4789001;1;0;1
109847;202007;352590;F;4313400;6;13;-7
110610;202007;352590;G;4781400;0;1;-1
111556;202007;352590;G;4712100;4;2;2
111690;202007;352590;G;4789002;0;1;-1
112005;202007;352590;G;4763602;5;0;5
112280;202007;352590;H;4930202;4;3;1
113009;202007;352590;J;6209100;0;1;-1
114290;202007;352590;C;2391503;0;1;-1
114321;202007;352590;M;6911703;0;1;-1
114347;202007;352590;N;8299799;0;5;-5
114414;202007;352590;F;4120400;0;1;-1
114495;202007;352590;G;4530703;0;1;-1
115077;202007;352590;G;4652400;0;8;-8
115509;202007;352590;H;5250804;2;0;2
115653;202007;352590;F;4330401;0;1;-1
115894;202007;352590;C;2710402;3;0;3
116042;202007;352590;G;4633801;1;0;1
116043;202007;352590;G;4633801;0;1;-1
116064;202007;352590;G;4711302;22;15;7
117405;202007;352590;G;4763603;2;0;2
117447;202007;352590;G;4731800;1;1;0
117846;202007;352590;N;8011101;4;10;-6
118533;202007;352590;K;6424703;1;0;1
119295;202007;352590;N;8211300;5;5;0
119428;202007;352590;G;4729699;1;2;-1
119575;202007;352590;G;4530703;1;0;1
119965;202007;352590;G;4781400;7;7;0
120371;202007;352590;G;4530703;1;0;1
120408;202007;352590;C;2790299;8;4;4
120427;202007;352590;M;7500100;0;1;-1
120460;202007;352590;N;7820500;1;0;1
120969;202007;352590;K;6619302;0;1;-1
121226;202007;352590;N;8299799;1;0;1
121260;202007;352590;C;1053800;4;0;4
121397;202007;352590;Q;8630501;4;4;0
121739;202007;352590;G;4633801;12;7;5
122554;202007;352590;G;4781400;2;0;2
123604;202007;352590;N;8111700;4;1;3
124085;202007;352590;F;4299599;4;1;3
124095;202007;352590;G;4520005;0;1;-1
124097;202007;352590;F;4299599;1;4;-3
124260;202007;352590;G;4713002;0;1;-1
124339;202007;352590;C;2071100;1;1;0
124579;202007;352590;G;4731800;2;1;1
124640;202007;352590;G;4781400;1;0;1
124928;202007;352590;S;9430800;0;3;-3
124935;202007;352590;G;4530703;1;0;1
125343;202007;352590;N;8112500;1;1;0
125396;202007;352590;P;8520100;1;2;-1
125474;202007;352590;G;4771701;0;2;-2
125476;202007;352590;G;4771701;1;1;0
125659;202007;352590;C;2759799;0;1;-1
126713;202007;352590;G;4744003;1;0;1
127061;202007;352590;H;4930202;0;1;-1
127669;202007;352590;H;4930202;0;1;-1
127670;202007;352590;H;4930202;1;0;1
127707;202007;352590;G;4741500;0;2;-2
127708;202007;352590;G;4741500;1;0;1
127709;202007;352590;G;4741500;0;1;-1
127710;202007;352590;G;4741500;0;1;-1
127727;202007;352590;G;4731800;3;3;0
127944;202007;352590;C;2029100;0;12;-12
127966;202007;352590;G;4635402;2;0;2
128381;202007;352590;I;5620104;1;0;1
128385;202007;352590;H;4930202;1;0;1
128659;202007;352590;G;4520004;0;1;-1
129174;202007;352590;H;4930202;11;2;9
129301;202007;352590;G;4789005;1;0;1
129624;202007;352590;G;4520001;0;1;-1
129626;202007;352590;Q;8650004;0;1;-1
129629;202007;352590;G;4754703;0;1;-1
129667;202007;352590;I;5611203;0;3;-3
129742;202007;352590;G;4520005;0;1;-1
130797;202007;352590;N;8112500;0;1;-1
130832;202007;352590;P;8512100;0;2;-2
130833;202007;352590;P;8511200;0;1;-1
131384;202007;352590;C;1091102;0;1;-1
131391;202007;352590;J;6201501;2;1;1
132043;202007;352590;P;8520100;0;4;-4
132231;202007;352590;J;6203100;0;2;-2
132418;202007;352590;P;8599602;0;1;-1
132431;202007;352590;G;4781400;0;1;-1
132559;202007;352590;P;8599604;0;1;-1
133041;202007;352590;N;8112500;2;0;2
133065;202007;352590;C;1053800;6;1;5
133386;202007;352590;H;4930201;0;2;-2
133474;202007;352590;G;4754702;2;0;2
133498;202007;352590;N;8112500;1;1;0
134272;202007;352590;G;4712100;0;1;-1
134357;202007;352590;C;1099601;0;1;-1
134463;202007;352590;G;4530703;0;1;-1
134698;202007;352590;C;1042200;0;1;-1
134796;202007;352590;P;8513900;0;2;-2
134797;202007;352590;P;8513900;1;0;1
135184;202007;352590;H;4930202;0;2;-2
135185;202007;352590;I;5510801;0;1;-1
135306;202007;352590;I;5611201;0;1;-1
135499;202007;352590;G;4617600;2;0;2
135926;202007;352590;N;7911200;0;2;-2
136130;202007;352590;K;6619399;1;0;1
136618;202007;352590;J;6190699;1;0;1
136655;202007;352590;C;1062700;0;1;-1
137081;202007;352590;G;4511101;0;1;-1
138289;202007;352590;N;8130300;1;0;1
138297;202007;352590;M;7020400;0;1;-1
138708;202007;352590;G;4782201;0;1;-1
139447;202007;352590;S;9609208;0;1;-1
139561;202007;352590;I;5611203;0;1;-1
139990;202007;352590;G;4753900;8;0;8
139991;202007;352590;G;4753900;3;0;3
140524;202007;352590;H;4930202;1;0;1
140559;202007;352590;Q;8630503;0;1;-1
140734;202007;352590;G;4639701;2;1;1
141206;202007;352590;G;4721104;1;0;1
141209;202007;352590;G;4530703;0;1;-1
141649;202007;352590;G;4751201;1;0;1
142159;202007;352590;M;7490104;0;1;-1
142591;202007;352590;C;2621300;25;16;9
142592;202007;352590;C;2632900;70;55;15
142648;202007;352590;N;8299799;55;76;-21
143927;202007;352590;C;1096100;1;0;1
143983;202007;352590;H;5212500;3;5;-2
144316;202007;352590;H;4930201;1;2;-1
144874;202007;352590;H;5112901;3;0;3
145037;202007;352590;P;8599604;1;0;1
145331;202007;352590;G;4731800;0;1;-1
145735;202007;352590;N;7732201;1;0;1
146077;202007;352590;N;7830200;1;0;1
146437;202007;352590;C;3313999;0;1;-1
146480;202007;352590;G;4781400;0;1;-1
146872;202007;352590;J;6201501;4;0;4
147451;202007;352590;H;4930202;2;2;0
147500;202007;352590;G;4530703;0;1;-1
148492;202007;352590;Q;8630501;2;1;1
148910;202007;352590;F;4120400;0;2;-2
148993;202007;352590;G;4712100;0;1;-1
149661;202007;352590;G;4744001;2;2;0
150296;202007;352590;P;8512100;1;1;0
150363;202007;352590;G;4772500;0;1;-1
150788;202007;352590;F;4213800;4;0;4
151025;202007;352590;G;4530703;1;0;1
151249;202007;352590;G;4729699;2;1;1
151482;202007;352590;G;4663000;0;3;-3
151543;202007;352590;I;5611203;0;1;-1
151616;202007;352590;H;5212500;14;16;-2
151623;202007;352590;G;4729699;0;1;-1
151696;202007;352590;N;8111700;4;5;-1
152574;202007;352590;N;7820500;5;2;3
152627;202007;352590;G;4511101;2;1;1
153140;202007;352590;G;4752100;0;1;-1
153154;202007;352590;G;4754701;3;0;3
153281;202007;352590;C;2093200;1;1;0
153899;202007;352590;H;4930202;2;0;2
154340;202007;352590;Q;8711502;0;1;-1
154421;202007;352590;G;4729699;0;5;-5
154507;202007;352590;F;4120400;0;2;-2
154931;202007;352590;P;8599603;1;0;1
155329;202007;352590;G;4520002;0;3;-3
155886;202007;352590;F;4222701;0;4;-4
156082;202007;352590;G;4789099;2;0;2
156267;202007;352590;G;4686902;2;4;-2
156587;202007;352590;G;4743100;5;0;5
156729;202007;352590;Q;8711502;3;0;3
157264;202007;352590;I;5611203;0;1;-1
157321;202007;352590;C;2222600;0;1;-1
157975;202007;352590;G;4511101;3;4;-1
158338;202007;352590;G;4669901;1;0;1
159092;202007;352590;G;4774100;1;0;1
159145;202007;352590;P;8591100;0;2;-2
159301;202007;352590;I;5611201;0;1;-1
159410;202007;352590;N;8111700;1;2;-1
159768;202007;352590;G;4754701;30;5;25
159772;202007;352590;G;4754701;6;0;6
160271;202007;352590;G;4530703;0;1;-1
160518;202007;352590;H;4930203;0;1;-1
160898;202007;352590;I;5611201;1;9;-8
160981;202007;352590;H;5223100;0;1;-1
161249;202007;352590;I;5611201;0;1;-1
161278;202007;352590;G;4731800;0;1;-1
161356;202007;352590;G;4763603;1;0;1
161362;202007;352590;I;5611201;1;0;1
162402;202007;352590;G;4731800;0;1;-1
162900;202007;352590;F;4330404;2;1;1
162902;202007;352590;N;7830200;22;19;3
163537;202007;352590;S;9521500;0;1;-1
163843;202007;352590;M;7112000;4;6;-2
163844;202007;352590;J;6204000;1;7;-6
164227;202007;352590;J;6311900;2;0;2
164949;202007;352590;K;6622300;1;0;1
165199;202007;352590;G;4771701;1;0;1
165423;202007;352590;C;1830003;0;1;-1
165753;202007;352590;C;3319800;1;0;1
165825;202007;352590;G;4722901;0;1;-1
165913;202007;352590;I;5611201;6;4;2
166370;202007;352590;H;4930202;0;2;-2
166843;202007;352590;I;5611201;0;1;-1
167095;202007;352590;G;4711302;2;0;2
167832;202007;352590;Q;8610101;3;7;-4
168322;202007;352590;G;4724500;5;19;-14
168323;202007;352590;G;4633801;1;0;1
168324;202007;352590;G;4724500;10;18;-8
168934;202007;352590;H;4930202;0;1;-1
169317;202007;352590;M;7500100;0;1;-1
169830;202007;352590;C;2812700;1;0;1
169959;202007;352590;F;4120400;0;1;-1
170077;202007;352590;G;4721102;1;1;0
170158;202007;352590;J;5914600;0;1;-1
170894;202007;352590;I;5510801;0;1;-1
170897;202007;352590;I;5510801;0;2;-2
171036;202007;352590;H;5250805;0;2;-2
171074;202007;352590;C;2621300;1;16;-15
171099;202007;352590;G;4781400;2;0;2
171284;202007;352590;G;4772500;0;1;-1
171519;202007;352590;G;4691500;8;2;6
171856;202007;352590;C;3291400;1;0;1
172437;202007;352590;G;4635402;0;1;-1
172648;202007;352590;F;4399103;1;0;1
172683;202007;352590;C;2511000;1;6;-5
172780;202007;352590;G;4731800;1;0;1
173484;202007;352590;N;7732201;0;1;-1
174008;202007;352590;M;6920601;1;0;1
174136;202007;352590;I;5611201;0;1;-1
174428;202007;352590;N;8299799;1;1;0
174579;202007;352590;G;4520005;1;0;1
174669;202007;352590;M;7119701;0;1;-1
174719;202007;352590;C;3329501;2;0;2
174831;202007;352590;G;4781400;0;1;-1
175166;202007;352590;G;4757100;1;0;1
175490;202007;352590;I;5611201;0;1;-1
175573;202007;352590;G;4712100;0;1;-1
175719;202007;352590;G;4633801;1;1;0
175920;202007;352590;P;8593700;1;1;0
176654;202007;352590;G;4530703;0;1;-1
176920;202007;352590;H;5211701;0;1;-1
177454;202007;352590;Q;8711502;0;5;-5
177455;202007;352590;Q;8711502;0;8;-8
177520;202007;352590;G;4782201;0;1;-1
177694;202007;352590;N;8211300;0;1;-1
177775;202007;352590;G;4520004;1;0;1
177860;202007;352590;Q;8640210;1;0;1
178069;202007;352590;G;4744002;1;0;1
178527;202007;352590;N;8211300;1;0;1
179172;202007;352590;N;8220200;1;2;-1
179506;202007;352590;N;8299706;0;1;-1
179586;202007;352590;H;5240199;1;0;1
180590;202007;352590;M;7112000;0;1;-1
181218;202007;352590;G;4744099;1;3;-2
181287;202007;352590;H;5250804;1;0;1
181322;202007;352590;G;4772500;1;1;0
182519;202007;352590;G;4742300;1;0;1
182796;202007;352590;M;7500100;1;0;1
182934;202007;352590;N;8211300;0;1;-1
183098;202007;352590;M;6920601;1;1;0
183099;202007;352590;Q;8630503;1;0;1
184318;202007;352590;G;4759899;0;1;-1
184583;202007;352590;C;2222600;0;28;-28
185050;202007;352590;G;4771701;1;1;0
185061;202007;352590;C;3314707;0;2;-2
186983;202007;352590;C;1629301;5;0;5
187170;202007;352590;G;4731800;3;0;3
187866;202007;352590;S;9609299;2;1;1
187874;202007;352590;G;4712100;4;2;2
187875;202007;352590;N;8299799;6;0;6
188130;202007;352590;G;4771701;1;0;1
188168;202007;352590;N;7911200;0;1;-1
188249;202007;352590;H;4930202;0;2;-2
189324;202007;352590;Q;8630502;4;1;3
189471;202007;352590;F;4321500;7;1;6
189541;202007;352590;G;4645103;0;1;-1
189793;202007;352590;H;4930202;4;2;2
189794;202007;352590;G;4687703;1;0;1
189924;202007;352590;M;6920601;0;1;-1
190325;202007;352590;F;4330401;2;0;2
191434;202007;352590;P;8511200;0;2;-2
191672;202007;352590;H;4930202;15;11;4
191837;202007;352590;F;4213800;2;3;-1
191901;202007;352590;C;1099699;1;0;1
192988;202007;352590;C;1099699;1;0;1
193061;202007;352590;G;4646001;1;0;1
193615;202007;352590;P;8599604;2;0;2
193638;202007;352590;G;4712100;1;1;0
194443;202007;352590;G;4781400;3;22;-19
194453;202007;352590;G;4511104;3;1;2
194470;202007;352590;P;8513900;1;0;1
194472;202007;352590;N;8130300;5;8;-3
194474;202007;352590;G;4789099;3;1;2
195070;202007;352590;G;4761003;1;0;1
196119;202007;352590;G;4633801;0;1;-1
196153;202007;352590;M;6920601;1;1;0
196390;202007;352590;N;8299799;1;1;0
196432;202007;352590;L;6821802;0;1;-1
196739;202007;352590;N;8299799;7;0;7
197019;202007;352590;C;2311700;1;0;1
197020;202007;352590;G;4744002;0;1;-1
197598;202007;352590;G;4751201;1;0;1
197609;202007;352590;H;5212500;9;4;5
197954;202007;352590;C;2349401;3;0;3
198344;202007;352590;Q;8630501;1;0;1
199543;202007;352590;G;4773300;1;0;1
199663;202007;352590;F;4321500;2;0;2
199906;202007;352590;N;8211300;0;2;-2
201187;202007;352590;N;8011101;0;1;-1
201215;202007;352590;G;4781400;0;1;-1
201964;202007;352590;F;4120400;0;2;-2
202054;202007;352590;G;4731800;0;1;-1
202161;202007;352590;Q;8711502;0;1;-1
202246;202007;352590;G;4649499;0;1;-1
202743;202007;352590;G;4772500;0;4;-4
203121;202007;352590;G;4789002;0;1;-1
203242;202007;352590;G;4744004;0;2;-2
203531;202007;352590;C;2599399;6;11;-5
204238;202007;352590;Q;8712300;0;2;-2
204433;202007;352590;C;1091101;1;1;0
206048;202007;352590;C;1733800;3;1;2
206231;202007;352590;I;5611203;0;3;-3
206264;202007;352590;I;5611203;0;1;-1
206580;202007;352590;P;8599603;0;2;-2
206607;202007;352590;H;4930202;0;2;-2
206769;202007;352590;C;3314799;3;1;2
206927;202007;352590;I;5611201;0;1;-1
207410;202007;352590;N;8299799;0;1;-1
208081;202007;352590;G;4789002;0;1;-1
208597;202007;352590;F;4120400;4;1;3
208980;202007;352590;J;6311900;3;0;3
209018;202007;352590;C;2790299;1;1;0
210246;202007;352590;G;4789004;0;1;-1
210281;202007;352590;I;5611201;0;1;-1
210468;202007;352590;I;5611202;1;0;1
210927;202007;352590;C;1733800;0;2;-2
211119;202007;352590;P;8520100;0;1;-1
211133;202007;352590;F;4322301;0;1;-1
211927;202007;352590;J;6203100;0;1;-1
212042;202007;352590;M;6920601;1;2;-1
212097;202007;352590;G;4731800;1;1;0
212225;202007;352590;G;4713002;0;1;-1
212358;202007;352590;N;8112500;1;0;1
212828;202007;352590;G;4761001;0;3;-3
213182;202007;352590;F;4399103;0;1;-1
213508;202007;352590;C;1066000;22;12;10
213880;202007;352590;G;4781400;0;1;-1
213926;202007;352590;H;4930202;2;9;-7
213949;202007;352590;S;9521500;1;1;0
214412;202007;352590;G;4712100;0;1;-1
214457;202007;352590;C;3250705;1;1;0
214465;202007;352590;I;5611203;1;1;0
214527;202007;352590;S;9521500;0;1;-1
214976;202007;352590;M;7490199;1;14;-13
215000;202007;352590;P;8512100;0;1;-1
215002;202007;352590;E;3821100;10;5;5
215004;202007;352590;I;5611201;3;1;2
215039;202007;352590;K;6462000;1;0;1
215091;202007;352590;N;8111700;28;13;15
215752;202007;352590;I;5611203;0;1;-1
216135;202007;352590;F;4120400;8;0;8
216619;202007;352590;C;2229399;1;0;1
216718;202007;352590;G;4711302;0;1;-1
216925;202007;352590;I;5611201;2;4;-2
217159;202007;352590;I;5611201;0;1;-1
217266;202007;352590;G;4712100;3;1;2
218168;202007;352590;N;8111700;0;1;-1
218353;202007;352590;C;3250706;0;1;-1
218929;202007;352590;J;6190601;4;2;2
218931;202007;352590;N;8121400;1;2;-1
218936;202007;352590;G;4520005;3;0;3
219039;202007;352590;G;4744001;2;1;1
219048;202007;352590;G;4520002;0;1;-1
220313;202007;352590;H;4930201;0;1;-1
220435;202007;352590;L;6821801;2;3;-1
221588;202007;352590;N;8211300;1;0;1
222651;202007;352590;G;4743100;2;1;1
222767;202007;352590;I;5611203;0;1;-1
223062;202007;352590;H;4930202;0;1;-1
224191;202007;352590;S;9420100;1;0;1
224627;202007;352590;N;7739099;0;1;-1
224723;202007;352590;G;4772500;2;0;2
224724;202007;352590;G;4772500;0;1;-1
225011;202007;352590;S;9511800;1;0;1
225529;202007;352590;M;6920601;0;1;-1
226345;202007;352590;G;4691500;8;3;5
227568;202007;352590;M;7311400;1;2;-1
227641;202007;352590;I;5611203;0;1;-1
227647;202007;352590;I;5611203;0;4;-4
227921;202007;352590;I;5611203;0;3;-3
228003;202007;352590;M;7020400;1;0;1
228087;202007;352590;C;1091102;1;1;0
228469;202007;352590;C;3314704;1;0;1
228828;202007;352590;F;4330403;0;1;-1
228833;202007;352590;F;4330499;0;2;-2
229624;202007;352590;L;6810201;0;1;-1
230225;202007;352590;G;4637199;1;0;1
230808;202007;352590;G;4639701;0;1;-1
230915;202007;352590;G;4619200;1;0;1
231185;202007;352590;I;5620104;0;1;-1
231190;202007;352590;Q;8630502;2;2;0
231356;202007;352590;G;4761003;1;0;1
231665;202007;352590;G;4689399;0;1;-1
231882;202007;352590;H;4930201;1;0;1
232124;202007;352590;G;4772500;0;1;-1
232298;202007;352590;F;4399101;1;0;1
232401;202007;352590;G;4669999;1;4;-3
232989;202007;352590;H;4930202;0;1;-1
233087;202007;352590;G;4763601;0;2;-2
233374;202007;352590;C;3314713;0;1;-1
233408;202007;352590;M;6920601;0;1;-1
233522;202007;352590;P;8512100;0;1;-1
234000;202007;352590;M;6920601;1;1;0
234843;202007;352590;G;4744005;0;1;-1
234878;202007;352590;D;3511502;0;2;-2
235378;202007;352590;G;4722901;0;1;-1
235887;202007;352590;G;4781400;1;0;1
236767;202007;352590;G;4686902;3;1;2
236831;202007;352590;C;3314708;0;1;-1
237005;202007;352590;F;4330499;1;2;-1
237089;202007;352590;N;8220200;0;1;-1
237683;202007;352590;K;6622300;2;0;2
237795;202007;352590;G;4731800;1;1;0
237898;202007;352590;G;4763603;0;1;-1
238160;202007;352590;N;8230001;1;0;1
238273;202007;352590;P;8512100;0;3;-3
238697;202007;352590;C;2731700;0;9;-9
238739;202007;352590;J;6190601;1;0;1
238929;202007;352590;H;4930201;0;1;-1
239086;202007;352590;G;4789099;1;1;0
239163;202007;352590;I;5611201;0;1;-1
239251;202007;352590;H;4930201;1;0;1
239672;202007;352590;N;8112500;2;1;1
239685;202007;352590;N;7911200;0;1;-1
239709;202007;352590;H;5211701;25;9;16
240660;202007;352590;G;4530704;3;1;2
240903;202007;352590;N;8219999;1;0;1
241108;202007;352590;C;2399101;1;0;1
241807;202007;352590;N;8111700;1;0;1
241990;202007;352590;C;3314702;3;1;2
242155;202007;352590;G;4754701;47;5;42
242668;202007;352590;C;1091102;1;0;1
242793;202007;352590;G;4744099;2;0;2
242803;202007;352590;G;4771702;2;3;-1
242804;202007;352590;C;1091101;1;3;-2
242809;202007;352590;C;2599399;13;6;7
242923;202007;352590;C;3314708;2;1;1
243150;202007;352590;C;1091100;1;0;1
243886;202007;352590;H;4930202;1;0;1
244520;202007;352590;P;8520100;0;2;-2
245040;202007;352590;F;4399103;2;1;1
246568;202007;352590;F;4120400;1;0;1
246832;202007;352590;F;4399199;1;0;1
246951;202007;352590;F;4330402;0;1;-1
247286;202007;352590;G;4530703;4;0;4
247497;202007;352590;G;4713002;0;1;-1
247832;202007;352590;M;6920601;0;1;-1
248678;202007;352590;G;4763601;1;0;1
248736;202007;352590;F;4322303;1;0;1
249363;202007;352590;G;4741500;1;0;1
249366;202007;352590;C;2522500;2;1;1
249897;202007;352590;C;1052000;1;0;1
250006;202007;352590;G;4772500;0;1;-1
250542;202007;352590;G;4741500;2;0;2
251302;202007;352590;G;4774100;0;4;-4
251364;202007;352590;S;9602501;0;2;-2
251544;202007;352590;N;7810800;5;1;4
251551;202007;352590;G;4721104;8;3;5
251552;202007;352590;G;4637107;1;0;1
251623;202007;352590;C;3101200;6;1;5
251625;202007;352590;G;4754701;4;1;3
251930;202007;352590;C;3321000;3;0;3
252437;202007;352590;J;6190699;1;0;1
253059;202007;352590;Q;8712300;4;3;1
253346;202007;352590;F;4120400;0;1;-1
253510;202007;352590;G;4744099;6;6;0
253716;202007;352590;G;4721104;0;1;-1
253717;202007;352590;G;4721104;0;2;-2
253813;202007;352590;N;7732201;0;2;-2
253818;202007;352590;I;5611201;0;1;-1
253830;202007;352590;G;4663000;1;0;1
253982;202007;352590;H;4930201;0;1;-1
254040;202007;352590;I;5611202;0;2;-2
256137;202007;352590;P;8512100;0;1;-1
256324;202007;352590;C;2229303;1;0;1
256413;202007;352590;G;4782201;1;2;-1
257181;202007;352590;F;4120400;0;2;-2
257382;202007;352590;N;7711000;1;0;1
257515;202007;352590;C;2823200;0;1;-1
257603;202007;352590;Q;8630503;0;1;-1
258133;202007;352590;S;9521500;3;0;3
258186;202007;352590;G;4712100;0;1;-1
258325;202007;352590;N;8299799;0;1;-1
258868;202007;352590;N;8111700;0;1;-1
258881;202007;352590;I;5611201;1;0;1
258992;202007;352590;G;4712100;1;0;1
259155;202007;352590;E;3811400;2;0;2
259990;202007;352590;G;4772500;1;0;1
260105;202007;352590;H;4930202;63;12;51
260773;202007;352590;G;4755502;0;1;-1
261002;202007;352590;H;4930201;1;2;-1
261003;202007;352590;Q;8650004;1;0;1
261424;202007;352590;P;8511200;0;3;-3
261433;202007;352590;G;4754701;0;1;-1
261562;202007;352590;P;8511200;0;1;-1
261636;202007;352590;G;4712100;1;0;1
262150;202007;352590;G;4721102;1;0;1
262294;202007;352590;N;8219999;0;1;-1
262303;202007;352590;P;8512100;0;5;-5
263166;202007;352590;N;8112500;1;0;1
263475;202007;352590;S;9603301;0;2;-2
263748;202007;352590;K;6422100;1;0;1
263951;202007;352590;Q;8630504;0;1;-1
264783;202007;352590;H;5112901;0;1;-1
265560;202007;352590;G;4754701;0;1;-1
266441;202007;352590;G;4712100;1;3;-2
267100;202007;352590;M;7112000;1;0;1
267697;202007;352590;N;8121400;0;2;-2
268484;202007;352590;G;4751201;1;0;1
268656;202007;352590;G;4729699;3;0;3
268665;202007;352590;H;5250803;1;0;1
268888;202007;352590;G;4520005;17;3;14
269125;202007;352590;M;7120100;5;2;3
269385;202007;352590;N;8219999;0;1;-1
269456;202007;352590;G;4721104;1;0;1
269827;202007;352590;N;7911200;1;0;1
269873;202007;352590;G;4759801;1;0;1
270324;202007;352590;F;4120400;5;2;3
270337;202007;352590;H;5229002;0;2;-2
270541;202007;352590;H;4930202;0;1;-1
271771;202007;352590;G;4541201;0;1;-1
271779;202007;352590;G;4663000;1;0;1
271944;202007;352590;G;4752100;1;0;1
272469;202007;352590;N;8211300;0;1;-1
272601;202007;352590;F;4120400;0;1;-1
272641;202007;352590;C;3250701;0;1;-1
273976;202007;352590;G;4771702;5;3;2
274047;202007;352590;N;8299799;2;0;2
274528;202007;352590;F;4222701;1;0;1
274975;202007;352590;N;8211300;2;0;2
275602;202007;352590;Q;8630501;1;0;1
275921;202007;352590;M;6920601;0;1;-1
276178;202007;352590;G;4789099;1;0;1
276250;202007;352590;G;4752100;5;0;5
276541;202007;352590;F;4120400;10;1;9
276742;202007;352590;H;4930201;1;2;-1
276906;202007;352590;H;4930202;1;0;1
277378;202007;352590;G;4754701;1;1;0
277444;202007;352590;G;4634601;1;0;1
277859;202007;352590;G;4789004;2;0;2
278038;202007;352590;F;4399199;5;0;5
278218;202007;352590;Q;8711502;1;1;0
278679;202007;352590;G;4687702;0;1;-1
279102;202007;352590;G;4520005;0;2;-2
279117;202007;352590;G;4731800;1;0;1
279332;202007;352590;H;4930201;1;2;-1
279370;202007;352590;H;4923002;0;1;-1
280265;202007;352590;G;4782201;0;1;-1
281344;202007;352590;N;8011101;7;2;5
281757;202007;352590;I;5611201;0;1;-1
281801;202007;352590;J;6190699;0;1;-1
282099;202007;352590;L;6822600;1;2;-1
283272;202007;352590;H;4930202;0;3;-3
283508;202007;352590;N;8111700;2;0;2
283515;202007;352590;G;4722901;0;1;-1
283790;202007;352590;P;8599603;2;0;2
283815;202007;352590;N;7912100;0;4;-4
284548;202007;352590;G;4724500;2;0;2
284955;202007;352590;I;5611201;0;1;-1
285593;202007;352590;G;4723700;1;0;1
285880;202007;352590;S;9601701;0;1;-1
285942;202007;352590;F;4321500;1;3;-2
286033;202007;352590;P;8593700;0;1;-1
286510;202007;352590;G;4520005;1;0;1
286891;202007;352590;I;5611203;0;1;-1
286962;202007;352590;H;5229002;0;1;-1
287230;202007;352590;M;7112000;0;1;-1
288227;202007;352590;P;8511200;0;1;-1
289000;202007;352590;G;4729699;0;1;-1
289078;202007;352590;C;2222600;5;1;4
289374;202007;352590;G;4789004;0;1;-1
289562;202007;352590;H;4930202;0;1;-1
289782;202007;352590;M;7119701;1;0;1
290063;202007;352590;G;4712100;0;1;-1
290185;202007;352590;G;4771701;1;0;1
290573;202007;352590;I;5620104;0;1;-1
291198;202007;352590;C;3212400;1;0;1
291872;202007;352590;I;5611201;0;1;-1
291996;202007;352590;N;8220200;101;74;27
292018;202007;352590;M;7490104;0;1;-1
292600;202007;352590;F;4399103;9;2;7
292699;202007;352590;M;6920601;0;2;-2
293555;202007;352590;J;6202300;2;0;2
294165;202007;352590;H;4930202;3;1;2
294413;202007;352590;G;4520002;0;1;-1
294414;202007;352590;F;4313400;14;0;14
294858;202007;352590;K;6491300;0;1;-1
295180;202007;352590;G;4729699;0;1;-1
296116;202007;352590;I;5611201;0;1;-1
296233;202007;352590;J;6204000;1;0;1
296516;202007;352590;I;5611204;0;1;-1
296622;202007;352590;M;7119703;0;2;-2
296907;202007;352590;F;4330402;0;1;-1
297716;202007;352590;G;4761001;0;1;-1
297870;202007;352590;I;5620104;1;0;1
298458;202007;352590;I;5620104;0;1;-1
298511;202007;352590;J;6201501;0;1;-1
298812;202007;352590;P;8593700;0;1;-1
299068;202007;352590;N;8130300;6;2;4
299162;202007;352590;G;4752100;0;1;-1
299452;202007;352590;F;4120400;53;6;47
299697;202007;352590;C;2222600;1;0;1
299772;202007;352590;S;9602502;1;1;0
300826;202007;352590;F;4330405;16;3;13
301134;202007;352590;G;4530703;0;1;-1
301761;202007;352590;N;8122200;2;0;2
301762;202007;352590;G;4530705;1;1;0
301766;202007;352590;H;4930201;1;0;1
302471;202007;352590;G;4774100;1;0;1
302809;202007;352590;C;3321000;0;1;-1
303226;202007;352590;N;8299799;0;2;-2
303236;202007;352590;G;4789002;0;1;-1
303960;202007;352590;M;7319003;0;2;-2
303969;202007;352590;H;4930201;0;1;-1
304039;202007;352590;I;5612100;0;1;-1
304256;202007;352590;H;4930202;0;2;-2
304770;202007;352590;H;4930202;10;5;5
304902;202007;352590;Q;8712300;7;7;0
305340;202007;352590;Q;8630502;0;1;-1
305557;202007;352590;H;5223100;0;1;-1
305677;202007;352590;C;2222600;2;0;2
306492;202007;352590;I;5611203;0;1;-1
306780;202007;352590;Q;8630504;1;0;1
307163;202007;352590;P;8550302;1;0;1
308160;202007;352590;N;8111700;2;4;-2
308206;202007;352590;H;4930201;2;0;2
310503;202007;352590;G;4712100;4;2;2
310972;202007;352590;N;8111700;0;1;-1
311170;202007;352590;I;5611201;0;2;-2
311248;202007;352590;G;4731800;1;1;0
311286;202007;352590;I;5611201;0;2;-2
312164;202007;352590;C;3314707;0;1;-1
312727;202007;352590;N;8112500;0;1;-1
313046;202007;352590;F;4222701;1;0;1
313669;202007;352590;G;4669999;5;1;4
313685;202007;352590;M;6920601;0;1;-1
313906;202007;352590;G;4712100;1;0;1
315258;202007;352590;N;8220200;1;0;1
315478;202007;352590;C;2222600;0;1;-1
316236;202007;352590;G;4712100;2;0;2
316280;202007;352590;S;9602502;0;1;-1
316347;202007;352590;G;4754701;1;0;1
317357;202007;352590;G;4789099;0;1;-1
317629;202007;352590;G;4721102;1;1;0
317947;202007;352590;H;4930202;18;4;14
318086;202007;352590;H;4930202;1;0;1
318207;202007;352590;C;1091102;0;1;-1
318778;202007;352590;N;8121400;1;0;1
318806;202007;352590;S;9512600;1;0;1
318916;202007;352590;G;4789001;0;1;-1
319175;202007;352590;I;5620101;0;1;-1
319199;202007;352590;G;4712100;0;2;-2
319252;202007;352590;N;8130300;1;0;1
319334;202007;352590;F;4399199;10;0;10
319466;202007;352590;M;6920601;1;0;1
320338;202007;352590;H;4930202;3;1;2
322265;202007;352590;G;4645101;2;20;-18
323632;202007;352590;N;8211300;0;4;-4
324020;202007;352590;G;4721102;0;2;-2
324442;202007;352590;L;6822600;1;0;1
324626;202007;352590;N;8299799;0;2;-2
325708;202007;352590;M;7112000;0;2;-2
325865;202007;352590;S;9609208;0;1;-1
326049;202007;352590;H;5212500;12;9;3
326145;202007;352590;G;4731800;3;2;1
326227;202007;352590;C;1412601;0;10;-10
326505;202007;352590;P;8599603;1;0;1
326975;202007;352590;C;2950600;2;0;2
327017;202007;352590;G;4744003;1;0;1
327321;202007;352590;G;4752100;0;1;-1
327409;202007;352590;F;4330403;0;2;-2
327665;202007;352590;G;4511101;0;1;-1
327868;202007;352590;F;4120400;1;0;1
328377;202007;352590;C;1042200;10;0;10
328402;202007;352590;G;4520001;0;1;-1
328453;202007;352590;G;4754701;1;0;1
328925;202007;352590;G;4649499;1;2;-1
329194;202007;352590;P;8599604;1;1;0
329498;202007;352590;P;8512100;0;3;-3
329599;202007;352590;Q;8630504;0;2;-2
329691;202007;352590;G;4729699;77;4;73
330091;202007;352590;H;4930201;0;1;-1
330543;202007;352590;Q;8630502;1;0;1
330594;202007;352590;N;8111700;0;1;-1
331045;202007;352590;S;9602502;0;2;-2
331078;202007;352590;H;4930202;1;1;0
332358;202007;352590;N;8112500;1;2;-1
332461;202007;352590;I;5620101;8;2;6
332463;202007;352590;I;5620101;1;1;0
332464;202007;352590;I;5620101;1;0;1
332729;202007;352590;G;4742300;2;3;-1
333340;202007;352590;H;5229002;1;0;1
333396;202007;352590;C;3314708;0;1;-1
333570;202007;352590;G;4729699;0;1;-1
333933;202007;352590;S;9521500;1;0;1
334041;202007;352590;L;6821801;1;0;1
334301;202007;352590;G;4646001;0;3;-3
334472;202007;352590;H;5211701;9;3;6
334497;202007;352590;P;8511200;0;2;-2
334641;202007;352590;F;4322302;0;1;-1
335272;202007;352590;P;8599604;1;0;1
335643;202007;352590;N;8220200;21;110;-89
335669;202007;352590;I;5611203;1;0;1
335866;202007;352590;N;8299799;0;1;-1
336065;202007;352590;J;6209100;1;0;1
336235;202007;352590;G;4520001;1;0;1
336896;202007;352590;I;5611201;1;0;1
337596;202007;352590;G;4772500;0;1;-1
337858;202007;352590;G;4633801;1;0;1
338021;202007;352590;I;5620104;1;0;1
338508;202007;352590;F;4120400;2;0;2
338791;202007;352590;F;4221904;11;11;0
338840;202007;352590;I;5611201;0;2;-2
339117;202007;352590;C;2330305;0;1;-1
340595;202007;352590;N;8299799;11;7;4
340633;202007;352590;C;3321000;0;1;-1
340652;202007;352590;N;8111700;5;5;0
340986;202007;352590;H;4930202;3;2;1
341203;202007;352590;F;4110700;0;1;-1
341206;202007;352590;G;4530703;0;1;-1
342001;202007;352590;G;4711302;1;1;0
342643;202007;352590;P;8599604;6;4;2
342775;202007;352590;C;3319800;0;1;-1
343079;202007;352590;C;3312102;0;1;-1
343538;202007;352590;G;4639701;17;9;8
343884;202007;352590;N;8111700;6;2;4
344197;202007;352590;F;4330499;0;3;-3
344417;202007;352590;C;1095300;1;8;-7
345300;202007;352590;I;5611202;0;1;-1
345336;202007;352590;G;4753900;25;5;20
345646;202007;352590;N;8291100;1;1;0
346317;202007;352590;J;6319400;0;1;-1
346689;202007;352590;G;4759899;0;1;-1
346824;202007;352590;G;4771701;1;0;1
347248;202007;352590;N;8219999;0;1;-1
347421;202007;352590;Q;8630504;0;1;-1
347688;202007;352590;C;2943300;2;1;1
347954;202007;352590;J;6209100;2;0;2
348401;202007;352590;I;5611201;1;1;0
348736;202007;352590;G;4754701;0;1;-1
348950;202007;352590;Q;8630503;3;1;2
349119;202007;352590;I;5611203;0;1;-1
349121;202007;352590;I;5611203;0;1;-1
349122;202007;352590;I;5611203;0;1;-1
350499;202007;352590;C;3314707;0;2;-2
350790;202007;352590;J;6204000;0;1;-1
351001;202007;352590;Q;8630503;2;1;1
351226;202007;352590;L;6821801;0;1;-1
351671;202007;352590;F;4120400;0;1;-1
352079;202007;352590;J;6319400;0;1;-1
352237;202007;352590;C;2542000;2;0;2
352407;202007;352590;Q;8711502;3;3;0
352704;202007;352590;G;4781400;1;0;1
352745;202007;352590;G;4744099;0;1;-1
353673;202007;352590;G;4781400;0;1;-1
354055;202007;352590;G;4761003;0;1;-1
354498;202007;352590;K;6462000;2;0;2
354712;202007;352590;C;2943300;5;1;4
354792;202007;352590;G;4744099;1;0;1
354950;202007;352590;H;5250801;1;0;1
355012;202007;352590;H;4930202;0;1;-1
355795;202007;352590;F;4330404;1;1;0
356373;202007;352590;C;2229302;0;1;-1
356421;202007;352590;P;8599603;2;1;1
357138;202007;352590;I;5611201;1;0;1
358775;202007;352590;G;4781400;0;1;-1
358976;202007;352590;H;5212500;0;6;-6
359791;202007;352590;C;2542000;1;0;1
359869;202007;352590;I;5620104;1;0;1
360525;202007;352590;G;4789099;1;0;1
360601;202007;352590;G;4721102;0;1;-1
361549;202007;352590;H;4930202;1;0;1
362379;202007;352590;G;4530703;0;1;-1
362410;202007;352590;I;5611201;1;0;1
362645;202007;352590;G;4744005;1;0;1
362924;202007;352590;G;4520002;0;1;-1
363010;202007;352590;G;4755502;1;0;1
363228;202007;352590;F;4321500;1;0;1
363299;202007;352590;G;4774100;0;1;-1
363340;202007;352590;G;4761001;0;4;-4
363741;202007;352590;C;2229399;0;2;-2
363857;202007;352590;G;4762800;0;1;-1
363970;202007;352590;Q;8690901;1;0;1
364163;202007;352590;H;5250804;11;7;4
364565;202007;352590;N;8291100;0;1;-1
364867;202007;352590;J;6202300;1;0;1
365263;202007;352590;G;4724500;3;0;3
365807;202007;352590;G;4713002;0;1;-1
366992;202007;352590;I;5611203;0;1;-1
367067;202007;352590;G;4520006;2;1;1
367410;202007;352590;G;4721102;2;1;1
367682;202007;352590;H;4930201;4;0;4
368504;202007;352590;M;7319003;0;2;-2
369237;202007;352590;H;4930201;0;1;-1
369362;202007;352590;C;3314713;0;1;-1
369482;202007;352590;J;6319400;1;0;1
369568;202007;352590;A;121101;0;2;-2
370274;202007;352590;G;4771701;1;0;1
370803;202007;352590;F;4330403;3;0;3
371096;202007;352590;H;4930202;1;1;0
371646;202007;352590;Q;8630503;0;1;-1
372164;202007;352590;I;5611203;0;1;-1
372441;202007;352590;R;9321200;0;1;-1
373338;202007;352590;H;4930202;2;0;2
373502;202007;352590;K;6462000;0;2;-2
373603;202007;352590;G;4789004;2;0;2
374534;202007;352590;Q;8630504;1;0;1
374685;202007;352590;I;5611203;1;0;1
374686;202007;352590;I;5611203;0;1;-1
375101;202007;352590;M;7112000;1;0;1
376311;202007;352590;G;4722901;0;1;-1
376576;202007;352590;G;4663000;0;1;-1
376910;202007;352590;G;4687702;1;0;1
377396;202007;352590;G;4520003;2;0;2
377876;202007;352590;G;4744005;1;0;1
378131;202007;352590;Q;8630501;0;1;-1
378372;202007;352590;Q;8640202;3;1;2
378385;202007;352590;G;4711302;2;0;2
378709;202007;352590;N;7820500;1;1;0
378754;202007;352590;F;4399101;3;6;-3
379321;202007;352590;G;4744005;0;2;-2
379595;202007;352590;N;7729299;0;1;-1
380346;202007;352590;G;4771701;1;0;1
380807;202007;352590;I;5620103;0;1;-1
381678;202007;352590;G;4639701;0;1;-1
382261;202007;352590;H;4930202;1;0;1
382593;202007;352590;I;5611203;0;1;-1
382896;202007;352590;M;7112000;1;3;-2
383047;202007;352590;I;5611201;0;3;-3
383889;202007;352590;H;5240101;0;1;-1
383894;202007;352590;K;6622300;1;0;1
384069;202007;352590;S;9602502;1;0;1
384277;202007;352590;G;4755503;0;1;-1
384856;202007;352590;G;4520002;1;0;1
385182;202007;352590;Q;8640202;0;1;-1
385183;202007;352590;Q;8640202;0;1;-1
385208;202007;352590;G;4789004;1;0;1
385231;202007;352590;Q;8630504;0;3;-3
385343;202007;352590;I;5620104;1;1;0
385425;202007;352590;G;4729699;1;0;1
385426;202007;352590;G;4729699;0;3;-3
385769;202007;352590;G;4722901;1;1;0
386117;202007;352590;Q;8711502;0;1;-1
386335;202007;352590;N;8230001;0;1;-1
386850;202007;352590;G;4789099;1;0;1
387108;202007;352590;G;4741500;0;1;-1
387182;202007;352590;N;8111700;4;1;3
387265;202007;352590;I;5620104;1;0;1
387352;202007;352590;G;4541203;1;0;1
387505;202007;352590;J;6110803;1;0;1
387665;202007;352590;G;4729699;1;0;1
388222;202007;352590;I;5620101;1;0;1
388313;202007;352590;F;4120400;7;2;5
389311;202007;352590;G;4772500;0;1;-1
389327;202007;352590;G;4520002;0;1;-1
389440;202007;352590;H;5212500;4;8;-4
389696;202007;352590;C;1053800;13;1;12
389870;202007;352590;G;4721102;1;0;1
389907;202007;352590;I;5611201;0;2;-2
390676;202007;352590;I;5611203;0;2;-2
390731;202007;352590;F;4391600;0;1;-1
391168;202007;352590;C;1091102;0;1;-1
391281;202007;352590;G;4753900;0;5;-5
391521;202007;352590;M;7112000;4;2;2
391843;202007;352590;G;4712100;1;0;1
391878;202007;352590;M;7490104;0;4;-4
392182;202007;352590;S;9603304;0;2;-2
392295;202007;352590;G;4789099;1;2;-1
393075;202007;352590;G;4782201;0;1;-1
393322;202007;352590;G;4744005;2;0;2
393423;202007;352590;C;3101200;1;0;1
393607;202007;352590;G;4772500;3;0;3
393664;202007;352590;I;5611203;0;1;-1
394332;202007;352590;M;7490104;1;0;1
394894;202007;352590;M;7112000;0;1;-1
395436;202007;352590;F;4399199;1;0;1
396018;202007;352590;J;6209100;1;0;1
396019;202007;352590;J;6209100;0;2;-2
396051;202007;352590;P;8599699;1;0;1
396350;202007;352590;G;4721102;1;0;1
396677;202007;352590;H;5112901;2;0;2
397563;202007;352590;H;5211799;0;6;-6
397668;202007;352590;F;4330401;1;0;1
397783;202007;352590;N;8111700;0;1;-1
397910;202007;352590;N;8291100;3;5;-2
398594;202007;352590;G;4781400;0;1;-1
399703;202007;352590;G;4744099;3;0;3
400589;202007;352590;Q;8630501;2;2;0
401421;202007;352590;G;4723700;1;1;0
401645;202007;352590;I;5611201;0;1;-1
401836;202007;352590;J;6110803;2;1;1
402045;202007;352590;G;4530703;0;1;-1
402223;202007;352590;P;8512100;0;1;-1
403063;202007;352590;C;1412601;0;2;-2
403226;202007;352590;S;9601703;2;6;-4
403337;202007;352590;S;9491000;1;0;1
403751;202007;352590;C;3314799;2;0;2
403807;202007;352590;I;5611203;0;5;-5
403838;202007;352590;G;4789001;0;1;-1
405109;202007;352590;G;4774100;1;0;1
405615;202007;352590;G;4784900;1;0;1
405621;202007;352590;M;7020400;1;0;1
406038;202007;352590;S;9602501;0;1;-1
406040;202007;352590;G;4781400;0;1;-1
406045;202007;352590;J;6202300;1;0;1
406436;202007;352590;G;4781400;1;1;0
406904;202007;352590;P;8512100;0;1;-1
407126;202007;352590;M;7112000;1;0;1
408037;202007;352590;H;4930202;0;1;-1
408259;202007;352590;N;8230001;0;1;-1
408636;202007;352590;G;4711301;11;8;3
408801;202007;352590;L;6821802;1;1;0
408977;202007;352590;F;4321500;0;2;-2
409899;202007;352590;P;8599603;0;1;-1
410041;202007;352590;G;4729602;1;0;1
410291;202007;352590;G;4783101;0;1;-1
410925;202007;352590;S;9529199;0;1;-1
411307;202007;352590;G;4711302;0;1;-1
411508;202007;352590;P;8599699;0;2;-2
411596;202007;352590;I;5611201;1;0;1
411754;202007;352590;N;7911200;0;2;-2
411756;202007;352590;N;7911200;0;1;-1
413052;202007;352590;G;4520005;2;0;2
413057;202007;352590;C;1099699;1;0;1
413692;202007;352590;Q;8630504;0;1;-1
413787;202007;352590;G;4781400;0;1;-1
413895;202007;352590;K;6492100;0;1;-1
414455;202007;352590;N;8299799;0;1;-1
414831;202007;352590;H;5320202;3;2;1
415315;202007;352590;F;4321500;0;1;-1
415600;202007;352590;L;6821802;1;0;1
415653;202007;352590;Q;8630504;1;0;1
415663;202007;352590;G;4530702;3;0;3
415692;202007;352590;P;8593700;1;4;-3
416779;202007;352590;G;4774100;0;1;-1
416899;202007;352590;H;4930202;1;0;1
416908;202007;352590;F;4120400;1;0;1
417126;202007;352590;H;4930201;2;0;2
417374;202007;352590;N;7810800;1;1;0
417573;202007;352590;N;8121400;1;2;-1
418148;202007;352590;F;4299599;1;0;1
418945;202007;352590;N;7739099;9;3;6
420120;202007;352590;Q;8630504;2;0;2
420378;202007;352590;S;9602502;1;0;1
420850;202007;352590;P;8599604;0;1;-1
421788;202007;352590;Q;8630503;3;1;2
421939;202007;352590;S;9609208;0;1;-1
422125;202007;352590;R;9313100;0;1;-1
422896;202007;352590;G;4781400;0;1;-1
422907;202007;352590;N;7732201;1;0;1
423435;202007;352590;P;8599699;0;1;-1
423611;202007;352590;C;2222600;2;1;1
423671;202007;352590;M;7319002;2;0;2
424108;202007;352590;S;9602502;1;0;1
424662;202007;352590;H;4930201;3;0;3
424771;202007;352590;H;5223100;2;1;1
425040;202007;352590;C;1412602;0;1;-1
425159;202007;352590;I;5611201;0;1;-1
425454;202007;352590;I;5620104;1;1;0
425656;202007;352590;K;6619302;2;0;2
425767;202007;352590;N;8111700;1;0;1
426532;202007;352590;J;5819100;0;1;-1
427106;202007;352590;G;4713002;1;0;1
427264;202007;352590;G;4784900;1;0;1
427339;202007;352590;G;4789002;2;0;2
428553;202007;352590;M;6920601;0;2;-2
428833;202007;352590;G;4530703;1;0;1
429195;202007;352590;F;4313400;1;0;1
429196;202007;352590;F;4313400;0;1;-1
429258;202007;352590;P;8599699;1;0;1
430060;202007;352590;P;8511200;0;1;-1
430063;202007;352590;G;4712100;0;1;-1
431013;202007;352590;P;8512100;0;1;-1
431037;202007;352590;G;4711302;0;3;-3
431616;202007;352590;C;1099699;2;0;2
431880;202007;352590;G;4757100;0;1;-1
433359;202007;352590;P;8520100;0;4;-4
433798;202007;352590;H;4930202;7;1;6
434195;202007;352590;N;8211300;0;1;-1
434459;202007;352590;I;5611201;1;0;1
435389;202007;352590;G;4691500;1;0;1
435513;202007;352590;N;8219999;1;0;1
436143;202007;352590;N;8299799;1;0;1
436689;202007;352590;N;8111700;18;1;17
437025;202007;352590;A;163600;0;2;-2
437063;202007;352590;H;4930202;1;1;0
437419;202007;352590;N;8219999;0;1;-1
437500;202007;352590;C;3314707;1;0;1
437512;202007;352590;P;8592903;0;1;-1
438421;202007;352590;G;4633801;0;1;-1
438448;202007;352590;H;4930201;0;1;-1
439158;202007;352590;N;8211300;1;1;0
439697;202007;352590;N;8230001;0;1;-1
439761;202007;352590;G;4711302;0;3;-3
440944;202007;352590;G;4753900;0;1;-1
441034;202007;352590;G;4753900;128;31;97
441217;202007;352590;G;4753900;0;2;-2
441227;202007;352590;G;4753900;0;3;-3
441722;202007;352590;G;4712100;1;0;1
442362;202007;352590;G;4744099;2;0;2
443043;202007;352590;H;4930202;16;23;-7
443432;202007;352590;G;4781400;0;8;-8
443532;202007;352590;G;4781400;2;4;-2
443808;202007;352590;H;4930202;2;0;2
444127;202007;352590;L;6810201;1;0;1
444431;202007;352590;G;4752100;1;0;1
444671;202007;352590;I;5611201;1;0;1
445149;202007;352590;F;4330404;2;1;1
445664;202007;352590;G;4530703;2;0;2
445893;202007;352590;G;4684299;1;0;1
446130;202007;352590;N;8219999;1;0;1
446144;202007;352590;M;7112000;0;1;-1
447266;202007;352590;F;4292801;0;2;-2
447835;202007;352590;G;4520002;1;0;1
449243;202007;352590;L;6822600;0;1;-1
450121;202007;352590;P;8599603;1;0;1
450396;202007;352590;C;3312103;0;1;-1
452726;202007;352590;Q;8630504;6;1;5
452812;202007;352590;J;6204000;0;1;-1
453537;202007;352590;G;4744001;4;0;4
455444;202007;352590;I;5611201;3;0;3
456115;202007;352590;F;4299599;0;1;-1
456658;202007;352590;A;161003;1;0;1
457246;202007;352590;Q;8640202;1;0;1
457577;202007;352590;S;9602502;1;0;1
457777;202007;352590;Q;8690901;1;0;1
457813;202007;352590;H;4930203;2;0;2
457999;202007;352590;G;4785799;1;2;-1
458928;202007;352590;H;5229099;14;1;13
459386;202007;352590;P;8593700;0;6;-6
459877;202007;352590;N;8121400;1;0;1
460686;202007;352590;F;4120400;2;1;1
461346;202007;352590;I;5611201;1;0;1
461480;202007;352590;G;4669999;5;3;2
461481;202007;352590;G;4669999;1;1;0
461544;202007;352590;G;4729602;2;0;2
461722;202007;352590;G;4754702;3;0;3
461928;202007;352590;M;7112000;0;1;-1
462184;202007;352590;Q;8650003;1;0;1
463335;202007;352590;C;3299003;2;2;0
463464;202007;352590;P;8513900;0;1;-1
463485;202007;352590;C;2599302;10;7;3
463812;202007;352590;I;5611201;1;0;1
464779;202007;352590;G;4771701;1;0;1
464851;202007;352590;I;5611203;1;0;1
465945;202007;352590;C;1091102;3;1;2
465969;202007;352590;I;5620101;0;1;-1
466290;202007;352590;G;4774100;1;0;1
466502;202007;352590;G;4771701;1;0;1
466519;202007;352590;N;8230001;1;2;-1
466756;202007;352590;N;8211300;0;1;-1
467142;202007;352590;R;9313100;2;0;2
467377;202007;352590;G;4774100;0;1;-1
467718;202007;352590;G;4721102;2;0;2
468341;202007;352590;I;5611201;1;1;0
468618;202007;352590;F;4313400;1;0;1
468763;202007;352590;I;5611201;0;2;-2
470065;202007;352590;N;8211300;4;2;2
470132;202007;352590;R;9319199;1;0;1
470544;202007;352590;N;8219999;1;0;1
470647;202007;352590;N;7810800;0;1;-1
470919;202007;352590;L;6821801;1;0;1
471568;202007;352590;G;4744099;0;1;-1
472280;202007;352590;H;5320201;4;0;4
472379;202007;352590;I;5611201;0;1;-1
474938;202007;352590;G;4712100;1;0;1
474979;202007;352590;G;4744001;0;2;-2
475389;202007;352590;G;4712100;0;1;-1
475403;202007;352590;S;9609208;1;0;1
475458;202007;352590;J;6203100;1;0;1
475521;202007;352590;N;7739002;1;0;1
475597;202007;352590;Q;8630504;2;0;2
475754;202007;352590;I;5611201;2;0;2
476069;202007;352590;N;8292000;1;0;1
476212;202007;352590;N;8121400;1;0;1
476252;202007;352590;N;8111700;4;0;4
476266;202007;352590;C;1091102;1;0;1
476938;202007;352590;N;8291100;1;0;1
476973;202007;352590;G;4729699;2;0;2
478149;202007;352590;G;4723700;2;0;2
478481;202007;352590;G;4781400;1;1;0
478599;202007;352590;Q;8711502;6;0;6
479816;202007;352590;I;5611203;1;0;1
480688;202007;352590;H;4930202;1;2;-1
481320;202007;352590;M;7319002;7;0;7
481321;202007;352590;M;7319002;0;3;-3
481634;202007;352590;I;5620104;2;0;2
481857;202007;352590;A;122900;1;0;1
482724;202007;352590;N;8111700;10;2;8
484285;202007;352590;G;4744001;2;0;2
484711;202007;352590;Q;8630504;1;0;1
486821;202007;352590;P;8532500;0;1;-1
486962;202007;352590;G;4781400;0;1;-1
487091;202007;352590;I;5611201;3;2;1
488403;202007;352590;J;6120501;0;1;-1
488414;202007;352590;J;6120501;0;1;-1
489280;202007;352590;H;4930202;1;0;1
490782;202007;352590;I;5611203;0;2;-2
490845;202007;352590;C;1062700;0;14;-14
490846;202007;352590;C;1062700;3;15;-12
491382;202007;352590;C;1813099;3;0;3
491921;202007;352590;S;9412099;0;1;-1
491966;202007;352590;Q;8640202;1;0;1
492043;202007;352590;G;4721104;0;1;-1
492283;202007;352590;G;4753900;0;1;-1
492331;202007;352590;H;4930202;4;1;3
492335;202007;352590;G;4789002;1;0;1
492338;202007;352590;F;4120400;1;1;0
492458;202007;352590;G;4772500;0;1;-1
492475;202007;352590;C;2019399;1;6;-5
492536;202007;352590;C;2543800;0;1;-1
492537;202007;352590;C;2599399;0;1;-1
492669;202007;352590;C;2710402;4;10;-6
493301;202007;352590;R;9312300;0;1;-1
493302;202007;352590;I;5611201;0;1;-1
493303;202007;352590;S;9430800;0;2;-2
493304;202007;352590;C;2592602;0;1;-1
493305;202007;352590;S;9430800;0;1;-1
493308;202007;352590;K;6550200;2;28;-26
493316;202007;352590;K;6550200;0;1;-1
493322;202007;352590;K;6550200;0;1;-1
493323;202007;352590;Q;8690999;0;1;-1
493334;202007;352590;K;6550200;0;1;-1
493374;202007;352590;F;4399105;3;1;2
493375;202007;352590;S;9430800;0;3;-3
493376;202007;352590;M;6920601;1;0;1
493377;202007;352590;R;9312300;0;5;-5
493517;202007;352590;C;2013402;12;7;5
493962;202007;352590;G;4781400;1;0;1
494075;202007;352590;G;4781400;0;3;-3
494215;202007;352590;G;4781400;0;2;-2
494492;202007;352590;F;4120400;0;1;-1
494506;202007;352590;G;4632001;1;0;1
494608;202007;352590;G;4782201;0;8;-8
494610;202007;352590;G;4782201;0;14;-14
494611;202007;352590;G;4782201;0;1;-1
494614;202007;352590;G;4782201;0;13;-13
494616;202007;352590;G;4782201;0;7;-7
494621;202007;352590;G;4782201;0;5;-5
494622;202007;352590;G;4782201;0;16;-16
494623;202007;352590;G;4782201;0;3;-3
494702;202007;352590;G;4711301;23;4;19
494804;202007;352590;G;4731800;3;0;3
495002;202007;352590;G;4744005;1;0;1
495066;202007;352590;C;2821601;7;2;5
495080;202007;352590;O;8411600;4;85;-81
495595;202007;352590;C;3250705;1;3;-2
495722;202007;352590;C;3101200;1;1;0
495726;202007;352590;C;2063100;6;2;4
495740;202007;352590;C;2651500;1;2;-1
496085;202007;352590;I;5510801;1;0;1
496101;202007;352590;G;4744002;1;1;0
496117;202007;352590;J;6010100;0;2;-2
496118;202007;352590;H;4930202;4;9;-5
496119;202007;352590;G;4639701;1;1;0
496135;202007;352590;G;4754701;0;1;-1
496136;202007;352590;N;8299706;1;0;1
496137;202007;352590;F;4313400;0;21;-21
496276;202007;352590;N;8111700;1;0;1
496311;202007;352590;C;2342702;1;0;1
496975;202007;352590;G;4711302;0;4;-4
497239;202007;352590;G;4711301;1;0;1
497556;202007;352590;I;5510801;1;0;1
497694;202007;352590;Q;8640202;1;4;-3
497696;202007;352590;Q;8690999;3;0;3
497712;202007;352590;Q;8640299;1;0;1
497715;202007;352590;Q;8690999;1;0;1
497718;202007;352590;Q;8640202;7;0;7
497876;202007;352590;F;4110700;0;1;-1
497966;202007;352590;G;4789007;1;0;1
497967;202007;352590;G;4789002;1;0;1
497968;202007;352590;G;4711302;1;1;0
498226;202007;352590;G;4713001;0;1;-1
498941;202007;352590;H;4921301;0;4;-4
499644;202007;352590;H;5211799;0;1;-1
499678;202007;352590;G;4731800;0;1;-1
499712;202007;352590;Q;8640205;0;1;-1
499717;202007;352590;G;4732600;1;0;1
499722;202007;352590;S;9430800;1;0;1
499723;202007;352590;S;9430800;0;1;-1
499756;202007;352590;C;2229399;7;3;4
499931;202007;352590;G;4784900;3;2;1
500222;202007;352590;I;5620101;0;1;-1
500311;202007;352590;I;5620101;0;1;-1
500348;202007;352590;I;5620101;3;0;3
500415;202007;352590;I;5620101;0;1;-1
500718;202007;352590;P;8599601;0;1;-1
500719;202007;352590;C;1813099;0;1;-1
500720;202007;352590;M;6920601;2;2;0
500721;202007;352590;P;8599601;0;1;-1
500722;202007;352590;G;4530703;2;0;2
500807;202007;352590;G;4755503;1;0;1
501102;202007;352590;C;1330800;30;10;20
501106;202007;352590;F;4313400;0;1;-1
501413;202007;352590;K;6550200;0;3;-3
501414;202007;352590;K;6550200;1;0;1
501415;202007;352590;K;6550200;0;6;-6
501416;202007;352590;K;6550200;2;0;2
501579;202007;352590;F;4120400;5;0;5
501580;202007;352590;G;4731800;0;1;-1
501604;202007;352590;H;4921301;0;14;-14
501606;202007;352590;G;4744002;0;1;-1
501608;202007;352590;C;1623400;0;6;-6
501609;202007;352590;C;1122401;2;0;2
501610;202007;352590;G;4711302;1;0;1
501613;202007;352590;C;1112700;2;2;0
501615;202007;352590;G;4744099;1;0;1
501616;202007;352590;C;1112700;2;0;2
501617;202007;352590;G;4771701;0;1;-1
501618;202007;352590;C;1011201;0;1;-1
501620;202007;352590;P;8513900;5;4;1
501621;202007;352590;G;4511101;2;2;0
501623;202007;352590;C;2229302;1;3;-2
501625;202007;352590;R;9312300;1;0;1
501626;202007;352590;G;4721102;1;1;0
501629;202007;352590;C;1033301;0;1;-1
501632;202007;352590;C;2219600;12;5;7
501634;202007;352590;G;4783101;0;1;-1
501635;202007;352590;C;1099601;2;1;1
501636;202007;352590;C;1629301;2;0;2
501639;202007;352590;G;4729699;0;1;-1
501642;202007;352590;K;6622300;1;0;1
501645;202007;352590;G;4530703;0;1;-1
501647;202007;352590;H;4929902;3;3;0
501648;202007;352590;C;2330399;1;0;1
501649;202007;352590;Q;8610101;88;27;61
501650;202007;352590;G;4541203;0;1;-1
501653;202007;352590;G;4721102;1;1;0
501656;202007;352590;R;9312300;0;1;-1
501657;202007;352590;G;4731800;1;1;0
501658;202007;352590;G;4711302;0;2;-2
501660;202007;352590;G;4711302;3;2;1
501664;202007;352590;G;4711302;0;4;-4
501666;202007;352590;G;4711302;1;6;-5
501667;202007;352590;G;4711302;15;12;3
501668;202007;352590;G;4711302;2;1;1
501670;202007;352590;G;4711302;2;12;-10
501671;202007;352590;G;4639701;0;1;-1
501673;202007;352590;G;4711302;6;4;2
501675;202007;352590;G;4711302;0;1;-1
501677;202007;352590;G;4711302;2;7;-5
501678;202007;352590;G;4711302;3;9;-6
501679;202007;352590;G;4711302;6;15;-9
501680;202007;352590;H;4921301;0;12;-12
501681;202007;352590;C;1311100;0;1;-1
501682;202007;352590;C;1311100;42;16;26
501683;202007;352590;C;2229301;357;52;305
501684;202007;352590;C;2229301;3;3;0
501685;202007;352590;C;2229301;11;7;4
501686;202007;352590;C;2229301;0;1;-1
501687;202007;352590;C;2229301;3;8;-5
501690;202007;352590;Q;8730102;1;0;1
501691;202007;352590;P;8513900;0;2;-2
501699;202007;352590;G;4721102;0;1;-1
501700;202007;352590;G;4511101;0;1;-1
501707;202007;352590;S;9430800;4;4;0
501708;202007;352590;G;4721102;0;1;-1
501715;202007;352590;Q;8610101;4;4;0
501718;202007;352590;Q;8610101;28;13;15
501721;202007;352590;C;2342702;3;0;3
501723;202007;352590;Q;8800600;0;1;-1
501730;202007;352590;G;4744005;1;0;1
501731;202007;352590;G;4530703;0;1;-1
501733;202007;352590;Q;8711502;1;6;-5
501734;202007;352590;H;5223100;0;1;-1
501735;202007;352590;G;4744099;1;0;1
501743;202007;352590;G;4711302;4;4;0
501744;202007;352590;G;4711302;6;6;0
501745;202007;352590;G;4711302;3;1;2
501746;202007;352590;G;4711302;2;1;1
501748;202007;352590;G;4711302;3;4;-1
501751;202007;352590;M;6920601;0;1;-1
501758;202007;352590;S;9420100;1;0;1
501759;202007;352590;S;9491000;0;1;-1
501760;202007;352590;S;9491000;1;0;1
501762;202007;352590;G;4633801;2;1;1
501773;202007;352590;S;9491000;1;0;1
502025;202007;352590;N;8299706;3;1;2
502031;202007;352590;P;8513900;0;1;-1
502032;202007;352590;G;4729699;0;1;-1
502043;202007;352590;C;2071100;0;1;-1
502291;202007;352590;C;1013901;13;4;9
502547;202007;352590;G;4744099;1;0;1
502647;202007;352590;S;9420100;0;1;-1
502649;202007;352590;Q;8640202;2;0;2
502650;202007;352590;Q;8640201;1;0;1
502655;202007;352590;S;9491000;0;1;-1
502656;202007;352590;Q;8640202;4;0;4
502657;202007;352590;Q;8640202;1;0;1
502658;202007;352590;Q;8640202;0;1;-1
502659;202007;352590;Q;8640202;1;0;1
502660;202007;352590;H;4930202;0;2;-2
502687;202007;352590;S;9430800;5;3;2
502688;202007;352590;Q;8610101;0;3;-3
502712;202007;352590;P;8520100;0;2;-2
502719;202007;352590;G;4647801;0;1;-1
502720;202007;352590;S;9499500;0;1;-1
502721;202007;352590;P;8511200;0;4;-4
502929;202007;352590;C;3250707;4;4;0
503017;202007;352590;G;4661300;1;5;-4
503154;202007;352590;E;3702900;0;1;-1
503155;202007;352590;P;8512100;2;1;1
503169;202007;352590;P;8592999;0;1;-1
503170;202007;352590;N;8112500;0;1;-1
503171;202007;352590;N;8112500;1;0;1
503172;202007;352590;N;7820500;0;2;-2
503226;202007;352590;G;4639701;3;4;-1
503242;202007;352590;G;4789008;0;1;-1
503259;202007;352590;H;4930202;7;2;5
503397;202007;352590;H;4930202;5;0;5
503450;202007;352590;G;4771702;5;4;1
503522;202007;352590;G;4755502;1;0;1
503525;202007;352590;I;5611201;1;1;0
503548;202007;352590;G;4744001;0;1;-1
503603;202007;352590;G;4530703;0;1;-1
503730;202007;352590;G;4721102;0;1;-1
503753;202007;352590;C;1031700;2;9;-7
503787;202007;352590;C;2512800;1;0;1
503993;202007;352590;G;4771701;0;1;-1
504240;202007;352590;G;4669999;1;0;1
504250;202007;352590;I;5510801;0;1;-1
504338;202007;352590;G;4789004;0;1;-1
504708;202007;352590;N;8211300;0;1;-1
504813;202007;352590;G;4712100;0;1;-1
505302;202007;352590;Q;8640203;1;0;1
505344;202007;352590;H;4930202;2;1;1
505345;202007;352590;N;8112500;1;1;0
505349;202007;352590;M;6911703;1;0;1
505350;202007;352590;L;6822600;2;0;2
505351;202007;352590;M;7112000;0;1;-1
505354;202007;352590;P;8513900;1;1;0
505486;202007;352590;F;4329103;0;2;-2
505603;202007;352590;C;3101200;0;1;-1
506050;202007;352590;G;4712100;0;1;-1
506051;202007;352590;G;4712100;1;1;0
506274;202007;352590;N;7732201;2;0;2
506275;202007;352590;N;8112500;0;1;-1
506335;202007;352590;G;4511101;6;2;4
506341;202007;352590;I;5620101;0;1;-1
506504;202007;352590;S;9529199;1;0;1
506759;202007;352590;N;7732201;1;0;1
506869;202007;352590;F;4399199;1;0;1
506950;202007;352590;C;3314710;0;1;-1
507001;202007;352590;C;2821602;0;2;-2
507401;202007;352590;G;4731800;0;1;-1
507641;202007;352590;G;4661300;2;0;2
507990;202007;352590;I;5510803;0;1;-1
508371;202007;352590;G;4753900;1;0;1
508452;202007;352590;G;4511102;0;1;-1
508460;202007;352590;G;4511102;1;0;1
508492;202007;352590;K;6550200;5;2;3
508493;202007;352590;Q;8630502;1;0;1
508494;202007;352590;Q;8610102;5;3;2
508495;202007;352590;Q;8610101;2;0;2
508496;202007;352590;Q;8640210;1;0;1
508705;202007;352590;G;4744005;0;1;-1
508736;202007;352590;G;4520001;0;1;-1
508879;202007;352590;F;4321500;0;2;-2
509101;202007;352590;C;3314707;0;1;-1
509106;202007;352590;C;3314708;0;1;-1
509135;202007;352590;G;4541205;1;0;1
509189;202007;352590;C;2949299;1;0;1
509615;202007;352590;H;4930202;2;2;0
509715;202007;352590;K;6493000;0;6;-6
509803;202007;352590;C;2099199;4;0;4
509892;202007;352590;C;2592602;0;3;-3
509978;202007;352590;H;4930202;2;1;1
510128;202007;352590;K;6493000;1;1;0
510320;202007;352590;N;8299706;0;1;-1
510349;202007;352590;G;4712100;1;1;0
510482;202007;352590;I;5611201;1;0;1
510483;202007;352590;I;5611201;1;1;0
510561;202007;352590;I;5620101;0;1;-1
510575;202007;352590;N;8112500;1;0;1
510576;202007;352590;N;8121400;6;4;2
510578;202007;352590;H;5223100;1;1;0
510579;202007;352590;N;8112500;1;0;1
510657;202007;352590;G;4646001;0;1;-1
510859;202007;352590;F;4221902;1;0;1
510899;202007;352590;H;4929902;13;2;11
510922;202007;352590;I;5611201;0;1;-1
510953;202007;352590;G;4763601;0;1;-1
511139;202007;352590;G;4635402;16;6;10
511213;202007;352590;C;2229399;13;2;11
511237;202007;352590;H;4930202;1;2;-1
511277;202007;352590;Q;8640205;0;1;-1
511280;202007;352590;S;9430800;0;1;-1
511311;202007;352590;M;6920601;1;1;0
511312;202007;352590;P;8512100;0;2;-2
511319;202007;352590;N;8112500;0;1;-1
511433;202007;352590;C;2944100;13;11;2
511460;202007;352590;C;1629301;1;1;0
511711;202007;352590;G;4731800;0;1;-1
511820;202007;352590;F;4292802;0;11;-11
511889;202007;352590;H;4930202;1;1;0
511925;202007;352590;G;4721102;1;2;-1
511927;202007;352590;C;2539001;0;2;-2
511946;202007;352590;K;6550200;1;0;1
512017;202007;352590;E;3839401;0;1;-1
512136;202007;352590;H;4930202;0;1;-1
512160;202007;352590;G;4789099;0;1;-1
512190;202007;352590;N;7732201;2;0;2
512213;202007;352590;G;4741500;0;1;-1
512303;202007;352590;G;4789004;1;0;1
512363;202007;352590;G;4633802;0;1;-1
512392;202007;352590;G;4731800;0;1;-1
512410;202007;352590;C;1314600;10;0;10
512582;202007;352590;G;4672900;1;0;1
513025;202007;352590;G;4729699;0;1;-1
513174;202007;352590;M;7210000;0;1;-1
513197;202007;352590;G;4771701;0;2;-2
513292;202007;352590;C;2522500;5;13;-8
513509;202007;352590;C;3299005;0;3;-3
513533;202007;352590;Q;8610101;1;2;-1
513568;202007;352590;C;2014200;1;0;1
513734;202007;352590;K;6422100;0;1;-1
514445;202007;352590;G;4744005;1;0;1
514453;202007;352590;G;4511104;0;2;-2
514530;202007;352590;B;810099;2;1;1
514531;202007;352590;C;2330302;0;5;-5
514778;202007;352590;G;4633802;1;0;1
514779;202007;352590;G;4633802;0;1;-1
514961;202007;352590;Q;8800600;0;4;-4
515009;202007;352590;C;3104700;2;2;0
515017;202007;352590;Q;8711502;0;2;-2
515018;202007;352590;P;8513900;1;0;1
515167;202007;352590;S;9491000;0;12;-12
515206;202007;352590;C;2599399;0;3;-3
515493;202007;352590;G;4713001;2;1;1
515667;202007;352590;G;4713004;16;0;16
515784;202007;352590;G;4530703;0;1;-1
515858;202007;352590;C;2591800;28;15;13
515921;202007;352590;G;4635402;1;5;-4
515928;202007;352590;C;1122401;3;7;-4
516049;202007;352590;C;1721400;0;7;-7
516141;202007;352590;G;4711302;9;8;1
516612;202007;352590;G;4771701;0;1;-1
516693;202007;352590;G;4771701;3;1;2
516830;202007;352590;G;4771701;1;1;0
517214;202007;352590;C;2949299;0;1;-1
517567;202007;352590;N;8211300;19;7;12
517678;202007;352590;C;1411801;0;6;-6
517679;202007;352590;G;4661300;0;1;-1
517792;202007;352590;G;4771701;0;1;-1
517839;202007;352590;G;4771701;0;1;-1
518026;202007;352590;G;4771701;0;1;-1
518027;202007;352590;G;4771701;0;1;-1
518143;202007;352590;G;4771701;0;1;-1
518191;202007;352590;G;4771701;1;1;0
518207;202007;352590;G;4771701;0;3;-3
518381;202007;352590;G;4771701;0;1;-1
518436;202007;352590;G;4771701;1;0;1
518599;202007;352590;Q;8800600;9;14;-5
518649;202007;352590;G;4635402;3;0;3
518895;202007;352590;N;8121400;84;34;50
519449;202007;352590;G;4741500;1;0;1
520487;202007;352590;P;8541400;0;3;-3
520520;202007;352590;P;8541400;0;4;-4
520705;202007;352590;G;4712100;0;1;-1
520733;202007;352590;C;3230200;1;0;1
520750;202007;352590;G;4789002;5;8;-3
520764;202007;352590;C;2229301;0;1;-1
520903;202007;352590;G;4744099;0;1;-1
520926;202007;352590;G;4530701;1;0;1
521760;202007;352590;J;6209100;2;1;1
521767;202007;352590;Q;8660700;6;4;2
521870;202007;352590;G;4771701;1;1;0
522376;202007;352590;H;4930202;2;0;2
522498;202007;352590;F;4120400;0;1;-1
522501;202007;352590;C;3314710;4;2;2
523240;202007;352590;G;4731800;1;0;1
523463;202007;352590;H;4930202;1;1;0
523473;202007;352590;F;4330401;1;1;0
523745;202007;352590;G;4711302;21;21;0
523784;202007;352590;C;1099699;8;4;4
523870;202007;352590;F;4211101;2;0;2
523898;202007;352590;N;8112500;1;1;0
524493;202007;352590;L;6822600;1;0;1
524561;202007;352590;N;7739099;4;4;0
524581;202007;352590;I;5611203;0;3;-3
524582;202007;352590;I;5611203;0;6;-6
524689;202007;352590;G;4789099;1;3;-2
525126;202007;352590;J;5819100;0;1;-1
525127;202007;352590;N;8111700;7;44;-37
525128;202007;352590;H;5223100;1;0;1
525140;202007;352590;H;5223100;1;1;0
525141;202007;352590;H;5223100;2;0;2
525142;202007;352590;P;8512100;0;1;-1
525143;202007;352590;Q;8690999;0;1;-1
525149;202007;352590;P;8513900;0;3;-3
525152;202007;352590;N;8112500;1;0;1
525154;202007;352590;N;8112500;1;1;0
525218;202007;352590;G;4771701;0;3;-3
525282;202007;352590;G;4744005;1;1;0
525456;202007;352590;C;2014200;2;1;1
525478;202007;352590;G;4711302;1;1;0
525479;202007;352590;C;1013901;1;0;1
525551;202007;352590;F;4120400;17;5;12
525580;202007;352590;C;2222600;1;1;0
525622;202007;352590;G;4684299;1;0;1
525762;202007;352590;G;4729699;0;1;-1
525913;202007;352590;C;2229399;1;0;1
525968;202007;352590;G;4781400;0;1;-1
526103;202007;352590;I;5620101;0;1;-1
526150;202007;352590;I;5620101;6;2;4
526383;202007;352590;I;5611201;0;1;-1
526401;202007;352590;C;1412601;0;1;-1
526420;202007;352590;G;4744005;6;3;3
526448;202007;352590;G;4744005;0;1;-1
526469;202007;352590;H;4930202;4;4;0
526587;202007;352590;C;2330302;0;1;-1
526652;202007;352590;G;4721102;0;1;-1
526808;202007;352590;I;5611203;0;1;-1
527528;202007;352590;G;4771701;1;0;1
527537;202007;352590;J;6203100;0;2;-2
527662;202007;352590;C;2543800;0;1;-1
527683;202007;352590;C;2330302;1;0;1
527807;202007;352590;G;4712100;1;0;1
527888;202007;352590;G;4721102;3;1;2
527961;202007;352590;G;4771702;3;4;-1
527985;202007;352590;G;4530703;0;1;-1
529374;202007;352590;G;4511101;1;2;-1
529498;202007;352590;C;2229301;61;20;41
529637;202007;352590;F;4299599;0;2;-2
529674;202007;352590;F;4110700;0;1;-1
529754;202007;352590;N;7739099;0;1;-1
529870;202007;352590;I;5611201;0;1;-1
530073;202007;352590;G;4741500;0;1;-1
530076;202007;352590;G;4741500;1;0;1
530079;202007;352590;G;4741500;1;0;1
530080;202007;352590;G;4741500;2;1;1
530968;202007;352590;C;3299099;6;0;6
531210;202007;352590;C;2822402;0;1;-1
531426;202007;352590;G;4789099;0;1;-1
531454;202007;352590;G;4692300;1;1;0
531610;202007;352590;C;1031700;1;0;1
531706;202007;352590;J;5813100;0;1;-1
532134;202007;352590;G;4635402;1;6;-5
533178;202007;352590;H;5310502;4;3;1
533188;202007;352590;H;5223100;0;1;-1
533189;202007;352590;H;5223100;0;1;-1
533233;202007;352590;H;5310502;0;1;-1
533642;202007;352590;C;1330800;3;0;3
533708;202007;352590;G;4744001;1;1;0
533799;202007;352590;G;4711302;1;0;1
533823;202007;352590;G;4771701;1;0;1
533895;202007;352590;N;7820500;0;2;-2
534673;202007;352590;G;4711301;23;14;9
535039;202007;352590;I;5620101;0;9;-9
535254;202007;352590;C;2349401;0;1;-1
535260;202007;352590;N;8211300;3;5;-2
535718;202007;352590;H;4930202;4;3;1
536720;202007;352590;H;4930202;0;1;-1
537289;202007;352590;C;2812700;0;1;-1
537954;202007;352590;H;4930203;2;2;0
540283;202007;352590;G;4530703;0;1;-1
540667;202007;352590;G;4711301;0;1;-1
543435;202007;352590;S;9511800;2;0;2
545591;202007;352590;H;4930202;1;0;1
546834;202007;352590;G;4679604;1;0;1
547271;202007;352590;C;3314710;23;7;16
548105;202007;352590;G;4541201;0;20;-20
552378;202007;352590;C;2330399;0;1;-1
553107;202007;352590;H;4930202;0;3;-3
553851;202007;352590;G;4751201;1;1;0
554238;202007;352590;C;1733800;15;4;11
554239;202007;352590;C;1733800;32;3;29
555431;202007;352590;K;6422100;0;1;-1
555432;202007;352590;K;6422100;0;1;-1
555480;202007;352590;K;6422100;0;2;-2
555481;202007;352590;K;6422100;0;1;-1
558476;202007;352590;G;4781400;0;1;-1
560642;202007;352590;I;5620101;0;3;-3
562021;202007;352590;C;1733800;1;0;1
562202;202007;352590;N;8111700;0;3;-3
562476;202007;352590;E;3832700;1;1;0
562477;202007;352590;I;5620101;0;2;-2
562638;202007;352590;I;5611201;0;1;-1
562644;202007;352590;C;2829199;0;2;-2
562684;202007;352590;C;2599399;0;3;-3
563483;202007;352590;F;4330401;0;2;-2
563568;202007;352590;H;5320201;1;0;1
563975;202007;352590;C;2813500;48;4;44
563976;202007;352590;C;2349401;6;11;-5
580369;202007;352590;M;6912500;2;0;2
310;202104;352590;G;4784900;1;0;1
341;202104;352590;G;4751201;0;2;-2
1141;202104;352590;Q;8640202;2;1;1
1426;202104;352590;L;6810202;0;1;-1
2317;202104;352590;C;2599399;3;10;-7
2382;202104;352590;G;4633801;1;0;1
2462;202104;352590;L;6810202;1;0;1
3035;202104;352590;C;2812700;12;3;9
3059;202104;352590;H;4930203;7;3;4
3125;202104;352590;C;1091101;1;0;1
3179;202104;352590;I;5510803;1;0;1
3485;202104;352590;C;2222600;0;1;-1
3522;202104;352590;G;4530703;1;0;1
3606;202104;352590;C;2949299;58;13;45
3723;202104;352590;G;4672900;0;1;-1
4559;202104;352590;C;2040100;1;4;-3
4668;202104;352590;N;7739099;3;4;-1
4748;202104;352590;N;7810800;4;9;-5
4949;202104;352590;K;6622300;0;3;-3
5005;202104;352590;C;2539002;0;2;-2
5205;202104;352590;G;4744001;1;0;1
6583;202104;352590;K;6423900;1;0;1
6758;202104;352590;C;2229399;1;0;1
7290;202104;352590;C;1732000;5;2;3
7786;202104;352590;G;4753900;4;3;1
8817;202104;352590;G;4712100;0;1;-1
9196;202104;352590;Q;8711502;1;1;0
9293;202104;352590;G;4744002;1;0;1
9411;202104;352590;N;8112500;0;1;-1
9486;202104;352590;P;8599601;0;1;-1
9499;202104;352590;G;4649406;0;1;-1
9781;202104;352590;G;4672900;3;0;3
10855;202104;352590;G;4789007;0;1;-1
10900;202104;352590;G;4789099;0;1;-1
11869;202104;352590;P;8599601;1;0;1
12081;202104;352590;G;4530703;1;0;1
12311;202104;352590;H;5211701;6;5;1
13131;202104;352590;I;5611203;0;2;-2
13233;202104;352590;Q;8610101;11;7;4
13752;202104;352590;C;1610201;0;2;-2
13803;202104;352590;C;2342702;10;7;3
14332;202104;352590;C;1813001;2;1;1
14386;202104;352590;J;6203100;1;2;-1
14407;202104;352590;G;4511102;1;0;1
14492;202104;352590;H;4929902;4;6;-2
14662;202104;352590;S;9601703;8;3;5
14666;202104;352590;S;9601703;25;36;-11
14948;202104;352590;C;1413401;0;1;-1
15347;202104;352590;M;6920601;1;0;1
15402;202104;352590;C;2341900;2;0;2
16113;202104;352590;M;6920601;0;1;-1
16992;202104;352590;P;8512100;1;0;1
16994;202104;352590;S;9420100;1;0;1
16995;202104;352590;Q;8640299;0;2;-2
17587;202104;352590;G;4520001;0;1;-1
17651;202104;352590;G;4732600;0;1;-1
17812;202104;352590;S;9601701;0;1;-1
17996;202104;352590;R;9319199;0;1;-1
17997;202104;352590;M;6920601;1;1;0
18691;202104;352590;F;4321500;0;1;-1
18963;202104;352590;C;3240099;1;0;1
19044;202104;352590;C;2731700;2;1;1
19175;202104;352590;G;4711301;3;9;-6
19242;202104;352590;G;4511101;1;2;-1
19760;202104;352590;H;5223100;0;1;-1
19844;202104;352590;G;4742300;0;2;-2
19923;202104;352590;G;4644301;49;43;6
19995;202104;352590;M;7112000;0;4;-4
20085;202104;352590;J;6202300;0;1;-1
20141;202104;352590;G;4781400;0;1;-1
20227;202104;352590;K;6622300;1;1;0
20518;202104;352590;H;5250804;0;1;-1
20670;202104;352590;K;6424703;0;1;-1
20679;202104;352590;G;4771701;1;1;0
21059;202104;352590;G;4511102;1;0;1
21277;202104;352590;N;8299701;54;41;13
21449;202104;352590;S;9430800;2;2;0
21676;202104;352590;I;5611201;0;2;-2
22296;202104;352590;I;5611203;0;1;-1
22318;202104;352590;C;2511000;1;0;1
22441;202104;352590;G;4724500;1;0;1
22498;202104;352590;N;8122200;0;1;-1
22533;202104;352590;G;4721102;0;1;-1
22971;202104;352590;C;2229302;1;0;1
23026;202104;352590;G;4781400;0;1;-1
23175;202104;352590;G;4689399;6;0;6
23742;202104;352590;G;4645101;0;1;-1
23842;202104;352590;G;4652400;4;0;4
24166;202104;352590;C;3102100;7;2;5
24589;202104;352590;H;4930203;16;5;11
24695;202104;352590;K;6622300;1;0;1
24836;202104;352590;I;5510803;1;0;1
24886;202104;352590;M;6920601;1;5;-4
24887;202104;352590;Q;8640299;3;1;2
24898;202104;352590;F;4329104;4;7;-3
25236;202104;352590;G;4751201;3;0;3
25662;202104;352590;C;2222600;1;0;1
25700;202104;352590;G;4771701;0;1;-1
25805;202104;352590;Q;8630502;1;0;1
25859;202104;352590;L;6810202;9;2;7
26220;202104;352590;G;4649499;0;1;-1
26409;202104;352590;M;7312200;1;0;1
27086;202104;352590;F;4399199;2;1;1
27375;202104;352590;H;4930202;4;2;2
27508;202104;352590;G;4639701;1;1;0
27567;202104;352590;C;1062700;3;3;0
28292;202104;352590;C;1081302;3;3;0
28467;202104;352590;G;4530703;2;0;2
28750;202104;352590;M;7112000;1;0;1
28788;202104;352590;M;6920601;2;2;0
28828;202104;352590;C;2539001;1;1;0
29290;202104;352590;C;3250705;1;1;0
29552;202104;352590;G;4721104;0;1;-1
30347;202104;352590;I;5620101;0;1;-1
30526;202104;352590;P;8512100;1;1;0
30608;202104;352590;N;8211300;29;22;7
30609;202104;352590;G;4634601;15;13;2
31260;202104;352590;C;2219600;1;1;0
31330;202104;352590;G;4712100;1;1;0
32568;202104;352590;P;8599601;1;0;1
33529;202104;352590;G;4530701;0;4;-4
34130;202104;352590;C;2539001;1;0;1
34244;202104;352590;G;4687701;1;2;-1
34442;202104;352590;C;2599399;7;3;4
34444;202104;352590;G;4759899;1;3;-2
34773;202104;352590;P;8599601;0;1;-1
34951;202104;352590;G;4744005;0;1;-1
36066;202104;352590;F;4313400;0;2;-2
36891;202104;352590;G;4781400;1;0;1
37129;202104;352590;M;6920601;0;2;-2
37380;202104;352590;I;5611201;1;0;1
37408;202104;352590;N;8211300;8;12;-4
37429;202104;352590;C;2539001;2;1;1
37588;202104;352590;S;9430800;4;1;3
37936;202104;352590;C;2511000;1;1;0
38118;202104;352590;G;4751201;1;1;0
38436;202104;352590;P;8511200;1;1;0
38437;202104;352590;P;8512100;0;1;-1
38925;202104;352590;C;1099699;0;1;-1
39356;202104;352590;C;1081302;4;5;-1
39609;202104;352590;N;8011101;4;9;-5
39926;202104;352590;N;7820500;30;13;17
40308;202104;352590;G;4731800;1;1;0
40457;202104;352590;C;1749400;1;1;0
40742;202104;352590;G;4754701;0;2;-2
40924;202104;352590;G;4781400;0;1;-1
41168;202104;352590;F;4223500;1;0;1
41374;202104;352590;G;4781400;0;1;-1
41564;202104;352590;M;6920601;2;0;2
41616;202104;352590;H;5221400;25;39;-14
41710;202104;352590;C;2941700;15;12;3
41720;202104;352590;R;9313100;0;3;-3
42396;202104;352590;G;4731800;1;1;0
43035;202104;352590;C;2751100;0;2;-2
43430;202104;352590;C;2229302;0;1;-1
43562;202104;352590;I;5611203;0;1;-1
43638;202104;352590;J;6120501;1;0;1
43934;202104;352590;C;2815102;1;0;1
44002;202104;352590;F;4120400;1;0;1
44253;202104;352590;C;2451200;0;1;-1
44309;202104;352590;G;4530703;0;1;-1
44500;202104;352590;C;1099604;1;0;1
45174;202104;352590;P;8532500;1;0;1
45267;202104;352590;G;4731800;1;1;0
45286;202104;352590;H;4930202;0;1;-1
45478;202104;352590;Q;8630502;0;1;-1
45529;202104;352590;P;8513900;1;2;-1
45728;202104;352590;G;4774100;0;1;-1
46276;202104;352590;G;4763601;0;1;-1
46650;202104;352590;G;4721102;0;1;-1
46887;202104;352590;I;5611203;0;2;-2
46954;202104;352590;Q;8640205;0;1;-1
47043;202104;352590;G;4511102;0;1;-1
47306;202104;352590;G;4722901;1;1;0
47632;202104;352590;G;4789099;1;0;1
47884;202104;352590;C;2091600;7;3;4
48045;202104;352590;G;4530705;0;1;-1
48056;202104;352590;P;8512100;1;0;1
48301;202104;352590;F;4211101;0;1;-1
48567;202104;352590;C;1053800;1;0;1
48642;202104;352590;H;4930202;0;11;-11
48667;202104;352590;Q;8800600;1;2;-1
48723;202104;352590;G;4721102;1;1;0
49055;202104;352590;H;5211799;48;6;42
49169;202104;352590;C;3101200;0;1;-1
49232;202104;352590;G;4731800;2;0;2
49259;202104;352590;N;8211300;4;4;0
49637;202104;352590;C;3312102;1;0;1
50418;202104;352590;I;5620103;3;1;2
50484;202104;352590;H;4930202;9;10;-1
50790;202104;352590;C;1013901;8;14;-6
50845;202104;352590;G;4722901;1;0;1
51338;202104;352590;C;2814301;0;1;-1
51524;202104;352590;H;5223100;0;1;-1
51583;202104;352590;P;8599602;0;3;-3
51961;202104;352590;G;4789099;2;0;2
52361;202104;352590;G;4754702;0;1;-1
52791;202104;352590;C;2599399;0;2;-2
52888;202104;352590;G;4755503;0;1;-1
52984;202104;352590;G;4679601;3;2;1
53991;202104;352590;H;4930202;6;13;-7
54245;202104;352590;G;4789001;0;1;-1
54360;202104;352590;G;4789099;2;0;2
54465;202104;352590;N;8121400;10;35;-25
54551;202104;352590;N;8291100;0;2;-2
54578;202104;352590;M;6920601;0;1;-1
54761;202104;352590;G;4771702;0;2;-2
54800;202104;352590;C;2222600;1;5;-4
55131;202104;352590;G;4771701;0;1;-1
55278;202104;352590;G;4752100;0;2;-2
55660;202104;352590;G;4689399;0;1;-1
56167;202104;352590;G;4639701;1;4;-3
56249;202104;352590;K;6622300;0;4;-4
56750;202104;352590;F;4330499;4;5;-1
57271;202104;352590;N;8299706;1;0;1
57856;202104;352590;H;5229002;1;0;1
58295;202104;352590;G;4646001;5;9;-4
58442;202104;352590;N;8112500;1;0;1
58856;202104;352590;I;5620101;2;1;1
58862;202104;352590;I;5620101;0;1;-1
58883;202104;352590;Q;8720401;3;4;-1
59109;202104;352590;H;4930203;0;1;-1
61051;202104;352590;I;5611201;0;2;-2
61671;202104;352590;G;4744099;1;1;0
61699;202104;352590;G;4771702;1;0;1
61718;202104;352590;G;4781400;1;2;-1
62792;202104;352590;G;4711302;3;0;3
62847;202104;352590;G;4712100;1;0;1
63169;202104;352590;G;4754701;0;2;-2
63285;202104;352590;F;4391600;0;1;-1
64169;202104;352590;G;4520005;0;1;-1
64492;202104;352590;H;4930202;2;1;1
65189;202104;352590;E;3600601;21;1;20
65208;202104;352590;M;7119701;1;0;1
65210;202104;352590;I;5611203;0;1;-1
65380;202104;352590;N;8292000;6;2;4
65456;202104;352590;G;4789099;0;2;-2
65524;202104;352590;C;1093702;28;15;13
65959;202104;352590;N;7820500;165;294;-129
66037;202104;352590;F;4120400;9;2;7
67477;202104;352590;G;4759801;0;1;-1
67479;202104;352590;J;6209100;1;2;-1
67825;202104;352590;C;3292202;1;0;1
67912;202104;352590;H;4930202;1;0;1
68327;202104;352590;C;2829199;3;1;2
68514;202104;352590;N;7820500;1;0;1
68538;202104;352590;N;7820500;150;209;-59
70038;202104;352590;P;8599699;2;0;2
70057;202104;352590;P;8599699;1;1;0
70309;202104;352590;F;4399199;3;2;1
70322;202104;352590;J;6190601;1;1;0
70527;202104;352590;I;5611203;0;1;-1
71243;202104;352590;N;8129000;36;47;-11
71308;202104;352590;G;4744005;0;4;-4
71359;202104;352590;C;2222600;5;13;-8
72067;202104;352590;G;4789099;0;1;-1
72101;202104;352590;H;4930202;2;11;-9
72102;202104;352590;H;4930202;3;5;-2
72369;202104;352590;H;5120000;3;0;3
72372;202104;352590;H;5120000;1;1;0
73057;202104;352590;G;4744005;3;0;3
73109;202104;352590;G;4637106;3;2;1
73726;202104;352590;G;4744001;1;0;1
74000;202104;352590;G;4646001;3;0;3
74435;202104;352590;I;5510803;1;1;0
74457;202104;352590;F;4120400;0;1;-1
74510;202104;352590;I;5510803;1;1;0
74707;202104;352590;Q;8630501;0;1;-1
75268;202104;352590;I;5620103;1;1;0
75408;202104;352590;G;4649499;0;2;-2
75580;202104;352590;N;7820500;1;0;1
75833;202104;352590;N;8211300;0;1;-1
75910;202104;352590;J;6203100;0;1;-1
76021;202104;352590;Q;8630504;0;1;-1
76077;202104;352590;N;8291100;2;2;0
76696;202104;352590;Q;8630503;1;0;1
76957;202104;352590;G;4672900;2;3;-1
77048;202104;352590;I;5611201;2;2;0
77051;202104;352590;I;5611201;3;5;-2
77179;202104;352590;S;9430800;1;1;0
77311;202104;352590;N;8299799;4;12;-8
77312;202104;352590;N;8299799;0;2;-2
77367;202104;352590;Q;8711502;7;2;5
77629;202104;352590;J;6203100;1;0;1
77829;202104;352590;N;7820500;2;1;1
77849;202104;352590;G;4742300;0;1;-1
78485;202104;352590;D;3514000;2;0;2
78510;202104;352590;H;4930202;1;1;0
78769;202104;352590;K;6622300;1;0;1
79820;202104;352590;N;8121400;6;0;6
79882;202104;352590;H;4930201;3;1;2
80087;202104;352590;G;4530703;0;1;-1
80134;202104;352590;C;2029100;1;2;-1
80449;202104;352590;H;5112901;14;1;13
80805;202104;352590;G;4520001;0;1;-1
81026;202104;352590;G;4771701;0;1;-1
81500;202104;352590;P;8532500;4;2;2
81595;202104;352590;P;8599699;1;4;-3
82082;202104;352590;G;4541202;0;1;-1
82657;202104;352590;S;9601701;0;1;-1
83471;202104;352590;Q;8630501;0;1;-1
83747;202104;352590;C;3314721;2;12;-10
84127;202104;352590;G;4511101;1;2;-1
84574;202104;352590;F;4299599;4;13;-9
85012;202104;352590;Q;8640210;1;0;1
85013;202104;352590;Q;8640210;0;1;-1
85309;202104;352590;G;4753900;1;0;1
85457;202104;352590;M;7112000;1;0;1
85475;202104;352590;G;4731800;3;2;1
85510;202104;352590;C;2599399;0;2;-2
85529;202104;352590;G;4639701;9;7;2
86081;202104;352590;G;4731800;1;1;0
86671;202104;352590;I;5611201;0;1;-1
87333;202104;352590;N;8299799;3;12;-9
87692;202104;352590;G;4771701;0;1;-1
87977;202104;352590;G;4712100;1;0;1
89156;202104;352590;P;8512100;3;2;1
89306;202104;352590;H;5250801;2;0;2
89735;202104;352590;M;7112000;0;1;-1
89935;202104;352590;N;8211300;10;35;-25
90179;202104;352590;G;4789099;0;2;-2
90360;202104;352590;R;9329802;0;1;-1
90778;202104;352590;G;4731800;0;1;-1
91599;202104;352590;J;6203100;2;0;2
91667;202104;352590;I;5611201;0;2;-2
92100;202104;352590;M;6920601;1;1;0
92104;202104;352590;C;2399199;2;0;2
92524;202104;352590;F;4399105;1;0;1
92766;202104;352590;Q;8630504;1;1;0
92831;202104;352590;G;4520001;1;0;1
93343;202104;352590;Q;8650099;34;6;28
93448;202104;352590;R;9313100;0;2;-2
93568;202104;352590;G;4789007;3;0;3
93671;202104;352590;G;4753900;1;1;0
94175;202104;352590;G;4744005;1;0;1
94177;202104;352590;L;6810202;1;1;0
95402;202104;352590;K;6612603;0;1;-1
95788;202104;352590;H;4930201;6;1;5
96755;202104;352590;C;2222600;2;3;-1
96843;202104;352590;G;4724500;1;4;-3
96857;202104;352590;G;4724500;0;2;-2
97016;202104;352590;N;8299799;2;1;1
97447;202104;352590;G;4712100;0;1;-1
97864;202104;352590;I;5510803;3;1;2
99253;202104;352590;G;4712100;1;0;1
99468;202104;352590;F;4299599;0;1;-1
99556;202104;352590;C;2229303;0;2;-2
99564;202104;352590;L;6810202;4;0;4
99668;202104;352590;I;5611202;1;0;1
100008;202104;352590;S;9609208;1;0;1
100185;202104;352590;G;4520002;2;1;1
100256;202104;352590;S;9430800;1;7;-6
100731;202104;352590;S;9430800;1;1;0
101423;202104;352590;N;8299706;0;1;-1
101645;202104;352590;G;4729699;1;2;-1
101943;202104;352590;H;5240199;0;1;-1
102581;202104;352590;G;4520001;0;1;-1
103606;202104;352590;J;5914600;0;3;-3
103672;202104;352590;G;4751201;0;1;-1
103689;202104;352590;G;4530703;8;2;6
103708;202104;352590;F;4110700;0;1;-1
103712;202104;352590;C;2950600;0;1;-1
104190;202104;352590;G;4731800;1;1;0
104194;202104;352590;G;4782201;1;1;0
104214;202104;352590;F;4313400;6;6;0
104384;202104;352590;G;4789099;0;1;-1
104497;202104;352590;M;6920601;0;1;-1
104604;202104;352590;C;2330302;0;1;-1
104690;202104;352590;F;4313400;22;3;19
104746;202104;352590;P;8512100;1;0;1
104836;202104;352590;G;4511101;4;5;-1
105368;202104;352590;P;8513900;2;1;1
105645;202104;352590;R;9313100;0;1;-1
106399;202104;352590;G;4789001;2;0;2
107388;202104;352590;G;4687703;2;1;1
107654;202104;352590;G;4729699;1;0;1
108184;202104;352590;N;7820500;125;125;0
108402;202104;352590;C;2869100;0;1;-1
108781;202104;352590;R;9313100;0;2;-2
109147;202104;352590;Q;8712300;5;2;3
109224;202104;352590;N;8299799;1;0;1
109793;202104;352590;J;6202300;1;1;0
110354;202104;352590;G;4755502;0;2;-2
110437;202104;352590;P;8599604;1;1;0
110891;202104;352590;M;7119701;0;1;-1
110893;202104;352590;G;4781400;1;0;1
111156;202104;352590;G;4772500;0;1;-1
111270;202104;352590;G;4530703;0;1;-1
111816;202104;352590;N;8219999;1;0;1
111887;202104;352590;G;4541203;1;1;0
112110;202104;352590;G;4721102;1;1;0
112545;202104;352590;Q;8630503;0;1;-1
113217;202104;352590;G;4774100;0;1;-1
113641;202104;352590;G;4721102;0;2;-2
113706;202104;352590;J;6201501;1;1;0
113847;202104;352590;N;8299799;1;1;0
114637;202104;352590;G;4687702;0;1;-1
115099;202104;352590;G;4711302;9;9;0
115129;202104;352590;G;4774100;0;3;-3
115235;202104;352590;G;4753900;0;1;-1
115361;202104;352590;G;4649499;0;1;-1
115417;202104;352590;M;6920601;1;0;1
115696;202104;352590;Q;8630503;1;0;1
115728;202104;352590;G;4530703;0;1;-1
116508;202104;352590;C;2219600;6;0;6
116591;202104;352590;G;4759899;0;1;-1
116733;202104;352590;G;4744099;0;1;-1
116866;202104;352590;C;2823200;1;1;0
117064;202104;352590;C;2825900;2;0;2
117120;202104;352590;G;4772500;0;2;-2
117124;202104;352590;G;4772500;0;1;-1
118032;202104;352590;G;4639701;1;2;-1
118172;202104;352590;G;4530703;1;0;1
118631;202104;352590;G;4759899;0;3;-3
118632;202104;352590;G;4759899;1;4;-3
118637;202104;352590;G;4649499;3;7;-4
118810;202104;352590;G;4744099;1;1;0
118888;202104;352590;G;4520001;1;0;1
119307;202104;352590;G;4753900;0;2;-2
119339;202104;352590;G;4744002;0;1;-1
119499;202104;352590;H;4930203;0;1;-1
119597;202104;352590;N;8299799;0;12;-12
119738;202104;352590;J;6204000;1;2;-1
119801;202104;352590;F;4222701;0;1;-1
119854;202104;352590;C;1099699;0;1;-1
119976;202104;352590;C;1082100;1;3;-2
120237;202104;352590;G;4645101;1;0;1
120473;202104;352590;F;4120400;1;1;0
121058;202104;352590;G;4711302;1;6;-5
121200;202104;352590;G;4711301;10;8;2
121397;202104;352590;G;4711302;2;0;2
121401;202104;352590;G;4789099;0;1;-1
122012;202104;352590;I;5611203;1;0;1
122276;202104;352590;P;8531700;6;1;5
122288;202104;352590;C;2941700;2;0;2
123347;202104;352590;G;4789002;1;0;1
123496;202104;352590;C;2591800;1;4;-3
124137;202104;352590;K;6424703;1;0;1
124174;202104;352590;G;4761001;0;2;-2
124175;202104;352590;I;5611201;0;1;-1
124291;202104;352590;G;4789001;0;2;-2
124304;202104;352590;G;4530703;2;0;2
125508;202104;352590;F;4120400;0;1;-1
125758;202104;352590;G;4759899;0;1;-1
125951;202104;352590;F;4313400;11;5;6
125966;202104;352590;G;4721102;0;1;-1
126009;202104;352590;G;4753900;0;1;-1
126173;202104;352590;G;4781400;0;1;-1
126460;202104;352590;G;4744099;0;1;-1
127306;202104;352590;H;4930202;0;1;-1
127784;202104;352590;G;4712100;2;3;-1
127866;202104;352590;G;4530703;1;1;0
127972;202104;352590;G;4789002;3;0;3
127973;202104;352590;G;4789002;0;8;-8
128175;202104;352590;G;4751201;1;2;-1
128297;202104;352590;G;4763602;0;1;-1
128636;202104;352590;H;4930202;2;4;-2
130633;202104;352590;G;4721102;0;1;-1
130840;202104;352590;G;4759899;1;0;1
131148;202104;352590;F;4120400;1;1;0
131153;202104;352590;N;8299799;0;3;-3
131565;202104;352590;G;4763601;0;1;-1
132004;202104;352590;G;4618499;1;0;1
132601;202104;352590;F;4330401;1;0;1
133051;202104;352590;G;4633801;0;1;-1
133070;202104;352590;G;4711302;7;11;-4
133197;202104;352590;G;4713002;0;2;-2
133907;202104;352590;I;5611201;0;1;-1
134546;202104;352590;H;4930202;1;0;1
134563;202104;352590;I;5611201;0;1;-1
134570;202104;352590;G;4763603;2;1;1
134735;202104;352590;I;5611201;0;1;-1
135048;202104;352590;N;8011101;9;9;0
135703;202104;352590;G;4771701;0;1;-1
135848;202104;352590;K;6424703;1;3;-2
136304;202104;352590;H;4930202;1;1;0
136729;202104;352590;N;8211300;5;1;4
136885;202104;352590;G;4729699;0;3;-3
137038;202104;352590;G;4530703;0;1;-1
137382;202104;352590;C;2542000;0;1;-1
137459;202104;352590;G;4781400;0;3;-3
137963;202104;352590;C;2790299;4;3;1
137965;202104;352590;C;2790299;4;1;3
137970;202104;352590;G;4530703;1;0;1
138848;202104;352590;E;3701100;0;2;-2
138906;202104;352590;C;1053800;3;1;2
139083;202104;352590;Q;8630501;2;2;0
139395;202104;352590;G;4722901;0;1;-1
139490;202104;352590;G;4633801;4;2;2
140433;202104;352590;G;4744099;1;2;-1
140818;202104;352590;P;8513900;2;0;2
140819;202104;352590;M;7120100;1;0;1
141051;202104;352590;C;2622100;0;1;-1
141570;202104;352590;N;8111700;1;2;-1
142010;202104;352590;G;4751201;1;0;1
142134;202104;352590;F;4299599;0;4;-4
142214;202104;352590;G;4685100;0;2;-2
142420;202104;352590;C;2071100;0;1;-1
142886;202104;352590;C;2790299;0;1;-1
143097;202104;352590;S;9430800;2;0;2
143376;202104;352590;J;6209100;1;0;1
143702;202104;352590;G;4771701;0;1;-1
143703;202104;352590;G;4771701;0;2;-2
143704;202104;352590;G;4771701;0;1;-1
143903;202104;352590;C;2759799;3;1;2
144463;202104;352590;G;4652400;1;0;1
144888;202104;352590;I;5611201;0;2;-2
145487;202104;352590;G;4752100;0;1;-1
145765;202104;352590;C;2219600;1;1;0
145799;202104;352590;G;4722901;1;1;0
146186;202104;352590;G;4741500;0;1;-1
146206;202104;352590;G;4731800;0;2;-2
146461;202104;352590;C;2029100;5;9;-4
146489;202104;352590;G;4635402;4;2;2
147380;202104;352590;S;9493600;3;1;2
147852;202104;352590;H;4930202;5;2;3
148017;202104;352590;M;6920601;0;1;-1
148155;202104;352590;M;7020400;1;1;0
148311;202104;352590;R;9313100;0;1;-1
148337;202104;352590;R;9313100;2;1;1
148442;202104;352590;G;4754703;1;1;0
149266;202104;352590;H;4923002;0;1;-1
149625;202104;352590;S;9430800;0;1;-1
149933;202104;352590;G;4722901;1;0;1
150419;202104;352590;J;6204000;0;1;-1
150421;202104;352590;G;4759899;1;0;1
150500;202104;352590;J;6201501;1;1;0
151017;202104;352590;C;1031700;0;1;-1
151173;202104;352590;G;4520001;1;0;1
151270;202104;352590;J;6201501;2;2;0
151381;202104;352590;G;4771702;1;1;0
151529;202104;352590;H;4930202;0;1;-1
151730;202104;352590;C;2543800;3;0;3
152137;202104;352590;G;4772500;0;1;-1
152476;202104;352590;N;8112500;0;4;-4
152503;202104;352590;C;1053800;0;3;-3
152995;202104;352590;G;4754702;0;1;-1
153882;202104;352590;G;4712100;1;0;1
153973;202104;352590;C;1099601;16;3;13
154078;202104;352590;P;8512100;2;1;1
154082;202104;352590;P;8520100;0;2;-2
154353;202104;352590;C;1042200;3;4;-1
154377;202104;352590;G;4541203;0;1;-1
154477;202104;352590;P;8513900;1;0;1
154946;202104;352590;H;4930202;2;2;0
155119;202104;352590;N;8122200;1;0;1
155227;202104;352590;G;4789001;0;2;-2
156062;202104;352590;K;6619399;1;1;0
157382;202104;352590;M;6920601;1;0;1
157736;202104;352590;N;7711000;0;1;-1
157997;202104;352590;I;5611203;0;1;-1
158006;202104;352590;I;5611203;0;1;-1
159029;202104;352590;J;5813100;1;1;0
159905;202104;352590;N;7732201;1;0;1
160526;202104;352590;G;4753900;0;5;-5
160527;202104;352590;G;4753900;0;1;-1
160643;202104;352590;G;4789099;0;1;-1
161034;202104;352590;G;4789002;1;0;1
161215;202104;352590;P;8512100;2;0;2
161326;202104;352590;G;4639701;2;2;0
162157;202104;352590;G;4781400;0;1;-1
162368;202104;352590;G;4731800;0;1;-1
162880;202104;352590;B;891600;1;0;1
162948;202104;352590;M;7490104;0;1;-1
163451;202104;352590;C;2621300;46;21;25
163452;202104;352590;C;2632900;32;36;-4
163493;202104;352590;G;4759899;0;1;-1
163510;202104;352590;N;8299799;88;113;-25
164087;202104;352590;P;8512100;2;0;2
164236;202104;352590;H;5239799;1;0;1
164306;202104;352590;G;4729699;1;0;1
164728;202104;352590;G;4530703;0;2;-2
165060;202104;352590;H;5212500;4;5;-1
166022;202104;352590;C;3316301;1;1;0
166537;202104;352590;G;4731800;1;0;1
166929;202104;352590;F;4321500;0;1;-1
167013;202104;352590;N;7732201;0;3;-3
167383;202104;352590;N;7830200;0;1;-1
168077;202104;352590;G;4687703;0;1;-1
168276;202104;352590;J;6201501;4;5;-1
168917;202104;352590;H;4930202;1;0;1
169150;202104;352590;F;4399199;2;0;2
169180;202104;352590;G;4731800;0;2;-2
169356;202104;352590;G;4686902;0;1;-1
170064;202104;352590;Q;8630501;1;0;1
170164;202104;352590;G;4530704;0;1;-1
170403;202104;352590;J;5829800;0;1;-1
170504;202104;352590;G;4729699;0;1;-1
170548;202104;352590;F;4120400;2;4;-2
170962;202104;352590;G;4530703;8;1;7
171391;202104;352590;G;4744001;0;2;-2
171735;202104;352590;G;4744099;1;0;1
172055;202104;352590;P;8512100;1;0;1
172056;202104;352590;P;8512100;0;1;-1
172329;202104;352590;G;4781400;0;1;-1
172614;202104;352590;F;4213800;0;9;-9
173096;202104;352590;C;2840200;1;0;1
173109;202104;352590;G;4729699;1;1;0
173379;202104;352590;C;2539001;1;0;1
173541;202104;352590;H;5212500;10;15;-5
173636;202104;352590;N;8111700;13;7;6
173665;202104;352590;G;4721104;1;2;-1
173835;202104;352590;G;4672900;1;0;1
174057;202104;352590;G;4789001;0;2;-2
174625;202104;352590;N;7820500;2;3;-1
174683;202104;352590;G;4511101;1;0;1
174901;202104;352590;I;5611201;3;0;3
175203;202104;352590;I;5620104;0;1;-1
175504;202104;352590;F;4120400;2;0;2
176136;202104;352590;G;4782201;1;0;1
176233;202104;352590;H;4930202;0;1;-1
176807;202104;352590;G;4729699;1;5;-4
177311;202104;352590;F;4110700;1;0;1
177390;202104;352590;P;8599603;1;0;1
178208;202104;352590;G;4744001;1;0;1
178397;202104;352590;H;4930202;0;1;-1
178547;202104;352590;F;4222701;0;8;-8
178795;202104;352590;G;4789099;1;0;1
179017;202104;352590;G;4686902;16;4;12
179517;202104;352590;E;3832700;3;1;2
179804;202104;352590;I;5611201;0;4;-4
179825;202104;352590;I;5611201;1;1;0
179831;202104;352590;I;5611201;1;1;0
180171;202104;352590;C;2222600;1;6;-5
180540;202104;352590;J;6209100;0;1;-1
180671;202104;352590;K;6619399;1;1;0
180936;202104;352590;G;4511101;1;3;-2
181767;202104;352590;G;4789099;0;1;-1
182178;202104;352590;K;6462000;0;1;-1
182241;202104;352590;G;4774100;0;2;-2
182572;202104;352590;I;5611201;0;1;-1
182918;202104;352590;G;4754701;2;0;2
183245;202104;352590;L;6821801;0;1;-1
183814;202104;352590;H;4930203;0;1;-1
184609;202104;352590;P;8541400;1;0;1
184645;202104;352590;G;4731800;0;1;-1
184856;202104;352590;I;5611203;1;1;0
185299;202104;352590;I;5620101;0;1;-1
185823;202104;352590;G;4731800;5;2;3
186176;202104;352590;G;4789005;0;3;-3
186619;202104;352590;G;4754701;2;1;1
187230;202104;352590;M;6920601;0;1;-1
187474;202104;352590;M;7112000;5;3;2
187475;202104;352590;J;6204000;9;5;4
187648;202104;352590;G;4781400;1;0;1
189040;202104;352590;G;4771701;1;0;1
189573;202104;352590;F;4321500;4;0;4
189591;202104;352590;G;4772500;1;0;1
189793;202104;352590;G;4722901;2;2;0
189904;202104;352590;I;5611201;1;7;-6
190862;202104;352590;G;4789099;1;0;1
190952;202104;352590;I;5611201;0;3;-3
191220;202104;352590;G;4530703;0;1;-1
191382;202104;352590;M;6920601;0;1;-1
191565;202104;352590;N;8211300;1;0;1
191612;202104;352590;N;7739099;0;1;-1
191855;202104;352590;I;5620101;3;2;1
192000;202104;352590;C;1094500;1;1;0
192027;202104;352590;Q;8610101;0;9;-9
192535;202104;352590;N;8219999;2;0;2
192536;202104;352590;N;8219999;0;1;-1
192541;202104;352590;G;4686902;4;2;2
192625;202104;352590;G;4724500;3;4;-1
192626;202104;352590;G;4633801;0;1;-1
192627;202104;352590;G;4724500;10;3;7
192900;202104;352590;G;4663000;1;0;1
193158;202104;352590;L;6810201;0;1;-1
193775;202104;352590;M;7500100;1;0;1
193969;202104;352590;G;4789099;1;0;1
194222;202104;352590;P;8593700;0;1;-1
194335;202104;352590;C;2812700;1;0;1
194606;202104;352590;G;4721102;1;0;1
194881;202104;352590;I;5611201;1;1;0
195091;202104;352590;G;4744002;0;1;-1
195521;202104;352590;I;5510801;0;1;-1
195669;202104;352590;H;5250805;6;1;5
195718;202104;352590;C;2621300;1;12;-11
196183;202104;352590;G;4691500;6;9;-3
196568;202104;352590;C;3291400;1;1;0
197003;202104;352590;F;4330401;0;1;-1
197447;202104;352590;G;4520006;2;0;2
197465;202104;352590;C;2511000;7;1;6
197566;202104;352590;G;4731800;1;0;1
198567;202104;352590;G;4511101;0;1;-1
198927;202104;352590;G;4731800;1;1;0
199077;202104;352590;M;6920601;1;2;-1
199461;202104;352590;H;4930202;1;0;1
199555;202104;352590;N;8299799;0;1;-1
199639;202104;352590;H;5211701;1;0;1
199640;202104;352590;H;5211701;0;3;-3
199803;202104;352590;M;7119701;1;1;0
199998;202104;352590;C;2660400;118;2;116
200373;202104;352590;G;4757100;0;1;-1
200541;202104;352590;G;4771701;1;0;1
200636;202104;352590;Q;8640205;0;1;-1
200809;202104;352590;G;4712100;2;1;1
200975;202104;352590;G;4633801;0;1;-1
201982;202104;352590;P;8599604;1;2;-1
202010;202104;352590;G;4511101;0;1;-1
202175;202104;352590;I;5611201;0;1;-1
202309;202104;352590;G;4729699;1;0;1
202427;202104;352590;G;4781400;0;2;-2
202497;202104;352590;M;7490199;1;0;1
202797;202104;352590;Q;8630504;0;1;-1
202935;202104;352590;G;4731800;0;1;-1
202953;202104;352590;G;4782201;0;1;-1
203246;202104;352590;G;4520004;2;0;2
203329;202104;352590;Q;8640210;1;1;0
203539;202104;352590;C;2539001;1;0;1
203719;202104;352590;G;4754701;14;5;9
203724;202104;352590;G;4754701;0;1;-1
204126;202104;352590;N;8211300;2;2;0
204814;202104;352590;N;8220200;4;6;-2
205204;202104;352590;N;8299706;1;0;1
205275;202104;352590;G;4530703;1;0;1
206826;202104;352590;P;8599601;1;0;1
206971;202104;352590;N;8122200;3;0;3
207228;202104;352590;G;4744003;0;1;-1
208089;202104;352590;G;4789099;1;1;0
208396;202104;352590;G;4773300;1;0;1
208606;202104;352590;G;4742300;0;1;-1
209134;202104;352590;H;4930202;0;9;-9
209374;202104;352590;J;6204000;1;0;1
209538;202104;352590;G;4789099;0;1;-1
210100;202104;352590;I;5620102;0;1;-1
210559;202104;352590;H;4930202;0;1;-1
210912;202104;352590;C;2222600;8;5;3
211035;202104;352590;G;4754701;0;1;-1
211043;202104;352590;F;4292802;0;3;-3
211443;202104;352590;C;3314707;3;4;-1
211942;202104;352590;P;8512100;0;1;-1
211987;202104;352590;C;2651500;1;0;1
212405;202104;352590;M;6920601;0;1;-1
212618;202104;352590;N;8020001;1;1;0
213775;202104;352590;G;4731800;2;2;0
214253;202104;352590;K;6622300;2;0;2
214609;202104;352590;S;9609299;2;0;2
214626;202104;352590;G;4712100;0;1;-1
214627;202104;352590;N;8299799;8;2;6
214998;202104;352590;N;7911200;0;1;-1
215016;202104;352590;G;4511101;1;2;-1
215450;202104;352590;G;4789099;1;0;1
216481;202104;352590;F;4321500;2;0;2
216613;202104;352590;M;7311400;0;1;-1
216846;202104;352590;H;4930202;3;2;1
216991;202104;352590;M;6920601;3;1;2
217063;202104;352590;M;6920601;0;1;-1
217596;202104;352590;G;4772500;0;1;-1
217967;202104;352590;M;7111100;0;2;-2
218711;202104;352590;P;8511200;1;0;1
218975;202104;352590;H;4930202;8;17;-9
219157;202104;352590;F;4213800;1;0;1
219246;202104;352590;C;1099699;1;0;1
220404;202104;352590;C;1099699;1;0;1
220658;202104;352590;G;4530703;1;0;1
221154;202104;352590;N;8299799;1;0;1
221170;202104;352590;G;4712100;1;1;0
221199;202104;352590;G;4669999;1;0;1
222080;202104;352590;G;4623109;9;0;9
222104;202104;352590;G;4781400;5;10;-5
222116;202104;352590;G;4511104;1;2;-1
222142;202104;352590;P;8513900;1;1;0
222144;202104;352590;N;8130300;17;26;-9
222145;202104;352590;G;4789099;2;6;-4
222739;202104;352590;S;9601701;1;1;0
222821;202104;352590;G;4761003;0;1;-1
223040;202104;352590;C;2840200;2;0;2
223934;202104;352590;G;4633801;0;1;-1
223937;202104;352590;A;132600;0;2;-2
224243;202104;352590;N;8299799;0;3;-3
224266;202104;352590;C;3314710;2;0;2
224696;202104;352590;N;8299799;0;2;-2
224929;202104;352590;G;4721102;0;1;-1
224931;202104;352590;F;4399105;0;2;-2
225027;202104;352590;C;2311700;0;1;-1
225405;202104;352590;F;4322302;2;0;2
225685;202104;352590;G;4751201;0;2;-2
225706;202104;352590;H;5212500;8;7;1
225780;202104;352590;G;4771701;1;0;1
226066;202104;352590;C;3314721;1;0;1
226067;202104;352590;C;3314721;0;1;-1
226118;202104;352590;C;2349401;5;2;3
226337;202104;352590;C;2599399;0;1;-1
226575;202104;352590;Q;8630501;0;1;-1
226678;202104;352590;G;4789005;1;1;0
228000;202104;352590;G;4773300;3;0;3
228345;202104;352590;G;4754701;0;1;-1
229224;202104;352590;C;1412601;0;1;-1
229350;202104;352590;J;5911102;1;0;1
229871;202104;352590;C;2072000;1;2;-1
229929;202104;352590;G;4781400;0;1;-1
230456;202104;352590;N;8219999;0;1;-1
230635;202104;352590;G;4633801;1;1;0
230882;202104;352590;G;4731800;1;0;1
230992;202104;352590;Q;8711502;0;1;-1
231090;202104;352590;G;4649499;1;0;1
231498;202104;352590;I;5611201;1;0;1
232622;202104;352590;J;6209100;1;0;1
232675;202104;352590;G;4782201;1;1;0
232676;202104;352590;G;4782201;0;1;-1
232680;202104;352590;G;4782201;6;0;6
233359;202104;352590;Q;8712300;2;0;2
233564;202104;352590;C;1091101;0;3;-3
234188;202104;352590;G;4713002;1;1;0
235390;202104;352590;C;1733800;0;1;-1
235867;202104;352590;I;5620101;4;2;2
235890;202104;352590;P;8599603;1;1;0
236133;202104;352590;I;5611204;0;2;-2
236285;202104;352590;I;5611201;2;2;0
237002;202104;352590;G;4731800;0;1;-1
237081;202104;352590;N;8230001;1;0;1
237817;202104;352590;G;4789004;0;1;-1
238021;202104;352590;L;6822600;1;1;0
238137;202104;352590;F;4120400;1;1;0
238228;202104;352590;M;7420004;0;1;-1
238334;202104;352590;C;2229302;1;0;1
238622;202104;352590;J;6311900;4;0;4
239038;202104;352590;J;5811500;0;1;-1
239564;202104;352590;L;6821802;1;2;-1
239767;202104;352590;G;4743100;0;2;-2
240312;202104;352590;I;5611204;0;1;-1
240608;202104;352590;S;9609208;1;0;1
240723;202104;352590;G;4729699;0;1;-1
240814;202104;352590;C;1733800;4;4;0
241001;202104;352590;P;8520100;0;2;-2
241099;202104;352590;G;4530703;1;0;1
241795;202104;352590;G;4781400;0;1;-1
242322;202104;352590;I;5611201;0;4;-4
242417;202104;352590;N;8112500;1;1;0
242491;202104;352590;F;4330404;4;0;4
243260;202104;352590;G;4782201;0;2;-2
243608;202104;352590;C;1066000;3;11;-8
243999;202104;352590;G;4781400;0;3;-3
244000;202104;352590;G;4781400;0;1;-1
244081;202104;352590;S;9521500;6;0;6
244201;202104;352590;P;8599604;1;0;1
244633;202104;352590;G;4712100;1;0;1
244687;202104;352590;C;3250705;1;1;0
245243;202104;352590;E;3821100;6;7;-1
245245;202104;352590;I;5611201;1;0;1
245246;202104;352590;I;5611201;0;1;-1
245281;202104;352590;K;6462000;2;3;-1
245327;202104;352590;N;8111700;17;17;0
246487;202104;352590;F;4120400;4;0;4
246559;202104;352590;H;5223100;0;1;-1
246607;202104;352590;I;5611201;1;0;1
246920;202104;352590;M;7112000;0;2;-2
247084;202104;352590;G;4783101;0;1;-1
247147;202104;352590;G;4711302;0;1;-1
247300;202104;352590;C;3314708;1;0;1
247417;202104;352590;I;5611201;0;1;-1
247418;202104;352590;I;5611201;0;1;-1
247692;202104;352590;L;6822600;1;0;1
247791;202104;352590;G;4712100;1;1;0
247923;202104;352590;K;6462000;0;2;-2
248406;202104;352590;G;4744099;2;1;1
248903;202104;352590;G;4783101;1;0;1
248984;202104;352590;C;3250706;1;0;1
249614;202104;352590;N;8121400;5;0;5
249712;202104;352590;C;2342702;1;0;1
249739;202104;352590;P;8513900;2;0;2
250211;202104;352590;F;4120400;1;0;1
251089;202104;352590;P;8511200;0;1;-1
251231;202104;352590;M;7420001;2;2;0
251301;202104;352590;C;3314704;1;0;1
251659;202104;352590;R;9329804;0;3;-3
251938;202104;352590;M;6920601;1;1;0
252290;202104;352590;G;4774100;0;1;-1
252495;202104;352590;G;4759899;1;0;1
253555;202104;352590;S;9602502;0;6;-6
253788;202104;352590;P;8511200;1;0;1
253791;202104;352590;G;4743100;0;1;-1
253920;202104;352590;I;5611203;0;1;-1
254273;202104;352590;H;4930202;2;7;-5
254813;202104;352590;C;3314708;1;0;1
255566;202104;352590;S;9420100;0;1;-1
256000;202104;352590;M;6920601;0;1;-1
256172;202104;352590;G;4772500;1;0;1
256176;202104;352590;G;4772500;0;1;-1
256180;202104;352590;G;4772500;0;1;-1
256504;202104;352590;S;9511800;1;0;1
256921;202104;352590;G;4530701;0;1;-1
256922;202104;352590;G;4530703;0;2;-2
257093;202104;352590;N;8111700;2;0;2
257630;202104;352590;N;8291100;1;0;1
257799;202104;352590;G;4691500;7;2;5
258976;202104;352590;G;4637199;0;3;-3
259287;202104;352590;I;5611203;0;2;-2
259344;202104;352590;I;5611203;0;2;-2
259352;202104;352590;I;5611203;0;1;-1
259758;202104;352590;I;5611203;0;2;-2
260161;202104;352590;G;4687702;0;2;-2
260336;202104;352590;G;4663000;2;0;2
260650;202104;352590;H;4930202;6;2;4
261100;202104;352590;F;4120400;3;0;3
262219;202104;352590;N;7733100;2;0;2
262223;202104;352590;N;7733100;2;0;2
262268;202104;352590;G;4637199;0;1;-1
262913;202104;352590;I;5611201;0;1;-1
262935;202104;352590;I;5611201;0;2;-2
263450;202104;352590;Q;8630502;0;2;-2
263626;202104;352590;G;4761003;2;0;2
263726;202104;352590;H;4930202;0;2;-2
264028;202104;352590;G;4689399;2;3;-1
264272;202104;352590;F;4213800;0;1;-1
264856;202104;352590;G;4669999;6;4;2
264937;202104;352590;N;7990200;1;0;1
266390;202104;352590;I;5611203;0;2;-2
267448;202104;352590;P;8591100;0;1;-1
268135;202104;352590;G;4722901;0;1;-1
268359;202104;352590;G;4543900;1;0;1
269105;202104;352590;G;4781400;0;2;-2
269336;202104;352590;Q;8630504;0;1;-1
269424;202104;352590;H;4930201;0;2;-2
269457;202104;352590;P;8541400;1;0;1
269816;202104;352590;G;4530703;1;0;1
269991;202104;352590;F;4221905;0;1;-1
270221;202104;352590;M;6920601;1;1;0
270506;202104;352590;M;7020400;9;0;9
270706;202104;352590;K;6619399;0;2;-2
270707;202104;352590;K;6622300;0;3;-3
270938;202104;352590;C;3314719;1;0;1
271070;202104;352590;G;4646001;0;1;-1
271901;202104;352590;C;2731700;5;0;5
272362;202104;352590;G;4789099;2;0;2
272365;202104;352590;Q;8640205;1;0;1
272366;202104;352590;Q;8640205;2;0;2
273008;202104;352590;H;5211701;72;56;16
274154;202104;352590;G;4530704;3;3;0
274218;202104;352590;G;4753900;0;1;-1
274753;202104;352590;G;4530705;0;1;-1
274950;202104;352590;G;4771701;1;0;1
275683;202104;352590;C;3314702;3;1;2
275687;202104;352590;G;4744001;1;1;0
275870;202104;352590;G;4754701;7;8;-1
276093;202104;352590;P;8593700;0;1;-1
276575;202104;352590;G;4744099;4;0;4
276577;202104;352590;N;8299799;0;1;-1
276589;202104;352590;G;4771702;3;0;3
276594;202104;352590;C;1091101;2;7;-5
276597;202104;352590;C;2599399;0;4;-4
276739;202104;352590;C;3314708;3;2;1
277291;202104;352590;C;3314710;1;0;1
277292;202104;352590;C;3314710;0;1;-1
277733;202104;352590;N;8211300;2;0;2
277906;202104;352590;H;4930202;6;1;5
278573;202104;352590;G;4759899;0;1;-1
278617;202104;352590;P;8520100;0;1;-1
279297;202104;352590;G;4781400;0;1;-1
279388;202104;352590;G;4772500;0;2;-2
279757;202104;352590;I;5620102;1;0;1
279882;202104;352590;Q;8630502;2;0;2
280301;202104;352590;N;7911200;0;6;-6
281238;202104;352590;F;4399199;1;3;-2
281757;202104;352590;G;4530703;2;3;-1
281875;202104;352590;G;4761001;0;1;-1
282955;202104;352590;G;4623109;1;1;0
283306;202104;352590;F;4322303;3;2;1
283830;202104;352590;I;5620104;0;2;-2
283953;202104;352590;I;5611201;0;1;-1
284034;202104;352590;G;4741500;0;1;-1
284036;202104;352590;C;2522500;0;1;-1
284753;202104;352590;G;4772500;0;1;-1
284837;202104;352590;F;4120400;13;1;12
284983;202104;352590;E;3702900;0;1;-1
285380;202104;352590;G;4741500;1;1;0
286461;202104;352590;N;7810800;2;3;-1
286470;202104;352590;G;4721104;3;9;-6
286471;202104;352590;G;4637107;1;2;-1
286498;202104;352590;H;4930202;2;0;2
286539;202104;352590;S;9511800;1;0;1
286550;202104;352590;C;3101200;1;4;-3
286551;202104;352590;G;4754701;0;2;-2
286552;202104;352590;G;4754701;1;2;-1
286682;202104;352590;J;6209100;3;0;3
286885;202104;352590;C;3321000;2;0;2
286948;202104;352590;I;5611203;1;0;1
287411;202104;352590;J;6190699;0;1;-1
287757;202104;352590;C;1053800;0;9;-9
288074;202104;352590;Q;8712300;1;3;-2
288406;202104;352590;F;4120400;6;1;5
288741;202104;352590;G;4772500;0;2;-2
288809;202104;352590;G;4757100;2;0;2
289248;202104;352590;G;4782201;0;1;-1
289428;202104;352590;I;5620104;0;1;-1
290451;202104;352590;G;4781400;0;1;-1
292188;202104;352590;H;5212500;0;1;-1
292583;202104;352590;G;4781400;0;1;-1
292847;202104;352590;M;7112000;0;47;-47
293008;202104;352590;N;7711000;0;1;-1
293316;202104;352590;Q;8630503;1;0;1
293969;202104;352590;H;5320202;0;2;-2
293997;202104;352590;G;4712100;0;1;-1
294359;202104;352590;P;8511200;0;2;-2
294730;202104;352590;I;5611201;0;1;-1
294759;202104;352590;N;8111700;0;2;-2
295147;202104;352590;G;4782201;0;2;-2
295415;202104;352590;N;7911200;1;0;1
295627;202104;352590;G;4782201;1;0;1
295921;202104;352590;I;5611203;1;2;-1
295986;202104;352590;S;9601701;2;0;2
296013;202104;352590;N;8111700;1;1;0
296181;202104;352590;H;4930202;7;15;-8
296188;202104;352590;F;4321500;0;1;-1
296598;202104;352590;G;4759899;1;0;1
296615;202104;352590;I;5611203;0;1;-1
297105;202104;352590;M;6911701;0;1;-1
297609;202104;352590;G;4754701;1;0;1
297735;202104;352590;G;4744004;0;1;-1
297747;202104;352590;P;8511200;0;1;-1
297843;202104;352590;G;4712100;1;0;1
298624;202104;352590;N;8219999;1;0;1
298640;202104;352590;G;4781400;0;1;-1
299167;202104;352590;I;5611203;1;0;1
299460;202104;352590;C;2229302;2;1;1
299726;202104;352590;I;5611201;1;0;1
299982;202104;352590;S;9603301;2;2;0
300043;202104;352590;C;3321000;3;0;3
300320;202104;352590;K;6422100;1;0;1
300610;202104;352590;H;4930202;0;1;-1
300844;202104;352590;H;5240199;0;1;-1
300848;202104;352590;Q;8630504;2;0;2
301004;202104;352590;P;8511200;1;0;1
302028;202104;352590;G;4774100;3;0;3
303716;202104;352590;H;4930202;1;0;1
304794;202104;352590;G;4742300;0;1;-1
305810;202104;352590;G;4751201;1;0;1
306007;202104;352590;H;5250803;2;2;0
306272;202104;352590;G;4520005;14;19;-5
306383;202104;352590;H;4930201;1;1;0
306578;202104;352590;M;7120100;1;2;-1
306919;202104;352590;N;8219999;2;5;-3
307018;202104;352590;G;4721104;0;1;-1
307043;202104;352590;G;4721104;0;3;-3
307344;202104;352590;H;4930202;1;0;1
307979;202104;352590;F;4120400;12;4;8
308211;202104;352590;M;7319003;1;1;0
308217;202104;352590;H;4930202;1;0;1
308246;202104;352590;I;5620104;0;1;-1
308577;202104;352590;G;4663000;3;3;0
308597;202104;352590;G;4511102;1;0;1
309555;202104;352590;G;4663000;1;1;0
310213;202104;352590;H;5250804;1;0;1
310431;202104;352590;F;4120400;10;7;3
310494;202104;352590;C;3250701;4;1;3
310731;202104;352590;N;8111700;3;0;3
311272;202104;352590;M;7020400;1;0;1
311486;202104;352590;G;4711302;0;1;-1
311856;202104;352590;G;4721104;0;2;-2
312010;202104;352590;G;4614100;1;1;0
312019;202104;352590;G;4771702;4;5;-1
312090;202104;352590;N;8299799;7;1;6
312630;202104;352590;F;4222701;0;1;-1
312967;202104;352590;G;4789099;0;1;-1
313894;202104;352590;G;4754701;0;1;-1
313896;202104;352590;Q;8630501;0;1;-1
314467;202104;352590;G;4744002;0;1;-1
314590;202104;352590;G;4752100;1;0;1
314930;202104;352590;F;4120400;3;0;3
315149;202104;352590;H;4930201;0;1;-1
315151;202104;352590;H;4930201;8;4;4
315625;202104;352590;S;9602501;2;1;1
315629;202104;352590;M;7500100;1;0;1
316333;202104;352590;I;5611201;3;0;3
316427;202104;352590;G;4789004;0;2;-2
316566;202104;352590;M;7319003;2;1;1
316626;202104;352590;F;4399199;0;1;-1
316710;202104;352590;Q;8650004;0;1;-1
316806;202104;352590;G;4744005;1;0;1
316823;202104;352590;Q;8711502;1;0;1
318438;202104;352590;H;4930202;0;1;-1
318892;202104;352590;F;4292802;0;1;-1
319048;202104;352590;G;4732600;0;1;-1
319122;202104;352590;G;4782201;0;1;-1
319841;202104;352590;G;4751201;2;2;0
320169;202104;352590;C;2033900;0;1;-1
320199;202104;352590;G;4789004;0;1;-1
320319;202104;352590;N;8011101;5;2;3
321063;202104;352590;G;4774100;2;1;1
321184;202104;352590;L;6822600;3;0;3
322416;202104;352590;G;4663000;2;1;1
322773;202104;352590;N;8111700;1;3;-2
323137;202104;352590;N;7912100;2;2;0
323273;202104;352590;N;7911200;0;1;-1
323931;202104;352590;G;4724500;1;1;0
325437;202104;352590;C;1013901;15;1;14
325526;202104;352590;S;9601701;2;0;2
325766;202104;352590;G;4782201;0;1;-1
326471;202104;352590;H;4930202;0;1;-1
326635;202104;352590;I;5611203;0;1;-1
326723;202104;352590;H;5229002;0;1;-1
326802;202104;352590;P;8599604;0;2;-2
326816;202104;352590;K;6462000;1;0;1
326871;202104;352590;G;4781400;0;1;-1
329307;202104;352590;C;2222600;3;2;1
330075;202104;352590;G;4783101;0;1;-1
330469;202104;352590;G;4530704;1;0;1
331388;202104;352590;R;9313100;3;0;3
331647;202104;352590;C;3212400;1;1;0
331870;202104;352590;C;2532201;1;0;1
332387;202104;352590;F;4330402;1;1;0
332499;202104;352590;N;8220200;235;50;185
332520;202104;352590;M;7490104;0;1;-1
333205;202104;352590;F;4399103;0;6;-6
333325;202104;352590;M;6920601;1;1;0
333901;202104;352590;G;4753900;0;3;-3
334251;202104;352590;J;6202300;0;1;-1
334941;202104;352590;H;4930202;2;0;2
335191;202104;352590;G;4520002;0;4;-4
335235;202104;352590;S;9430800;0;1;-1
337234;202104;352590;J;6204000;3;0;3
337559;202104;352590;I;5611201;0;1;-1
337698;202104;352590;M;7119703;2;0;2
338974;202104;352590;G;4761001;0;2;-2
339559;202104;352590;I;5611201;0;3;-3
340207;202104;352590;P;8593700;1;0;1
340468;202104;352590;G;4520002;2;0;2
340530;202104;352590;N;8130300;3;5;-2
340648;202104;352590;G;4652400;0;2;-2
340753;202104;352590;G;4744002;2;2;0
340819;202104;352590;F;4321500;5;4;1
340903;202104;352590;F;4120400;146;78;68
341172;202104;352590;C;2222600;1;0;1
341291;202104;352590;C;3314720;1;0;1
341984;202104;352590;J;6202300;0;1;-1
342514;202104;352590;F;4330405;17;2;15
342813;202104;352590;G;4530703;1;0;1
342848;202104;352590;G;4530703;1;2;-1
343412;202104;352590;M;7020400;0;1;-1
343519;202104;352590;N;8122200;1;1;0
343521;202104;352590;G;4530705;1;0;1
343525;202104;352590;H;4930201;2;1;1
343613;202104;352590;G;4721102;2;0;2
343689;202104;352590;F;4120400;3;4;-1
343722;202104;352590;H;4930202;2;0;2
343737;202104;352590;G;4721102;0;1;-1
344358;202104;352590;G;4721102;1;0;1
344945;202104;352590;I;5611203;1;0;1
345292;202104;352590;G;4754701;4;0;4
345947;202104;352590;S;9511800;2;0;2
345957;202104;352590;M;7319003;1;0;1
346639;202104;352590;J;6201501;1;1;0
346893;202104;352590;H;4930202;4;6;-2
347034;202104;352590;Q;8712300;4;3;1
347431;202104;352590;Q;8630504;0;1;-1
347512;202104;352590;Q;8630502;0;1;-1
347600;202104;352590;I;5611203;0;1;-1
347772;202104;352590;H;5223100;1;0;1
348143;202104;352590;F;4299599;0;1;-1
349493;202104;352590;P;8550302;0;8;-8
349500;202104;352590;P;8599699;2;0;2
350664;202104;352590;H;4930201;4;1;3
350881;202104;352590;G;4752100;0;1;-1
350911;202104;352590;S;9602502;1;0;1
351232;202104;352590;L;6821801;0;1;-1
351445;202104;352590;N;7820500;0;6;-6
351973;202104;352590;G;4781400;0;1;-1
352395;202104;352590;P;8512100;1;1;0
352983;202104;352590;S;9601701;1;0;1
353288;202104;352590;G;4712100;1;1;0
353672;202104;352590;I;5611203;0;1;-1
353691;202104;352590;G;4781400;1;1;0
354111;202104;352590;G;4731800;1;2;-1
354206;202104;352590;G;4723700;0;1;-1
354586;202104;352590;H;4930202;2;0;2
354824;202104;352590;I;5611201;0;1;-1
354974;202104;352590;C;2949299;8;7;1
355047;202104;352590;H;4930202;7;0;7
355110;202104;352590;G;4781400;0;1;-1
356120;202104;352590;G;4713002;0;1;-1
356577;202104;352590;N;8111700;1;0;1
356613;202104;352590;P;8593700;0;1;-1
356854;202104;352590;G;4669999;5;2;3
356865;202104;352590;M;6920601;1;1;0
357076;202104;352590;F;4329199;1;0;1
357421;202104;352590;S;9511800;1;1;0
358023;202104;352590;G;4672900;0;1;-1
358558;202104;352590;G;4754701;1;1;0
358623;202104;352590;J;6209100;1;0;1
359316;202104;352590;S;9602501;0;1;-1
359769;202104;352590;K;6619302;0;1;-1
359864;202104;352590;G;4754701;0;1;-1
359865;202104;352590;M;6920601;1;0;1
360248;202104;352590;G;4771701;0;1;-1
361239;202104;352590;I;5611201;1;0;1
361444;202104;352590;M;7020400;0;1;-1
361747;202104;352590;H;4930202;24;5;19
362005;202104;352590;G;4781400;2;0;2
362112;202104;352590;C;1091102;1;0;1
362729;202104;352590;G;4672900;1;0;1
362818;202104;352590;N;8121400;6;0;6
362819;202104;352590;N;8121400;0;4;-4
362838;202104;352590;G;4723700;2;0;2
363391;202104;352590;N;8130300;0;2;-2
363491;202104;352590;F;4399199;2;3;-1
363814;202104;352590;G;4789003;0;1;-1
363935;202104;352590;G;4757100;0;1;-1
365193;202104;352590;P;8511200;0;1;-1
365866;202104;352590;L;6810201;1;0;1
365928;202104;352590;G;4530703;0;1;-1
366820;202104;352590;G;4645101;35;1;34
367229;202104;352590;C;1099699;1;0;1
367458;202104;352590;G;4783101;0;1;-1
367868;202104;352590;G;4741500;0;2;-2
368584;202104;352590;G;4722901;0;2;-2
369282;202104;352590;M;7119704;0;1;-1
369709;202104;352590;I;5611201;0;1;-1
370418;202104;352590;M;7112000;0;2;-2
370641;202104;352590;M;7112000;2;1;1
370804;202104;352590;P;8599603;1;2;-1
371031;202104;352590;H;5212500;4;7;-3
371157;202104;352590;G;4731800;0;1;-1
371230;202104;352590;C;1412601;10;5;5
371351;202104;352590;F;4321500;3;1;2
371382;202104;352590;G;4713004;0;1;-1
371992;202104;352590;N;8219999;0;1;-1
372077;202104;352590;C;2950600;2;0;2
372135;202104;352590;G;4520001;0;1;-1
372551;202104;352590;S;9499500;1;1;0
373374;202104;352590;G;4759899;1;1;0
373658;202104;352590;C;1042200;0;3;-3
373749;202104;352590;G;4754701;1;1;0
374060;202104;352590;G;4731800;1;1;0
374219;202104;352590;R;9313100;0;1;-1
374620;202104;352590;P;8599603;0;1;-1
374741;202104;352590;M;7490104;1;0;1
374908;202104;352590;L;6822600;4;0;4
374940;202104;352590;P;8512100;2;0;2
375057;202104;352590;Q;8630504;0;1;-1
375172;202104;352590;G;4729699;1;33;-32
375859;202104;352590;I;5611201;2;1;1
376169;202104;352590;S;9602502;1;0;1
376240;202104;352590;N;8111700;2;1;1
377223;202104;352590;H;5250804;0;1;-1
378198;202104;352590;S;9499500;2;0;2
378318;202104;352590;I;5620101;2;4;-2
378319;202104;352590;I;5620101;4;2;2
378322;202104;352590;I;5620101;4;2;2
378594;202104;352590;J;6190601;0;1;-1
379263;202104;352590;S;9529105;1;0;1
379290;202104;352590;G;4753900;0;3;-3
379396;202104;352590;C;3314708;1;0;1
379589;202104;352590;G;4633801;1;0;1
380623;202104;352590;H;5211701;2;3;-1
381552;202104;352590;P;8512100;0;1;-1
381806;202104;352590;G;4754701;1;0;1
381992;202104;352590;N;8220200;191;113;78
381995;202104;352590;N;8211300;0;3;-3
382443;202104;352590;J;6209100;1;1;0
383445;202104;352590;G;4774100;0;1;-1
384141;202104;352590;G;4772500;1;0;1
385219;202104;352590;P;8599604;1;0;1
385447;202104;352590;H;4930201;29;13;16
385466;202104;352590;Q;8630502;1;1;0
385497;202104;352590;L;6822600;0;1;-1
385556;202104;352590;F;4221904;9;3;6
385613;202104;352590;I;5611201;0;1;-1
385641;202104;352590;R;9001999;0;1;-1
385725;202104;352590;H;4930201;1;1;0
386536;202104;352590;G;4729602;0;1;-1
386738;202104;352590;H;4930202;1;1;0
386878;202104;352590;R;9313100;0;1;-1
387579;202104;352590;N;8299799;32;15;17
387640;202104;352590;F;4399103;2;0;2
387653;202104;352590;N;8111700;3;3;0
388017;202104;352590;H;4930202;2;1;1
388256;202104;352590;G;4530703;1;0;1
388257;202104;352590;G;4530703;0;1;-1
389143;202104;352590;G;4711302;1;2;-1
389881;202104;352590;P;8599604;9;7;2
390024;202104;352590;K;6622300;0;1;-1
390916;202104;352590;G;4639701;3;8;-5
391094;202104;352590;G;4520007;1;1;0
391326;202104;352590;N;8111700;2;1;1
391919;202104;352590;G;4520004;0;1;-1
391926;202104;352590;C;1095300;0;3;-3
392544;202104;352590;G;4712100;0;1;-1
392986;202104;352590;G;4753900;0;16;-16
393774;202104;352590;N;8112500;0;1;-1
394312;202104;352590;G;4759899;0;1;-1
394461;202104;352590;G;4759899;0;2;-2
394619;202104;352590;G;4771701;1;0;1
395538;202104;352590;C;2943300;1;1;0
395825;202104;352590;J;6209100;5;3;2
395905;202104;352590;C;2941700;1;0;1
396201;202104;352590;M;7112000;2;2;0
396343;202104;352590;I;5620104;1;0;1
396360;202104;352590;I;5611201;0;2;-2
396368;202104;352590;N;8211300;2;0;2
396639;202104;352590;G;4753900;0;1;-1
396767;202104;352590;G;4731800;0;1;-1
396800;202104;352590;F;4312600;1;1;0
396981;202104;352590;Q;8640203;2;0;2
397176;202104;352590;I;5611203;2;1;1
397179;202104;352590;I;5611203;3;1;2
397180;202104;352590;I;5611203;3;5;-2
397182;202104;352590;I;5611203;5;3;2
398699;202104;352590;C;3314707;0;1;-1
398769;202104;352590;G;4781400;2;1;1
398914;202104;352590;H;4930202;2;0;2
399262;202104;352590;Q;8630503;1;0;1
399458;202104;352590;G;4511102;1;0;1
399471;202104;352590;L;6821801;0;1;-1
400107;202104;352590;G;4637199;4;1;3
400384;202104;352590;J;6319400;0;1;-1
400763;202104;352590;G;4782201;0;1;-1
400770;202104;352590;Q;8711502;1;0;1
400986;202104;352590;K;6462000;2;2;0
402027;202104;352590;G;4789099;2;0;2
403001;202104;352590;G;4722901;3;0;3
403002;202104;352590;G;4722901;0;2;-2
403417;202104;352590;C;2943300;0;1;-1
403657;202104;352590;N;8130300;2;1;1
405315;202104;352590;P;8599603;0;1;-1
405331;202104;352590;G;4781400;0;1;-1
406435;202104;352590;I;5620104;1;0;1
408240;202104;352590;H;5250804;0;4;-4
408850;202104;352590;G;4729699;1;1;0
409196;202104;352590;G;4520007;1;0;1
409238;202104;352590;I;5620104;0;1;-1
409969;202104;352590;G;4789099;1;1;0
409971;202104;352590;Q;8630504;2;0;2
410722;202104;352590;H;4930202;0;2;-2
410728;202104;352590;F;4313400;1;1;0
411056;202104;352590;H;4930202;1;0;1
411109;202104;352590;M;6911701;1;0;1
411120;202104;352590;H;4930202;1;0;1
411569;202104;352590;C;1069400;0;3;-3
412726;202104;352590;G;4755502;0;1;-1
412939;202104;352590;F;4321500;1;0;1
412949;202104;352590;G;4789099;0;1;-1
413586;202104;352590;G;4729699;2;0;2
413637;202104;352590;Q;8640202;0;6;-6
413912;202104;352590;S;9603301;0;1;-1
413951;202104;352590;H;5250804;5;2;3
414206;202104;352590;G;4774100;1;0;1
414475;202104;352590;S;9529199;0;1;-1
414597;202104;352590;G;4530703;1;0;1
414644;202104;352590;Q;8630504;1;0;1
414651;202104;352590;G;4774100;0;1;-1
414709;202104;352590;N;8111700;0;1;-1
414792;202104;352590;J;6202300;1;1;0
414815;202104;352590;N;8219901;1;0;1
414870;202104;352590;N;8011101;1;1;0
415242;202104;352590;G;4724500;1;0;1
415478;202104;352590;G;4729602;1;0;1
415483;202104;352590;G;4729602;1;0;1
415580;202104;352590;F;4221902;0;1;-1
415610;202104;352590;G;4724500;0;1;-1
416974;202104;352590;F;4292802;30;14;16
417092;202104;352590;R;9313100;0;3;-3
417154;202104;352590;I;5611203;0;2;-2
417216;202104;352590;G;4520006;1;0;1
417278;202104;352590;S;9601701;0;2;-2
418183;202104;352590;G;4773300;0;1;-1
418858;202104;352590;M;7319003;2;4;-2
418938;202104;352590;F;4120400;0;2;-2
419520;202104;352590;G;4686902;2;2;0
419780;202104;352590;C;3314713;3;1;2
419893;202104;352590;I;5611201;0;1;-1
419918;202104;352590;J;6319400;1;0;1
420813;202104;352590;M;6920601;1;0;1
421340;202104;352590;F;4330403;3;0;3
421679;202104;352590;H;4930202;3;2;1
422120;202104;352590;C;2592601;1;0;1
422295;202104;352590;I;5611201;1;1;0
422338;202104;352590;Q;8630503;2;0;2
423148;202104;352590;G;4731800;1;0;1
423200;202104;352590;R;9321200;0;4;-4
423690;202104;352590;G;4781400;0;1;-1
424422;202104;352590;K;6462000;0;1;-1
424664;202104;352590;G;4711302;1;0;1
424945;202104;352590;N;8122200;1;1;0
424972;202104;352590;Q;8630504;0;1;-1
425418;202104;352590;M;7490104;1;0;1
426064;202104;352590;N;8121400;1;1;0
426270;202104;352590;M;7112000;1;1;0
427080;202104;352590;G;4755501;1;0;1
427220;202104;352590;G;4530703;0;1;-1
427760;202104;352590;G;4722901;1;0;1
427829;202104;352590;N;8112500;1;0;1
427985;202104;352590;C;2511000;3;3;0
428094;202104;352590;J;6201501;0;1;-1
428388;202104;352590;G;4693100;0;1;-1
428847;202104;352590;G;4520003;0;1;-1
428881;202104;352590;N;8299799;1;0;1
429801;202104;352590;G;4729602;1;0;1
429973;202104;352590;Q;8640202;0;2;-2
429980;202104;352590;G;4711302;2;3;-1
430241;202104;352590;C;2539001;0;1;-1
430288;202104;352590;G;4721102;1;1;0
430352;202104;352590;N;7820500;7;10;-3
431389;202104;352590;N;7729299;0;1;-1
431607;202104;352590;I;5611203;0;1;-1
431940;202104;352590;G;4729699;0;1;-1
432358;202104;352590;C;3314713;0;1;-1
432443;202104;352590;G;4729699;0;1;-1
432475;202104;352590;G;4781400;0;1;-1
432935;202104;352590;G;4789099;1;0;1
433033;202104;352590;F;4330404;2;1;1
433191;202104;352590;G;4713002;2;0;2
433243;202104;352590;I;5611203;1;0;1
434256;202104;352590;N;7739099;1;0;1
434430;202104;352590;H;4930202;2;0;2
434546;202104;352590;H;4930202;2;2;0
435555;202104;352590;I;5611203;0;1;-1
435811;202104;352590;N;8121400;0;1;-1
436250;202104;352590;G;4773300;0;1;-1
436403;202104;352590;R;9321200;2;0;2
437366;202104;352590;G;4520002;2;0;2
437532;202104;352590;M;6911701;1;0;1
437612;202104;352590;F;4110700;1;0;1
437750;202104;352590;Q;8640202;1;0;1
437817;202104;352590;Q;8630504;2;1;1
438060;202104;352590;G;4729699;1;0;1
438104;202104;352590;G;4772500;0;1;-1
438415;202104;352590;G;4722901;3;1;2
439954;202104;352590;I;5620104;0;1;-1
440247;202104;352590;H;4930201;1;0;1
440338;202104;352590;J;6110803;1;0;1
440522;202104;352590;G;4729699;1;0;1
440745;202104;352590;I;5620104;1;2;-1
441042;202104;352590;P;8599604;1;0;1
441212;202104;352590;I;5620101;3;1;2
441321;202104;352590;F;4120400;5;7;-2
442027;202104;352590;G;4729602;1;0;1
442532;202104;352590;P;8512100;2;2;0
442571;202104;352590;G;4520002;0;1;-1
442703;202104;352590;H;5212500;1;6;-5
443001;202104;352590;C;1053800;0;2;-2
443002;202104;352590;G;4751201;1;0;1
443217;202104;352590;I;5611201;1;3;-2
444051;202104;352590;I;5611203;0;1;-1
444144;202104;352590;G;4721102;0;6;-6
444394;202104;352590;G;4530705;0;1;-1
444395;202104;352590;I;5620101;2;1;1
444775;202104;352590;R;9313100;0;1;-1
445039;202104;352590;M;7112000;13;1;12
445550;202104;352590;G;4712100;2;0;2
445737;202104;352590;S;9603304;1;0;1
445860;202104;352590;G;4789099;0;3;-3
445862;202104;352590;P;8599605;5;0;5
446014;202104;352590;N;8211300;1;0;1
446058;202104;352590;J;6319400;0;1;-1
447046;202104;352590;G;4744005;0;1;-1
447069;202104;352590;P;8593700;0;1;-1
447134;202104;352590;I;5611201;1;0;1
447406;202104;352590;G;4772500;1;2;-1
447436;202104;352590;G;4771701;0;1;-1
447478;202104;352590;I;5611203;0;1;-1
447630;202104;352590;G;4781400;0;1;-1
447669;202104;352590;I;5611203;0;2;-2
448191;202104;352590;Q;8650003;0;1;-1
448856;202104;352590;M;7112000;6;3;3
449056;202104;352590;G;4781400;1;0;1
449464;202104;352590;F;4399199;0;2;-2
449580;202104;352590;H;4930201;0;2;-2
449948;202104;352590;H;4930201;1;0;1
450162;202104;352590;G;4789004;1;1;0
450682;202104;352590;Q;8630504;0;1;-1
451666;202104;352590;I;5611201;0;1;-1
452081;202104;352590;F;4399103;1;0;1
452275;202104;352590;N;8291100;2;2;0
452405;202104;352590;G;4729699;2;0;2
452419;202104;352590;I;5611201;1;1;0
453031;202104;352590;F;4120400;3;2;1
453186;202104;352590;C;2521700;0;1;-1
453284;202104;352590;I;5611201;0;1;-1
453860;202104;352590;I;5611201;1;1;0
453982;202104;352590;G;4729699;0;4;-4
454323;202104;352590;G;4511101;1;1;0
454378;202104;352590;S;9499500;1;0;1
455698;202104;352590;G;4530705;1;0;1
455837;202104;352590;S;9601701;2;0;2
455843;202104;352590;G;4721104;0;1;-1
455844;202104;352590;C;1091102;1;0;1
456035;202104;352590;F;4321500;1;0;1
456255;202104;352590;G;4723700;0;2;-2
456331;202104;352590;G;4784900;0;1;-1
456975;202104;352590;J;6204000;1;0;1
457532;202104;352590;H;4930202;0;1;-1
458214;202104;352590;S;9601703;13;11;2
458632;202104;352590;H;4930202;2;3;-1
458749;202104;352590;C;3101200;1;0;1
458838;202104;352590;H;4930201;1;0;1
458848;202104;352590;C;3314799;0;1;-1
458871;202104;352590;G;4781400;1;0;1
459159;202104;352590;N;7732201;2;3;-1
459281;202104;352590;Q;8630502;1;0;1
459854;202104;352590;N;8111700;0;1;-1
461480;202104;352590;S;9602501;0;1;-1
461588;202104;352590;H;4930202;0;1;-1
462614;202104;352590;I;5611201;1;1;0
462720;202104;352590;M;7112000;0;1;-1
463095;202104;352590;G;4771701;1;0;1
463584;202104;352590;M;7112000;1;0;1
464144;202104;352590;N;8211300;0;1;-1
464326;202104;352590;I;5620101;1;1;0
464454;202104;352590;G;4711301;5;8;-3
464819;202104;352590;F;4321500;1;0;1
465247;202104;352590;I;5611201;0;1;-1
465515;202104;352590;I;5611203;1;0;1
465790;202104;352590;P;8599603;0;1;-1
466207;202104;352590;I;5620104;0;1;-1
466262;202104;352590;G;4783101;0;1;-1
467014;202104;352590;M;7119701;0;1;-1
467133;202104;352590;M;7112000;15;2;13
467356;202104;352590;N;8219999;0;1;-1
467484;202104;352590;G;4711302;3;0;3
467718;202104;352590;P;8599699;1;0;1
468368;202104;352590;F;4322303;2;1;1
468822;202104;352590;H;4930202;1;0;1
469416;202104;352590;G;4789099;2;0;2
469434;202104;352590;G;4520005;1;1;0
470165;202104;352590;G;4781400;0;1;-1
470230;202104;352590;G;4781400;0;2;-2
471356;202104;352590;H;5320202;3;4;-1
471937;202104;352590;F;4321500;0;3;-3
472346;202104;352590;Q;8630504;1;0;1
472382;202104;352590;P;8593700;1;2;-1
472917;202104;352590;G;4530703;0;1;-1
473843;202104;352590;G;4729699;0;1;-1
474283;202104;352590;N;8111700;3;0;3
474384;202104;352590;N;7810800;4;5;-1
474520;202104;352590;G;4520002;0;1;-1
474613;202104;352590;N;8121400;1;5;-4
475253;202104;352590;F;4299599;5;0;5
475422;202104;352590;G;4782201;0;1;-1
475556;202104;352590;G;4639701;6;8;-2
476159;202104;352590;N;7739099;17;0;17
476268;202104;352590;G;4752100;0;1;-1
476484;202104;352590;G;4637199;9;1;8
476489;202104;352590;N;7739099;0;1;-1
477581;202104;352590;Q;8630504;0;1;-1
478439;202104;352590;P;8599604;1;1;0
479109;202104;352590;M;7119701;0;1;-1
479281;202104;352590;H;4930202;0;1;-1
481075;202104;352590;N;8020001;1;0;1
481643;202104;352590;C;2222600;3;1;2
481717;202104;352590;M;7319002;2;3;-1
482768;202104;352590;G;4722902;0;1;-1
483777;202104;352590;I;5620104;2;0;2
484042;202104;352590;M;7490104;7;1;6
484113;202104;352590;I;5611203;0;1;-1
484430;202104;352590;Q;8630504;0;1;-1
484571;202104;352590;C;3321000;1;0;1
485987;202104;352590;G;4789002;2;3;-1
486112;202104;352590;G;4781400;0;1;-1
486273;202104;352590;G;4721104;1;0;1
487416;202104;352590;C;1091102;0;1;-1
487819;202104;352590;G;4781400;1;2;-1
488558;202104;352590;G;4744005;1;0;1
488570;202104;352590;Q;8690999;0;1;-1
489059;202104;352590;G;4712100;2;0;2
489906;202104;352590;C;2061400;0;1;-1
490175;202104;352590;G;4711302;3;2;1
490409;202104;352590;M;7112000;0;1;-1
492712;202104;352590;G;4781400;1;0;1
493381;202104;352590;H;4930202;0;3;-3
493830;202104;352590;N;8211300;1;0;1
493943;202104;352590;G;4789001;1;1;0
494131;202104;352590;I;5611201;0;1;-1
495231;202104;352590;Q;8640208;1;0;1
496127;202104;352590;H;4930202;1;2;-1
496331;202104;352590;H;4930202;0;2;-2
496377;202104;352590;H;4930202;1;0;1
496717;202104;352590;N;8111700;2;6;-4
496946;202104;352590;I;5611201;0;1;-1
497980;202104;352590;G;4729699;0;1;-1
498682;202104;352590;P;8512100;1;1;0
498908;202104;352590;G;4520006;2;1;1
498920;202104;352590;I;5611201;0;1;-1
499822;202104;352590;G;4789001;0;1;-1
500189;202104;352590;G;4711302;0;2;-2
500378;202104;352590;N;7722500;0;1;-1
501621;202104;352590;H;5212500;0;1;-1
501732;202104;352590;G;4753900;22;53;-31
501733;202104;352590;G;4753900;0;1;-1
501734;202104;352590;G;4753900;0;3;-3
501735;202104;352590;G;4753900;0;3;-3
502092;202104;352590;G;4753900;18;16;2
502657;202104;352590;G;4752100;1;0;1
502669;202104;352590;N;7820500;40;23;17
502724;202104;352590;G;4712100;0;3;-3
502725;202104;352590;G;4712100;0;1;-1
502806;202104;352590;J;6201501;1;0;1
503027;202104;352590;I;5620104;2;0;2
503802;202104;352590;G;4781400;0;1;-1
504245;202104;352590;I;5611201;1;2;-1
504282;202104;352590;H;4930202;108;20;88
504731;202104;352590;G;4781400;2;1;1
504826;202104;352590;G;4781400;0;2;-2
505131;202104;352590;H;4930202;1;0;1
505460;202104;352590;G;4781400;0;1;-1
505536;202104;352590;L;6810201;1;0;1
506687;202104;352590;F;4330404;1;5;-4
506733;202104;352590;N;8020001;1;0;1
507010;202104;352590;C;2311700;29;4;25
507395;202104;352590;F;4330404;2;1;1
507764;202104;352590;C;2599399;16;11;5
507766;202104;352590;N;8219999;0;1;-1
508266;202104;352590;C;1091102;1;0;1
509322;202104;352590;G;4541204;0;1;-1
509572;202104;352590;C;3321000;2;0;2
509575;202104;352590;M;7112000;1;0;1
510101;202104;352590;N;8211300;1;0;1
510119;202104;352590;C;2812700;1;4;-3
511018;202104;352590;C;2099199;0;3;-3
511055;202104;352590;I;5611203;1;1;0
511417;202104;352590;I;5611203;0;1;-1
512185;202104;352590;P;8513900;0;1;-1
512226;202104;352590;I;5611201;0;1;-1
512418;202104;352590;I;5611203;1;1;0
512664;202104;352590;I;5611203;2;0;2
512883;202104;352590;F;4110700;0;2;-2
513151;202104;352590;H;5112901;1;0;1
514320;202104;352590;I;5620102;1;0;1
514930;202104;352590;G;4774100;2;0;2
515093;202104;352590;G;4724500;2;0;2
515221;202104;352590;Q;8630504;1;0;1
515411;202104;352590;Q;8711502;1;0;1
517180;202104;352590;H;5310501;0;3;-3
517410;202104;352590;H;5310501;0;4;-4
518165;202104;352590;F;4329199;0;3;-3
518277;202104;352590;M;7112000;4;0;4
520237;202104;352590;F;4299599;2;0;2
521397;202104;352590;G;4763602;0;3;-3
521589;202104;352590;Q;8640202;5;3;2
522737;202104;352590;G;4781400;0;1;-1
523677;202104;352590;H;5229099;13;7;6
524831;202104;352590;N;8121400;19;0;19
525362;202104;352590;C;1721400;4;0;4
525463;202104;352590;G;4771701;1;0;1
525675;202104;352590;P;8599604;0;4;-4
526578;202104;352590;I;5611201;0;1;-1
526672;202104;352590;I;5611202;0;1;-1
526716;202104;352590;G;4669999;13;3;10
526717;202104;352590;G;4669999;2;0;2
526788;202104;352590;G;4729602;0;1;-1
526909;202104;352590;I;5620104;0;3;-3
527452;202104;352590;I;5611201;2;1;1
528121;202104;352590;H;4930202;0;3;-3
528181;202104;352590;I;5611203;2;0;2
528189;202104;352590;F;4321500;3;0;3
528218;202104;352590;I;5611203;0;1;-1
529127;202104;352590;C;2599302;2;1;1
529626;202104;352590;G;4541203;0;1;-1
530049;202104;352590;I;5611201;0;3;-3
530786;202104;352590;J;6319400;2;0;2
532176;202104;352590;C;1091102;0;1;-1
532858;202104;352590;G;4771701;2;1;1
532880;202104;352590;N;8230001;1;3;-2
532914;202104;352590;G;4520007;1;0;1
533168;202104;352590;N;8211300;0;1;-1
533972;202104;352590;C;3092000;1;0;1
534036;202104;352590;G;4781400;0;1;-1
534369;202104;352590;G;4721102;0;1;-1
535719;202104;352590;R;9329899;0;1;-1
536182;202104;352590;F;4120400;4;0;4
536449;202104;352590;G;4731800;3;0;3
536479;202104;352590;R;9313100;0;1;-1
537184;202104;352590;N;8211300;3;2;1
537652;202104;352590;P;8599604;1;0;1
537878;202104;352590;N;7810800;0;1;-1
539915;202104;352590;H;5320201;1;0;1
540648;202104;352590;G;4754701;0;1;-1
541289;202104;352590;I;5611203;0;1;-1
541861;202104;352590;G;4729699;1;0;1
542241;202104;352590;G;4781400;0;1;-1
542443;202104;352590;S;9601701;0;1;-1
542581;202104;352590;P;8512100;2;0;2
542584;202104;352590;G;4633801;0;2;-2
543077;202104;352590;K;6492100;1;0;1
543404;202104;352590;N;8111700;2;2;0
543684;202104;352590;G;4712100;0;1;-1
543714;202104;352590;S;9609208;1;0;1
543941;202104;352590;Q;8630504;0;1;-1
544399;202104;352590;G;4729699;0;1;-1
544520;202104;352590;N;8292000;3;1;2
544794;202104;352590;N;8111700;2;5;-3
544962;202104;352590;I;5620104;1;0;1
544998;202104;352590;G;4713002;0;1;-1
545509;202104;352590;Q;8630504;0;1;-1
545639;202104;352590;N;8291100;4;18;-14
545702;202104;352590;G;4774100;1;0;1
546204;202104;352590;G;4729699;2;0;2
546652;202104;352590;P;8593700;1;0;1
547228;202104;352590;G;4723700;1;0;1
547328;202104;352590;H;4930202;108;3;105
547636;202104;352590;G;4781400;0;1;-1
548154;202104;352590;G;4520001;0;1;-1
548165;202104;352590;K;6492100;1;0;1
549694;202104;352590;H;4930202;2;0;2
550448;202104;352590;H;4930202;4;2;2
551024;202104;352590;G;4761003;1;0;1
551175;202104;352590;M;7319002;0;4;-4
551198;202104;352590;G;4784900;2;0;2
552223;202104;352590;G;4754701;0;1;-1
552919;202104;352590;N;8111700;25;6;19
553053;202104;352590;F;4120400;0;1;-1
553065;202104;352590;M;7311400;3;1;2
554212;202104;352590;G;4781400;0;1;-1
554820;202104;352590;I;5611201;0;1;-1
554889;202104;352590;G;4744001;2;1;1
555450;202104;352590;G;4781400;0;1;-1
555661;202104;352590;I;5611203;1;0;1
555662;202104;352590;I;5611203;0;1;-1
556048;202104;352590;I;5611203;2;2;0
557216;202104;352590;I;5611203;1;0;1
557382;202104;352590;N;8211300;2;0;2
557693;202104;352590;G;4729699;1;0;1
557824;202104;352590;S;9602502;1;0;1
557946;202104;352590;H;4930202;1;0;1
558537;202104;352590;H;5211799;0;1;-1
558898;202104;352590;G;4729602;1;0;1
559050;202104;352590;I;5611203;0;1;-1
559603;202104;352590;G;4781400;0;1;-1
560019;202104;352590;G;4759899;7;4;3
560612;202104;352590;G;4744005;1;0;1
560895;202104;352590;G;4781400;2;1;1
560917;202104;352590;N;8211300;1;0;1
561218;202104;352590;J;6209100;1;0;1
561459;202104;352590;S;9602502;1;0;1
562397;202104;352590;H;4930202;1;0;1
563480;202104;352590;M;7490104;9;1;8
563507;202104;352590;C;1091102;0;1;-1
563678;202104;352590;H;5320202;0;1;-1
563751;202104;352590;G;4686902;4;5;-1
563825;202104;352590;N;8211300;0;3;-3
563863;202104;352590;S;9602502;0;2;-2
563897;202104;352590;J;6209100;7;6;1
564092;202104;352590;S;9602502;0;1;-1
564333;202104;352590;C;2539001;0;3;-3
565248;202104;352590;G;4530703;2;0;2
565292;202104;352590;G;4723700;1;1;0
565862;202104;352590;G;4781400;0;1;-1
567654;202104;352590;G;4774100;1;0;1
567686;202104;352590;I;5611201;0;2;-2
568518;202104;352590;G;4759899;0;1;-1
568877;202104;352590;G;4729699;1;0;1
570834;202104;352590;H;4930202;3;0;3
572229;202104;352590;G;4744001;1;0;1
573109;202104;352590;N;8292000;1;0;1
573162;202104;352590;G;4520005;2;0;2
573288;202104;352590;G;4772500;0;2;-2
573580;202104;352590;I;5611201;1;2;-1
573882;202104;352590;G;4635499;1;0;1
574789;202104;352590;G;4729699;1;1;0
576069;202104;352590;S;9609208;2;0;2
576159;202104;352590;G;4633801;5;0;5
577630;202104;352590;F;4120400;1;0;1
577643;202104;352590;N;8020001;1;0;1
578558;202104;352590;G;4669999;3;0;3
578559;202104;352590;C;1094500;2;0;2
579399;202104;352590;K;6612603;1;0;1
579988;202104;352590;I;5611203;2;0;2
580028;202104;352590;M;7020400;2;0;2
580249;202104;352590;J;6120501;2;1;1
580326;202104;352590;J;6141800;1;0;1
581701;202104;352590;F;4399105;0;1;-1
582224;202104;352590;N;8299799;1;3;-2
582286;202104;352590;I;5620103;1;0;1
583467;202104;352590;G;4774100;2;0;2
584113;202104;352590;I;5611203;0;1;-1
584428;202104;352590;I;5620104;0;1;-1
584812;202104;352590;G;4774100;2;0;2
585170;202104;352590;C;3314708;1;0;1
585174;202104;352590;I;5611203;1;0;1
585456;202104;352590;N;8111700;1;4;-3
586815;202104;352590;G;4771701;1;0;1
586828;202104;352590;G;4721102;4;1;3
586938;202104;352590;F;4120400;3;0;3
586939;202104;352590;F;4120400;4;1;3
587146;202104;352590;N;7810800;1;0;1
587187;202104;352590;N;8230001;1;0;1
587622;202104;352590;G;4772500;1;0;1
587811;202104;352590;G;4771701;1;0;1
588131;202104;352590;N;8211300;1;0;1
588993;202104;352590;G;4789001;3;0;3
590810;202104;352590;I;5611203;1;3;-2
590893;202104;352590;C;1062700;1;3;-2
590894;202104;352590;C;1062700;1;4;-3
591451;202104;352590;C;1813099;1;0;1
591565;202104;352590;G;4711302;0;1;-1
591663;202104;352590;H;5222200;1;0;1
591789;202104;352590;I;5620101;0;1;-1
591973;202104;352590;C;2091600;1;0;1
592069;202104;352590;S;9412099;0;2;-2
592532;202104;352590;G;4753900;2;2;0
592546;202104;352590;G;4753900;1;1;0
592605;202104;352590;H;4930202;1;3;-2
592612;202104;352590;F;4120400;11;1;10
592818;202104;352590;C;2019399;2;5;-3
592894;202104;352590;C;2599399;4;1;3
592895;202104;352590;C;2599399;3;4;-1
593043;202104;352590;C;2710402;14;15;-1
593079;202104;352590;G;4789099;0;1;-1
593162;202104;352590;L;6822600;0;1;-1
593586;202104;352590;C;2512800;1;0;1
593668;202104;352590;I;5611201;0;1;-1
593669;202104;352590;G;4744005;0;1;-1
593670;202104;352590;S;9430800;0;1;-1
593671;202104;352590;C;2592602;3;2;1
593673;202104;352590;S;9430800;1;0;1
593674;202104;352590;K;6550200;0;1;-1
593675;202104;352590;C;1043100;1;0;1
593678;202104;352590;K;6550200;17;23;-6
593694;202104;352590;K;6550200;2;2;0
593695;202104;352590;K;6550200;0;1;-1
593747;202104;352590;K;6550200;1;0;1
593789;202104;352590;F;4399105;0;2;-2
593790;202104;352590;G;4530703;1;0;1
593791;202104;352590;C;3313901;1;0;1
593792;202104;352590;R;9312300;1;5;-4
593831;202104;352590;S;9412099;0;1;-1
593951;202104;352590;C;2013402;5;3;2
593952;202104;352590;C;2013402;5;1;4
594591;202104;352590;G;4781400;0;1;-1
594719;202104;352590;G;4781400;0;1;-1
595008;202104;352590;F;4120400;1;0;1
595020;202104;352590;C;2862300;0;2;-2
595138;202104;352590;G;4782201;0;1;-1
595140;202104;352590;G;4782201;1;1;0
595141;202104;352590;G;4782201;0;9;-9
595142;202104;352590;G;4782201;0;1;-1
595143;202104;352590;G;4782201;0;1;-1
595220;202104;352590;G;4711301;11;15;-4
595338;202104;352590;G;4731800;1;2;-1
595456;202104;352590;G;4771701;2;0;2
595596;202104;352590;G;4744005;1;0;1
595672;202104;352590;C;2821601;1;0;1
595684;202104;352590;O;8411600;39;5;34
595685;202104;352590;G;4722901;0;1;-1
595944;202104;352590;G;4530705;1;0;1
596271;202104;352590;C;3250705;4;3;1
596404;202104;352590;C;2063100;4;7;-3
596418;202104;352590;C;2651500;3;2;1
596779;202104;352590;P;8599601;2;0;2
596792;202104;352590;G;4744002;5;0;5
596814;202104;352590;H;4930202;1;2;-1
596815;202104;352590;G;4639701;16;5;11
596833;202104;352590;F;4313400;0;1;-1
596834;202104;352590;G;4731800;1;0;1
597049;202104;352590;C;2342702;1;1;0
597323;202104;352590;G;4781400;0;1;-1
597741;202104;352590;G;4711302;4;2;2
598159;202104;352590;G;4711302;3;3;0
598296;202104;352590;I;5510801;1;2;-1
598461;202104;352590;Q;8640202;2;3;-1
598464;202104;352590;Q;8690999;1;2;-1
598478;202104;352590;Q;8640299;1;0;1
598484;202104;352590;Q;8640202;4;4;0
598735;202104;352590;G;4789002;0;1;-1
598736;202104;352590;G;4637107;0;1;-1
599138;202104;352590;G;4713004;1;1;0
600028;202104;352590;G;4712100;1;0;1
600046;202104;352590;H;4921301;9;6;3
600299;202104;352590;G;4731800;0;1;-1
600822;202104;352590;H;5211799;2;0;2
600892;202104;352590;Q;8640205;7;4;3
600893;202104;352590;C;1412601;1;0;1
600945;202104;352590;C;2229399;0;2;-2
601052;202104;352590;M;6920601;3;1;2
601101;202104;352590;S;9430800;1;2;-1
601128;202104;352590;G;4731800;0;1;-1
601159;202104;352590;G;4781400;0;1;-1
601169;202104;352590;G;4781400;1;0;1
601500;202104;352590;I;5620101;0;1;-1
601616;202104;352590;I;5620101;1;1;0
601713;202104;352590;I;5620101;0;1;-1
601741;202104;352590;I;5620101;0;1;-1
601933;202104;352590;I;5620101;3;2;1
601955;202104;352590;I;5620101;0;1;-1
601961;202104;352590;I;5620101;2;3;-1
602090;202104;352590;G;4772500;0;1;-1
602101;202104;352590;G;4511102;0;1;-1
602102;202104;352590;Q;8630503;1;1;0
602105;202104;352590;P;8599601;2;5;-3
602107;202104;352590;C;1813099;1;16;-15
602108;202104;352590;P;8599601;1;0;1
602109;202104;352590;G;4530703;2;1;1
602503;202104;352590;C;1330800;17;25;-8
602829;202104;352590;K;6550200;0;1;-1
602830;202104;352590;K;6550200;2;0;2
602833;202104;352590;K;6550200;2;1;1
602834;202104;352590;K;6550200;14;14;0
602835;202104;352590;K;6550200;1;0;1
603024;202104;352590;F;4120400;4;0;4
603051;202104;352590;H;4921301;0;8;-8
603054;202104;352590;G;4616800;1;1;0
603058;202104;352590;C;1623400;1;1;0
603060;202104;352590;C;1122401;2;3;-1
603061;202104;352590;C;1081302;1;4;-3
603062;202104;352590;C;1112700;5;5;0
603063;202104;352590;G;4731800;1;1;0
603064;202104;352590;G;4744099;1;1;0
603065;202104;352590;G;4530703;0;2;-2
603069;202104;352590;P;8513900;10;9;1
603070;202104;352590;C;2229302;2;5;-3
603073;202104;352590;R;9312300;2;1;1
603076;202104;352590;C;2219600;6;1;5
603078;202104;352590;G;4689399;1;0;1
603079;202104;352590;C;1099601;2;2;0
603080;202104;352590;C;1629301;6;3;3
603082;202104;352590;G;4729699;0;3;-3
603085;202104;352590;K;6622300;3;2;1
603088;202104;352590;G;4511104;2;2;0
603089;202104;352590;G;4530705;1;0;1
603090;202104;352590;C;2212900;1;1;0
603091;202104;352590;G;4530703;0;1;-1
603093;202104;352590;H;4929902;3;5;-2
603094;202104;352590;C;2330399;0;1;-1
603095;202104;352590;Q;8610101;51;32;19
603102;202104;352590;G;4731800;1;0;1
603103;202104;352590;G;4711302;0;2;-2
603104;202104;352590;G;4711302;0;3;-3
603107;202104;352590;G;4711302;0;1;-1
603109;202104;352590;G;4711302;0;6;-6
603111;202104;352590;G;4711302;5;5;0
603112;202104;352590;G;4711302;1;0;1
603113;202104;352590;G;4711302;7;12;-5
603114;202104;352590;G;4711302;1;4;-3
603116;202104;352590;G;4711302;7;7;0
603117;202104;352590;G;4639701;7;7;0
603119;202104;352590;G;4711302;1;2;-1
603121;202104;352590;G;4711302;3;3;0
603123;202104;352590;G;4711302;1;2;-1
603124;202104;352590;G;4711302;1;1;0
603125;202104;352590;G;4711302;10;11;-1
603126;202104;352590;H;4921301;0;6;-6
603127;202104;352590;C;1311100;2;1;1
603128;202104;352590;C;1311100;17;14;3
603130;202104;352590;C;2229301;8;27;-19
603131;202104;352590;C;2229301;2;11;-9
603132;202104;352590;C;2229301;6;26;-20
603133;202104;352590;C;2229301;0;2;-2
603134;202104;352590;C;2229301;0;1;-1
603136;202104;352590;Q;8730102;1;0;1
603137;202104;352590;Q;8730102;1;2;-1
603138;202104;352590;P;8513900;2;0;2
603150;202104;352590;S;9430800;2;2;0
603151;202104;352590;C;1813099;3;1;2
603152;202104;352590;G;4721102;0;1;-1
603157;202104;352590;Q;8610101;2;2;0
603159;202104;352590;Q;8610101;19;12;7
603160;202104;352590;M;6920601;3;2;1
603161;202104;352590;C;2342702;1;1;0
603165;202104;352590;G;4744005;1;1;0
603166;202104;352590;G;4530703;0;1;-1
603167;202104;352590;Q;8711502;2;3;-1
603170;202104;352590;G;4744099;0;1;-1
603177;202104;352590;G;4731800;1;0;1
603178;202104;352590;G;4711302;4;7;-3
603179;202104;352590;G;4711302;2;4;-2
603180;202104;352590;G;4711302;7;2;5
603181;202104;352590;G;4711302;3;1;2
603183;202104;352590;G;4711302;4;4;0
603185;202104;352590;M;6920601;0;1;-1
603186;202104;352590;M;6920601;1;1;0
603194;202104;352590;S;9420100;0;1;-1
603196;202104;352590;P;8511200;1;0;1
603197;202104;352590;S;9491000;0;1;-1
603200;202104;352590;S;9491000;1;0;1
603202;202104;352590;S;9491000;1;1;0
603205;202104;352590;S;9491000;2;0;2
603206;202104;352590;G;4633801;3;2;1
603207;202104;352590;H;4929902;1;0;1
603209;202104;352590;P;8531700;1;0;1
603217;202104;352590;G;4771701;0;1;-1
603464;202104;352590;N;8211300;1;0;1
603518;202104;352590;N;8299706;0;1;-1
603524;202104;352590;P;8513900;1;0;1
603543;202104;352590;C;2071100;4;3;1
603790;202104;352590;C;1013901;2;4;-2
604081;202104;352590;G;4744099;0;1;-1
604198;202104;352590;Q;8640202;1;1;0
604199;202104;352590;Q;8640202;0;2;-2
604200;202104;352590;Q;8640202;3;2;1
604201;202104;352590;Q;8640201;0;1;-1
604204;202104;352590;Q;8640202;0;1;-1
604206;202104;352590;Q;8650004;3;1;2
604207;202104;352590;Q;8640202;5;0;5
604208;202104;352590;Q;8640202;1;1;0
604209;202104;352590;Q;8640202;6;4;2
604210;202104;352590;Q;8640202;1;0;1
604211;202104;352590;H;4930202;1;1;0
604238;202104;352590;Q;8610101;8;5;3
604268;202104;352590;P;8520100;2;3;-1
604269;202104;352590;S;9499500;1;1;0
604353;202104;352590;C;1622699;0;1;-1
604380;202104;352590;H;5112901;4;3;1
604414;202104;352590;I;5620104;0;2;-2
604496;202104;352590;C;3250707;2;1;1
604578;202104;352590;C;2342702;1;4;-3
604592;202104;352590;G;4661300;8;7;1
604731;202104;352590;N;8112500;0;2;-2
604753;202104;352590;Q;8630502;1;1;0
604754;202104;352590;N;7820500;2;2;0
604797;202104;352590;G;4639701;0;1;-1
604811;202104;352590;G;4744099;1;3;-2
604831;202104;352590;H;4930202;7;3;4
604845;202104;352590;G;4782201;0;1;-1
604846;202104;352590;G;4782201;0;1;-1
605056;202104;352590;G;4771702;6;4;2
605057;202104;352590;N;8211300;0;1;-1
605134;202104;352590;G;4755502;2;0;2
605174;202104;352590;G;4744001;1;0;1
605220;202104;352590;G;4530703;0;1;-1
605232;202104;352590;G;4530701;0;1;-1
605358;202104;352590;G;4721102;1;5;-4
605376;202104;352590;C;1031700;2;13;-11
605696;202104;352590;G;4789004;1;3;-2
605934;202104;352590;G;4669999;4;1;3
606047;202104;352590;G;4530704;1;0;1
606293;202104;352590;G;4771701;1;0;1
606580;202104;352590;G;4541203;0;1;-1
606613;202104;352590;C;2222600;1;0;1
606704;202104;352590;G;4520006;0;1;-1
606766;202104;352590;G;4781400;0;1;-1
606960;202104;352590;Q;8640203;0;3;-3
607007;202104;352590;H;4930202;1;0;1
607009;202104;352590;Q;8711501;1;1;0
607012;202104;352590;M;7112000;0;1;-1
607014;202104;352590;S;9420100;1;0;1
607015;202104;352590;P;8513900;0;1;-1
607131;202104;352590;G;4712100;1;1;0
607152;202104;352590;F;4329103;0;3;-3
607234;202104;352590;C;3314799;1;0;1
607284;202104;352590;C;3101200;0;1;-1
607762;202104;352590;G;4712100;0;2;-2
607763;202104;352590;G;4712100;0;3;-3
607845;202104;352590;G;4649499;0;1;-1
607982;202104;352590;Q;8630502;0;2;-2
607985;202104;352590;N;8112500;1;0;1
607986;202104;352590;N;8112500;0;3;-3
608047;202104;352590;G;4511101;2;3;-1
608054;202104;352590;I;5620101;1;1;0
608127;202104;352590;C;1093702;0;1;-1
608215;202104;352590;S;9529199;1;0;1
608476;202104;352590;G;4789007;0;1;-1
608597;202104;352590;G;4721102;2;0;2
608599;202104;352590;F;4399199;2;1;1
608761;202104;352590;C;2821602;2;2;0
609059;202104;352590;H;4930202;1;0;1
609205;202104;352590;F;4313400;1;0;1
609257;202104;352590;B;810006;1;0;1
609290;202104;352590;L;6810202;1;0;1
609355;202104;352590;G;4649499;0;1;-1
609362;202104;352590;C;2823200;1;2;-1
609367;202104;352590;C;3101200;0;7;-7
609456;202104;352590;G;4661300;4;0;4
609532;202104;352590;C;2449199;1;2;-1
609714;202104;352590;G;4744005;1;0;1
609896;202104;352590;I;5510803;0;1;-1
610351;202104;352590;G;4753900;0;1;-1
610430;202104;352590;H;4930202;1;1;0
610517;202104;352590;K;6550200;1;0;1
610518;202104;352590;Q;8630502;1;0;1
610519;202104;352590;Q;8610102;1;1;0
610520;202104;352590;Q;8610101;8;4;4
610727;202104;352590;G;4761003;1;2;-1
610901;202104;352590;F;4321500;1;2;-1
611163;202104;352590;C;3314708;3;2;1
611262;202104;352590;G;4783101;0;1;-1
611712;202104;352590;H;4930202;0;2;-2
611746;202104;352590;G;4530703;1;0;1
611825;202104;352590;K;6493000;1;0;1
611914;202104;352590;C;2099199;1;1;0
611998;202104;352590;C;2592602;10;4;6
612092;202104;352590;H;4930202;7;7;0
612112;202104;352590;C;1094500;1;0;1
612256;202104;352590;K;6493000;0;1;-1
612416;202104;352590;K;6422100;1;0;1
612459;202104;352590;J;6204000;0;1;-1
612556;202104;352590;G;4641901;0;1;-1
612583;202104;352590;I;5611201;0;7;-7
612672;202104;352590;G;4781400;0;1;-1
612726;202104;352590;C;2229302;5;2;3
612776;202104;352590;N;8121400;2;4;-2
612778;202104;352590;H;5223100;2;1;1
612779;202104;352590;P;8512100;1;0;1
612780;202104;352590;N;8112500;0;1;-1
613020;202104;352590;G;4781400;1;0;1
613024;202104;352590;G;4763601;0;1;-1
613071;202104;352590;F;4221902;1;2;-1
613129;202104;352590;H;4929902;26;12;14
613149;202104;352590;I;5611201;2;0;2
613150;202104;352590;I;5611201;1;0;1
613375;202104;352590;G;4635402;8;14;-6
613473;202104;352590;C;2229399;28;19;9
613494;202104;352590;H;4930202;3;2;1
613528;202104;352590;Q;8640205;4;4;0
613565;202104;352590;P;8512100;0;1;-1
613566;202104;352590;N;8299799;0;1;-1
613689;202104;352590;C;2944100;5;12;-7
613728;202104;352590;C;1629301;3;3;0
613855;202104;352590;I;5510803;0;1;-1
614105;202104;352590;G;4520001;0;1;-1
614121;202104;352590;F;4292802;1;12;-11
614193;202104;352590;C;1412601;0;2;-2
614220;202104;352590;H;4930202;0;3;-3
614229;202104;352590;G;4520001;1;2;-1
614262;202104;352590;G;4721102;0;3;-3
614285;202104;352590;K;6550200;1;0;1
614480;202104;352590;G;4755502;0;1;-1
614566;202104;352590;C;1091101;0;1;-1
614576;202104;352590;N;7732201;1;0;1
614599;202104;352590;G;4741500;1;0;1
614762;202104;352590;G;4633802;0;1;-1
614813;202104;352590;C;1314600;0;2;-2
614814;202104;352590;G;4530703;0;1;-1
615475;202104;352590;G;4729699;0;1;-1
615524;202104;352590;C;2032100;2;0;2
615664;202104;352590;G;4530701;3;1;2
615790;202104;352590;C;2522500;4;23;-19
616065;202104;352590;Q;8610101;2;6;-4
616115;202104;352590;C;2014200;8;3;5
616228;202104;352590;G;4530703;3;0;3
616232;202104;352590;C;1412601;2;1;1
616243;202104;352590;C;2599399;0;1;-1
616244;202104;352590;C;2599399;1;0;1
616248;202104;352590;C;2812700;2;1;1
616547;202104;352590;K;6422100;1;0;1
617188;202104;352590;K;6422100;0;1;-1
617753;202104;352590;C;2222600;8;7;1
617793;202104;352590;I;5612100;1;0;1
617954;202104;352590;Q;8690999;1;1;0
618074;202104;352590;G;4511104;2;0;2
618111;202104;352590;C;2539002;2;2;0
618112;202104;352590;C;2539002;0;1;-1
618159;202104;352590;B;810099;0;1;-1
618160;202104;352590;C;2330302;2;1;1
618253;202104;352590;P;8513900;0;1;-1
618254;202104;352590;P;8511200;0;1;-1
618510;202104;352590;G;4530703;1;0;1
618616;202104;352590;Q;8800600;2;0;2
618703;202104;352590;C;3104700;1;0;1
618706;202104;352590;Q;8711502;0;1;-1
618707;202104;352590;P;8511200;0;1;-1
618757;202104;352590;I;5611201;0;2;-2
618831;202104;352590;Q;8640212;4;3;1
618879;202104;352590;S;9491000;4;1;3
619196;202104;352590;C;2949299;1;1;0
619529;202104;352590;G;4646001;0;1;-1
619714;202104;352590;C;2591800;15;6;9
619772;202104;352590;G;4635402;3;4;-1
619780;202104;352590;C;1122401;7;13;-6
619867;202104;352590;G;4781400;1;0;1
619945;202104;352590;C;1721400;8;2;6
619949;202104;352590;G;4647801;5;2;3
619991;202104;352590;C;3299002;0;3;-3
620050;202104;352590;G;4711302;4;5;-1
620394;202104;352590;G;4761001;0;4;-4
620469;202104;352590;K;6512000;0;1;-1
620673;202104;352590;G;4771701;1;1;0
620778;202104;352590;G;4771701;0;1;-1
620795;202104;352590;G;4771701;1;0;1
620958;202104;352590;C;2949299;9;6;3
621310;202104;352590;N;8211300;5;5;0
621339;202104;352590;G;4731800;0;1;-1
621442;202104;352590;C;1411801;27;19;8
621520;202104;352590;C;1111902;0;1;-1
621589;202104;352590;G;4771701;2;2;0
621636;202104;352590;G;4771701;1;1;0
621775;202104;352590;G;4771701;0;1;-1
621913;202104;352590;G;4771701;1;0;1
621916;202104;352590;G;4771701;1;1;0
622027;202104;352590;G;4771701;0;1;-1
622072;202104;352590;G;4771701;0;1;-1
622085;202104;352590;G;4771701;1;0;1
622140;202104;352590;G;4771701;1;2;-1
622154;202104;352590;G;4771701;1;1;0
622434;202104;352590;G;4771701;2;1;1
622539;202104;352590;G;4771701;1;0;1
622561;202104;352590;G;4771701;0;2;-2
622653;202104;352590;G;4771701;1;0;1
622830;202104;352590;Q;8800600;4;18;-14
623154;202104;352590;N;8121400;11;10;1
623237;202104;352590;G;4743100;1;0;1
623263;202104;352590;G;4782202;0;1;-1
623610;202104;352590;G;4781400;0;1;-1
624181;202104;352590;C;2592601;1;0;1
624235;202104;352590;G;4637107;0;1;-1
624498;202104;352590;G;4759899;1;0;1
624911;202104;352590;P;8541400;2;0;2
625111;202104;352590;G;4789002;3;3;0
625122;202104;352590;C;2229301;2;3;-1
625263;202104;352590;G;4744099;0;2;-2
626119;202104;352590;J;6202300;0;1;-1
626217;202104;352590;J;6209100;4;1;3
626228;202104;352590;Q;8660700;18;8;10
626344;202104;352590;H;4930202;0;1;-1
626364;202104;352590;M;7420001;0;1;-1
626374;202104;352590;G;4731800;1;1;0
626378;202104;352590;F;4120400;0;1;-1
627004;202104;352590;C;3314710;12;6;6
627022;202104;352590;C;1053800;1;0;1
627035;202104;352590;B;810006;1;1;0
627060;202104;352590;G;4731800;2;0;2
627061;202104;352590;G;4731800;1;1;0
628112;202104;352590;J;6202300;5;2;3
628367;202104;352590;G;4711302;35;25;10
628410;202104;352590;C;1099699;2;4;-2
628508;202104;352590;F;4211101;1;1;0
628547;202104;352590;P;8512100;1;0;1
628548;202104;352590;N;8112500;1;1;0
628565;202104;352590;G;4783101;0;1;-1
629135;202104;352590;G;4789099;1;0;1
629202;202104;352590;N;7739099;9;4;5
629215;202104;352590;I;5611203;0;8;-8
629216;202104;352590;I;5611203;0;6;-6
629314;202104;352590;I;5611201;0;1;-1
629333;202104;352590;G;4789099;1;1;0
629367;202104;352590;G;4731800;0;1;-1
629819;202104;352590;N;8111700;19;21;-2
629835;202104;352590;S;9491000;1;0;1
629836;202104;352590;H;5223100;0;1;-1
629837;202104;352590;Q;8690999;2;1;1
629849;202104;352590;Q;8690999;1;0;1
629850;202104;352590;N;8112500;0;2;-2
629853;202104;352590;N;8121400;3;1;2
629855;202104;352590;N;8112500;1;0;1
629856;202104;352590;Q;8640207;1;2;-1
629928;202104;352590;G;4771701;2;1;1
629929;202104;352590;G;4771701;1;0;1
629930;202104;352590;G;4771701;1;0;1
630007;202104;352590;G;4744005;2;0;2
630185;202104;352590;C;2014200;15;1;14
630204;202104;352590;G;4711302;1;0;1
630205;202104;352590;C;1013901;3;1;2
630206;202104;352590;G;4722901;0;1;-1
630279;202104;352590;F;4120400;8;0;8
630280;202104;352590;F;4120400;16;16;0
630411;202104;352590;F;4120400;4;2;2
630512;202104;352590;G;4729699;1;0;1
630595;202104;352590;G;4520001;0;1;-1
630653;202104;352590;C;2229399;0;2;-2
630731;202104;352590;G;4741500;1;1;0
630906;202104;352590;I;5620101;0;2;-2
631134;202104;352590;M;6920601;1;2;-1
631135;202104;352590;N;8112500;0;1;-1
631208;202104;352590;I;5611201;0;1;-1
631235;202104;352590;G;4744005;6;1;5
631241;202104;352590;G;4781400;0;1;-1
631273;202104;352590;G;4623199;4;0;4
631282;202104;352590;H;4930202;0;3;-3
631296;202104;352590;C;2599399;3;0;3
631475;202104;352590;G;4729699;0;2;-2
631598;202104;352590;G;4530703;1;0;1
631609;202104;352590;G;4763601;0;1;-1
632343;202104;352590;G;4530703;0;1;-1
632455;202104;352590;J;6203100;12;1;11
632588;202104;352590;C;2543800;2;0;2
632611;202104;352590;C;2330302;0;1;-1
632752;202104;352590;G;4712100;3;0;3
632771;202104;352590;G;4712100;1;0;1
632840;202104;352590;G;4721102;0;1;-1
632908;202104;352590;G;4753900;0;1;-1
632910;202104;352590;G;4771702;0;2;-2
634620;202104;352590;C;2229301;31;35;-4
634888;202104;352590;N;7739099;1;1;0
634900;202104;352590;C;3314710;1;0;1
634903;202104;352590;G;4782202;0;1;-1
634999;202104;352590;I;5611201;0;1;-1
635035;202104;352590;G;4754702;0;1;-1
635207;202104;352590;G;4741500;1;1;0
635208;202104;352590;G;4741500;0;1;-1
635211;202104;352590;G;4741500;0;2;-2
635212;202104;352590;G;4741500;1;1;0
635217;202104;352590;G;4741500;1;0;1
635221;202104;352590;G;4741500;1;0;1
636213;202104;352590;C;3299099;0;1;-1
636441;202104;352590;G;4744005;0;1;-1
636445;202104;352590;G;4781400;2;1;1
636479;202104;352590;C;2822402;1;2;-1
636565;202104;352590;G;4744002;0;1;-1
636594;202104;352590;G;4530703;0;1;-1
636709;202104;352590;G;4789099;0;1;-1
636725;202104;352590;G;4731800;0;1;-1
636726;202104;352590;G;4731800;0;1;-1
636741;202104;352590;G;4692300;12;6;6
636874;202104;352590;G;4520005;0;1;-1
636881;202104;352590;C;1629301;3;0;3
637010;202104;352590;G;4743100;1;0;1
637505;202104;352590;G;4635402;0;1;-1
638690;202104;352590;H;5310502;2;0;2
638742;202104;352590;H;5310502;1;1;0
639183;202104;352590;I;5611201;0;1;-1
639199;202104;352590;C;1330800;0;1;-1
639251;202104;352590;R;9313100;0;1;-1
639306;202104;352590;G;4744099;2;0;2
639392;202104;352590;G;4711302;1;1;0
639502;202104;352590;N;7820500;1;1;0
640381;202104;352590;G;4711301;5;10;-5
641048;202104;352590;C;2349401;9;6;3
641054;202104;352590;N;8211300;4;5;-1
641611;202104;352590;H;4930202;5;3;2
642754;202104;352590;G;4672900;4;4;0
643491;202104;352590;C;2812700;1;1;0
644265;202104;352590;H;4930203;6;3;3
645214;202104;352590;G;4757100;0;1;-1
646187;202104;352590;H;4930202;1;1;0
646929;202104;352590;G;4530703;0;1;-1
647390;202104;352590;G;4711301;3;0;3
649707;202104;352590;I;5510801;0;1;-1
653069;202104;352590;H;4930202;3;4;-1
653530;202104;352590;G;4639701;3;0;3
654520;202104;352590;G;4679604;10;1;9
656096;202104;352590;G;4541201;0;1;-1
659946;202104;352590;G;4661300;0;2;-2
661113;202104;352590;C;2330399;1;0;1
662158;202104;352590;H;4930202;0;6;-6
663577;202104;352590;C;1733800;10;6;4
663578;202104;352590;C;1733800;1;4;-3
664927;202104;352590;K;6422100;1;0;1
664975;202104;352590;K;6422100;0;1;-1
668703;202104;352590;G;4781400;2;1;1
668793;202104;352590;G;4781400;1;1;0
671460;202104;352590;I;5620101;6;4;2
673013;202104;352590;C;1733800;0;4;-4
673193;202104;352590;N;7732201;1;1;0
673247;202104;352590;N;8111700;1;4;-3
673527;202104;352590;I;5620104;1;1;0
673549;202104;352590;G;4771702;1;0;1
673564;202104;352590;G;4781400;0;1;-1
673566;202104;352590;I;5611201;0;1;-1
673649;202104;352590;Q;8630503;1;0;1
673722;202104;352590;C;2829199;2;0;2
673776;202104;352590;C;2599399;0;2;-2
673796;202104;352590;G;4642702;0;1;-1
675437;202104;352590;C;2813500;11;14;-3
675438;202104;352590;C;2349401;155;27;128
690132;202104;352590;Q;8630504;1;2;-1
693835;202104;352590;M;6912500;0;1;-1
77;202009;352590;K;6422100;0;1;-1
219;202009;352590;G;4789099;0;1;-1
420;202009;352590;G;4751201;1;1;0
500;202009;352590;F;4329103;0;1;-1
1204;202009;352590;Q;8640202;0;3;-3
1631;202009;352590;G;4752100;1;1;0
2425;202009;352590;C;2599399;10;13;-3
2475;202009;352590;G;4712100;0;1;-1
2570;202009;352590;L;6810202;1;0;1
2590;202009;352590;J;6311900;0;2;-2
2685;202009;352590;G;4789099;2;1;1
3143;202009;352590;C;2812700;4;3;1
3251;202009;352590;C;1091101;3;0;3
3616;202009;352590;C;2222600;1;0;1
3730;202009;352590;C;2949299;1;7;-6
3910;202009;352590;G;4781400;0;1;-1
4364;202009;352590;N;7911200;0;1;-1
4439;202009;352590;N;8219901;1;0;1
4613;202009;352590;C;2040100;8;3;5
4726;202009;352590;N;7739099;3;2;1
4786;202009;352590;H;4924800;1;0;1
4809;202009;352590;N;7810800;79;32;47
4986;202009;352590;K;6622300;4;2;2
5535;202009;352590;G;4789099;1;1;0
5536;202009;352590;C;2512800;0;1;-1
5981;202009;352590;C;1732000;3;0;3
6152;202009;352590;G;4732600;0;1;-1
6450;202009;352590;G;4753900;5;7;-2
6455;202009;352590;G;4753900;1;0;1
6496;202009;352590;G;4753900;1;1;0
7289;202009;352590;I;5620104;1;0;1
7879;202009;352590;Q;8711502;0;1;-1
8448;202009;352590;G;4672900;1;0;1
9205;202009;352590;M;6920601;1;1;0
9589;202009;352590;G;4789007;0;1;-1
9634;202009;352590;G;4789099;1;0;1
10303;202009;352590;S;9529199;1;0;1
10661;202009;352590;G;4754701;1;1;0
11032;202009;352590;H;5211799;8;10;-2
11585;202009;352590;G;4772500;0;1;-1
11838;202009;352590;I;5611203;2;0;2
11931;202009;352590;Q;8610101;5;1;4
12269;202009;352590;G;4633801;1;1;0
12536;202009;352590;C;2342702;26;0;26
13110;202009;352590;J;6203100;0;1;-1
13133;202009;352590;G;4511102;2;1;1
13212;202009;352590;H;4929902;1;4;-3
13389;202009;352590;S;9601703;5;3;2
13393;202009;352590;S;9601703;43;25;18
13684;202009;352590;C;1413401;1;0;1
14067;202009;352590;K;6629100;0;1;-1
14617;202009;352590;N;8112500;0;5;-5
14786;202009;352590;M;6920601;0;1;-1
14956;202009;352590;I;5611201;2;0;2
15622;202009;352590;Q;8640299;1;0;1
16327;202009;352590;N;8230001;0;1;-1
16462;202009;352590;S;9601701;2;1;1
16658;202009;352590;R;9319199;0;1;-1
16659;202009;352590;M;6920601;2;0;2
17117;202009;352590;G;4789099;1;0;1
17548;202009;352590;C;3240099;2;2;0
17634;202009;352590;C;2731700;1;4;-3
17752;202009;352590;G;4693100;14;15;-1
17803;202009;352590;G;4511101;6;2;4
18419;202009;352590;E;3701100;1;1;0
18438;202009;352590;K;6622300;1;0;1
18515;202009;352590;G;4644301;27;19;8
18546;202009;352590;I;5620101;2;1;1
18592;202009;352590;M;7112000;1;2;-1
18658;202009;352590;I;5611201;1;0;1
18859;202009;352590;K;6622300;1;1;0
19152;202009;352590;H;5250804;2;0;2
19262;202009;352590;P;8512100;0;1;-1
19366;202009;352590;N;8292000;0;1;-1
19429;202009;352590;G;4752100;1;0;1
19441;202009;352590;I;5611201;1;0;1
19508;202009;352590;C;1031700;0;1;-1
19619;202009;352590;S;9430800;0;1;-1
19944;202009;352590;N;8299701;2;2;0
20694;202009;352590;G;4789099;1;0;1
21200;202009;352590;G;4721102;2;0;2
21689;202009;352590;G;4781400;0;1;-1
21849;202009;352590;G;4689399;1;0;1
22429;202009;352590;G;4645101;1;0;1
22522;202009;352590;G;4652400;0;1;-1
22845;202009;352590;C;3102100;0;21;-21
23297;202009;352590;H;4930203;11;7;4
23301;202009;352590;H;4930202;0;27;-27
23562;202009;352590;I;5510803;0;1;-1
23618;202009;352590;N;8112500;1;0;1
23619;202009;352590;M;6920601;1;1;0
23629;202009;352590;F;4329104;1;1;0
23756;202009;352590;Q;8630504;1;1;0
23937;202009;352590;G;4751201;0;1;-1
24653;202009;352590;Q;8630503;2;1;1
24915;202009;352590;C;2542000;0;1;-1
25752;202009;352590;G;4744001;0;1;-1
25817;202009;352590;F;4399199;1;0;1
25875;202009;352590;J;6203100;1;0;1
26127;202009;352590;H;4930202;5;1;4
26193;202009;352590;G;4530703;1;0;1
26266;202009;352590;G;4639701;0;1;-1
26330;202009;352590;C;1062700;2;3;-1
26392;202009;352590;P;8593700;0;1;-1
26393;202009;352590;M;6920601;1;0;1
26807;202009;352590;G;4781400;1;0;1
27056;202009;352590;P;8511200;0;2;-2
27057;202009;352590;C;1081302;5;3;2
27554;202009;352590;M;6920601;4;0;4
27585;202009;352590;C;2539001;0;1;-1
28094;202009;352590;C;3250705;0;1;-1
28100;202009;352590;I;5611201;0;1;-1
28359;202009;352590;G;4721104;1;0;1
28462;202009;352590;C;3101200;1;2;-1
29325;202009;352590;P;8512100;1;0;1
29404;202009;352590;N;8211300;2;14;-12
29405;202009;352590;G;4634601;10;8;2
29726;202009;352590;G;4752100;1;1;0
29829;202009;352590;G;4530703;1;0;1
30101;202009;352590;C;2219600;2;2;0
30172;202009;352590;G;4712100;1;1;0
30295;202009;352590;C;2222600;1;1;0
31077;202009;352590;N;7911200;0;1;-1
31169;202009;352590;I;5611201;0;1;-1
32124;202009;352590;C;2949299;1;0;1
32415;202009;352590;G;4530701;3;0;3
32882;202009;352590;G;4530702;5;2;3
32993;202009;352590;C;2539001;0;2;-2
33105;202009;352590;G;4687703;0;2;-2
33244;202009;352590;C;2599399;1;0;1
33295;202009;352590;C;2599399;8;1;7
33298;202009;352590;G;4759899;2;2;0
34299;202009;352590;C;1413402;1;0;1
34322;202009;352590;G;4731800;0;1;-1
34353;202009;352590;H;4930202;0;1;-1
34500;202009;352590;N;8112500;0;1;-1
34770;202009;352590;F;4313400;1;2;-1
35389;202009;352590;G;4731800;1;0;1
35444;202009;352590;I;5611203;0;1;-1
35789;202009;352590;M;6920601;2;0;2
35872;202009;352590;G;4781400;0;1;-1
36063;202009;352590;G;4639701;7;1;6
36400;202009;352590;C;3314710;1;1;0
36745;202009;352590;G;4751201;1;1;0
37074;202009;352590;P;8512100;0;1;-1
37090;202009;352590;C;2869100;1;0;1
37994;202009;352590;C;1081302;9;3;6
38249;202009;352590;N;8011101;10;6;4
38470;202009;352590;P;8599601;1;0;1
38615;202009;352590;C;1721400;7;4;3
38638;202009;352590;N;7820500;6;0;6
40077;202009;352590;C;1340501;0;1;-1
40266;202009;352590;M;6920601;1;1;0
40275;202009;352590;G;4511101;2;5;-3
40314;202009;352590;H;5221400;5;8;-3
40425;202009;352590;C;2941700;4;1;3
40426;202009;352590;C;2941700;4;0;4
40653;202009;352590;E;3811400;0;1;-1
41120;202009;352590;G;4731800;1;2;-1
41716;202009;352590;C;2751100;1;0;1
41998;202009;352590;G;4511102;0;1;-1
42095;202009;352590;C;2229302;2;0;2
42226;202009;352590;I;5611203;1;0;1
42356;202009;352590;J;6110801;0;1;-1
42516;202009;352590;C;2815102;0;1;-1
42523;202009;352590;N;8112500;0;1;-1
43943;202009;352590;S;9430800;1;1;0
45264;202009;352590;G;4511101;0;1;-1
45511;202009;352590;I;5611203;1;3;-2
45559;202009;352590;G;4511101;0;1;-1
45985;202009;352590;G;4634601;0;1;-1
46316;202009;352590;G;4721104;0;1;-1
46550;202009;352590;C;2091600;1;5;-4
47283;202009;352590;G;4781400;1;0;1
47376;202009;352590;H;4930202;8;7;1
47814;202009;352590;H;5211799;9;4;5
48007;202009;352590;N;8211300;6;2;4
48582;202009;352590;C;2532201;0;1;-1
49525;202009;352590;C;1013901;23;27;-4
49962;202009;352590;S;9430800;1;1;0
50088;202009;352590;G;4754701;2;0;2
50227;202009;352590;H;5223100;2;0;2
50291;202009;352590;P;8599602;0;4;-4
50679;202009;352590;G;4789099;0;1;-1
51399;202009;352590;N;8112500;0;1;-1
51592;202009;352590;G;4713001;0;1;-1
52564;202009;352590;C;1414200;0;3;-3
52704;202009;352590;H;4930202;16;16;0
53202;202009;352590;N;8121400;13;15;-2
53270;202009;352590;N;8291100;0;3;-3
53500;202009;352590;G;4771702;1;0;1
53534;202009;352590;C;2222600;10;3;7
53732;202009;352590;G;4731800;0;1;-1
54019;202009;352590;G;4752100;0;1;-1
54020;202009;352590;G;4752100;1;1;0
54021;202009;352590;G;4752100;2;0;2
54286;202009;352590;G;4724500;0;1;-1
54287;202009;352590;G;4724500;1;2;-1
54410;202009;352590;G;4771701;0;1;-1
54886;202009;352590;G;4639701;3;2;1
54973;202009;352590;K;6622300;1;0;1
55501;202009;352590;F;4330499;2;1;1
55767;202009;352590;Q;8640299;0;1;-1
56554;202009;352590;I;5612100;0;2;-2
56618;202009;352590;H;5229002;1;0;1
57045;202009;352590;G;4646001;12;1;11
57197;202009;352590;N;8112500;0;2;-2
57282;202009;352590;N;8299706;0;1;-1
57623;202009;352590;I;5620101;1;1;0
57631;202009;352590;I;5620101;2;1;1
57651;202009;352590;Q;8720401;4;5;-1
57900;202009;352590;H;4930203;1;0;1
57911;202009;352590;G;4781400;1;0;1
58596;202009;352590;I;5611201;0;1;-1
59165;202009;352590;G;4759899;0;1;-1
59315;202009;352590;C;2811900;0;1;-1
59338;202009;352590;F;4120400;0;3;-3
59512;202009;352590;G;4754701;1;0;1
60253;202009;352590;J;5819100;1;0;1
60318;202009;352590;G;4665600;1;0;1
60471;202009;352590;P;8599601;1;1;0
60561;202009;352590;G;4744099;0;1;-1
61620;202009;352590;G;4711302;1;1;0
61682;202009;352590;G;4711302;0;1;-1
62096;202009;352590;F;4391600;6;1;5
63320;202009;352590;H;4930202;1;0;1
63995;202009;352590;E;3600601;2;2;0
64308;202009;352590;C;1093702;12;3;9
64688;202009;352590;N;7820500;314;249;65
64756;202009;352590;F;4120400;3;0;3
64985;202009;352590;N;7732201;1;0;1
65072;202009;352590;I;5611201;0;1;-1
66244;202009;352590;G;4724500;0;1;-1
66490;202009;352590;H;4930202;0;1;-1
66643;202009;352590;I;5620102;0;1;-1
66943;202009;352590;P;8599699;0;2;-2
67090;202009;352590;C;2829199;1;1;0
67297;202009;352590;N;7820500;509;321;188
67743;202009;352590;G;4744005;0;1;-1
68214;202009;352590;G;4754701;1;0;1
68655;202009;352590;P;8599699;2;1;1
68938;202009;352590;J;6190601;0;1;-1
69608;202009;352590;G;4633801;0;7;-7
69871;202009;352590;G;4774100;1;0;1
69892;202009;352590;N;8129000;45;50;-5
69959;202009;352590;G;4744005;0;2;-2
70010;202009;352590;C;2222600;4;2;2
70642;202009;352590;I;5611203;1;0;1
70723;202009;352590;H;4930202;6;5;1
70724;202009;352590;H;4930202;7;2;5
70750;202009;352590;G;4783101;0;1;-1
70992;202009;352590;H;5120000;4;1;3
71065;202009;352590;K;6622300;1;0;1
71108;202009;352590;N;8122200;1;0;1
71176;202009;352590;G;4789005;0;1;-1
71760;202009;352590;I;5611203;0;1;-1
71761;202009;352590;G;4637106;9;6;3
72391;202009;352590;G;4744001;1;0;1
73089;202009;352590;I;5510803;1;1;0
73322;202009;352590;Q;8630501;2;2;0
73891;202009;352590;I;5620103;0;1;-1
73956;202009;352590;P;8599601;1;0;1
74038;202009;352590;G;4771701;2;0;2
74131;202009;352590;G;4781400;1;0;1
74519;202009;352590;J;6203100;0;2;-2
74678;202009;352590;N;8291100;2;0;2
75148;202009;352590;G;4781400;1;0;1
75163;202009;352590;G;4530703;6;5;1
75299;202009;352590;Q;8630503;1;0;1
75550;202009;352590;G;4672900;2;0;2
75644;202009;352590;I;5611201;11;6;5
75645;202009;352590;I;5611201;5;5;0
75881;202009;352590;N;8299799;0;7;-7
75940;202009;352590;Q;8711502;3;4;-1
76181;202009;352590;J;6203100;1;1;0
76390;202009;352590;N;7820500;2;0;2
76821;202009;352590;F;4120400;4;4;0
77041;202009;352590;D;3514000;0;1;-1
77064;202009;352590;H;4930202;0;1;-1
77119;202009;352590;G;4639701;0;1;-1
77512;202009;352590;G;4789099;1;0;1
77720;202009;352590;M;7319002;1;1;0
78346;202009;352590;N;8121400;1;0;1
78400;202009;352590;H;4930201;5;1;4
78689;202009;352590;G;4672900;0;1;-1
78719;202009;352590;N;8112500;0;1;-1
78984;202009;352590;H;5112901;9;1;8
79356;202009;352590;Q;8640299;0;1;-1
79360;202009;352590;G;4520001;0;1;-1
79938;202009;352590;I;5510803;0;2;-2
80074;202009;352590;P;8532500;4;6;-2
80174;202009;352590;P;8599699;0;1;-1
80661;202009;352590;G;4541202;0;1;-1
82325;202009;352590;C;3314721;0;1;-1
82765;202009;352590;G;4511101;4;1;3
82971;202009;352590;N;7711000;0;1;-1
83203;202009;352590;F;4299599;10;0;10
83205;202009;352590;F;4299599;2;11;-9
83620;202009;352590;Q;8640210;1;0;1
83621;202009;352590;Q;8640210;1;1;0
83919;202009;352590;G;4743100;1;0;1
84101;202009;352590;M;7112000;0;1;-1
84121;202009;352590;G;4731800;0;1;-1
84176;202009;352590;G;4639701;10;11;-1
84717;202009;352590;G;4731800;1;0;1
85096;202009;352590;M;6911701;1;0;1
85331;202009;352590;H;5250804;1;1;0
85933;202009;352590;N;8299799;3;3;0
86399;202009;352590;I;5620101;1;1;0
87936;202009;352590;H;5250801;1;1;0
88067;202009;352590;I;5611203;0;1;-1
88250;202009;352590;G;4789007;1;0;1
88571;202009;352590;H;5250804;32;12;20
88629;202009;352590;G;4771702;1;1;0
88815;202009;352590;G;4789099;0;1;-1
88915;202009;352590;N;8211300;0;1;-1
89103;202009;352590;G;4761003;1;0;1
89462;202009;352590;G;4731800;1;1;0
90259;202009;352590;P;8599603;4;3;1
90745;202009;352590;M;6920601;0;1;-1
90748;202009;352590;G;4789001;1;0;1
90750;202009;352590;C;2399199;1;1;0
91029;202009;352590;Q;8630504;0;1;-1
91144;202009;352590;F;4399105;0;1;-1
91365;202009;352590;Q;8630504;1;0;1
91430;202009;352590;G;4520001;0;1;-1
91639;202009;352590;K;6622300;0;1;-1
91937;202009;352590;Q;8650099;6;13;-7
92134;202009;352590;G;4789007;2;2;0
92151;202009;352590;G;4781400;0;1;-1
92155;202009;352590;C;2949299;0;1;-1
92224;202009;352590;G;4753900;3;1;2
92710;202009;352590;F;4321500;0;1;-1
92982;202009;352590;H;5223100;0;1;-1
93804;202009;352590;N;8299706;1;1;0
94350;202009;352590;H;4930201;5;2;3
94443;202009;352590;G;4771701;1;0;1
95324;202009;352590;C;2222600;0;4;-4
95344;202009;352590;C;1032599;1;0;1
95415;202009;352590;G;4724500;69;0;69
95890;202009;352590;G;4743100;0;1;-1
96013;202009;352590;H;4929901;1;1;0
96026;202009;352590;G;4712100;0;1;-1
96361;202009;352590;I;5611201;3;0;3
96366;202009;352590;I;5611201;1;1;0
96453;202009;352590;I;5510803;0;2;-2
97932;202009;352590;Q;8630501;1;0;1
98084;202009;352590;C;1412601;0;1;-1
98132;202009;352590;F;4299599;0;7;-7
98622;202009;352590;S;9609208;0;1;-1
98789;202009;352590;G;4520002;2;0;2
98872;202009;352590;S;9430800;2;2;0
98918;202009;352590;G;4744001;1;1;0
100239;202009;352590;G;4729699;2;0;2
100562;202009;352590;H;4930202;0;1;-1
100899;202009;352590;N;8299706;1;0;1
101189;202009;352590;N;8112500;1;0;1
101817;202009;352590;G;4729699;0;1;-1
101833;202009;352590;G;4781400;0;1;-1
102224;202009;352590;J;5914600;0;1;-1
102312;202009;352590;G;4530703;6;4;2
102334;202009;352590;I;5611201;0;1;-1
102335;202009;352590;F;4110700;0;1;-1
102507;202009;352590;G;4687701;0;2;-2
102617;202009;352590;H;4930202;1;0;1
102816;202009;352590;G;4731800;1;0;1
102818;202009;352590;G;4782201;0;2;-2
103206;202009;352590;C;2330302;0;1;-1
103278;202009;352590;F;4313400;22;16;6
103432;202009;352590;G;4511101;14;8;6
103663;202009;352590;G;4744099;1;0;1
103667;202009;352590;P;8512100;0;3;-3
103742;202009;352590;F;4330404;0;2;-2
103896;202009;352590;P;8513900;0;1;-1
103964;202009;352590;H;4929902;1;0;1
104929;202009;352590;G;4751201;0;1;-1
105297;202009;352590;I;5510801;1;0;1
105317;202009;352590;J;6201501;2;0;2
105693;202009;352590;M;6920601;2;0;2
106261;202009;352590;G;4781400;0;3;-3
106667;202009;352590;N;7820500;80;124;-44
106995;202009;352590;I;5620101;0;10;-10
107653;202009;352590;Q;8712300;5;5;0
107716;202009;352590;N;8299799;3;4;-1
107811;202009;352590;G;4781400;0;2;-2
108076;202009;352590;H;5240199;0;4;-4
108258;202009;352590;J;6202300;1;1;0
108852;202009;352590;M;6920601;0;2;-2
109331;202009;352590;M;7119701;1;0;1
109337;202009;352590;G;4781400;0;1;-1
109550;202009;352590;G;4731800;0;1;-1
109579;202009;352590;G;4781400;1;0;1
109602;202009;352590;G;4772500;1;0;1
109660;202009;352590;G;4752100;0;1;-1
109764;202009;352590;G;4772500;0;1;-1
110372;202009;352590;G;4541203;0;1;-1
111273;202009;352590;R;9313100;1;0;1
112026;202009;352590;N;8299799;2;0;2
112223;202009;352590;J;6201501;0;1;-1
113179;202009;352590;G;4687702;1;0;1
113465;202009;352590;G;4693100;1;0;1
113644;202009;352590;G;4711302;5;3;2
113776;202009;352590;G;4753900;1;0;1
113779;202009;352590;Q;8640204;2;2;0
113895;202009;352590;G;4649499;1;0;1
113952;202009;352590;G;4771701;0;1;-1
114231;202009;352590;Q;8630503;1;0;1
114264;202009;352590;G;4751201;0;1;-1
115259;202009;352590;Q;8650003;2;0;2
115355;202009;352590;G;4744099;1;1;0
115483;202009;352590;C;2823200;2;0;2
115686;202009;352590;C;2825900;1;1;0
115743;202009;352590;G;4772500;1;1;0
115750;202009;352590;G;4772500;1;3;-2
115850;202009;352590;M;7112000;1;0;1
115910;202009;352590;H;4929902;2;0;2
116416;202009;352590;G;4781400;1;0;1
116528;202009;352590;G;4741500;0;1;-1
116802;202009;352590;C;2399101;1;1;0
116805;202009;352590;G;4530703;0;1;-1
117015;202009;352590;C;3250701;0;1;-1
117238;202009;352590;G;4759899;5;3;2
117239;202009;352590;G;4759899;2;0;2
117250;202009;352590;G;4649499;7;4;3
117345;202009;352590;G;4761001;0;1;-1
117493;202009;352590;G;4520001;1;1;0
117952;202009;352590;G;4744002;2;0;2
118121;202009;352590;H;4930203;1;0;1
118149;202009;352590;N;8299799;1;1;0
118177;202009;352590;G;4712100;0;1;-1
118221;202009;352590;N;8299799;0;3;-3
118366;202009;352590;J;6204000;1;0;1
118420;202009;352590;F;4222701;0;2;-2
118606;202009;352590;C;1099699;3;5;-2
118848;202009;352590;G;4645101;1;0;1
119262;202009;352590;C;1091102;0;2;-2
119669;202009;352590;G;4711302;13;13;0
119810;202009;352590;G;4711301;7;23;-16
120020;202009;352590;G;4711302;1;1;0
120578;202009;352590;I;5611203;0;1;-1
120655;202009;352590;G;4751200;0;1;-1
120834;202009;352590;P;8531700;0;4;-4
121191;202009;352590;G;4744001;0;1;-1
121859;202009;352590;G;4753900;1;0;1
121876;202009;352590;G;4789002;3;1;2
122025;202009;352590;C;2591800;0;2;-2
122704;202009;352590;G;4761001;1;1;0
122829;202009;352590;G;4530703;0;3;-3
124473;202009;352590;G;4530703;1;0;1
124583;202009;352590;F;4313400;0;14;-14
125340;202009;352590;C;1013902;1;2;-1
126470;202009;352590;C;1413402;1;1;0
126504;202009;352590;G;4712100;1;4;-3
126663;202009;352590;G;4789002;2;1;1
127076;202009;352590;G;4763602;1;2;-1
127422;202009;352590;H;4930202;11;7;4
129812;202009;352590;G;4731800;0;3;-3
129852;202009;352590;N;8299799;0;3;-3
129928;202009;352590;F;4120400;0;1;-1
130702;202009;352590;G;4652400;0;19;-19
131377;202009;352590;F;4330401;3;0;3
131423;202009;352590;G;4687702;0;1;-1
131651;202009;352590;C;2710402;3;1;2
131785;202009;352590;G;4520001;1;1;0
131840;202009;352590;G;4711302;17;8;9
132193;202009;352590;H;4930202;0;2;-2
132907;202009;352590;G;4781400;0;1;-1
133023;202009;352590;Q;8800600;2;0;2
133422;202009;352590;G;4731800;2;0;2
133551;202009;352590;I;5611201;0;1;-1
133859;202009;352590;N;8011101;8;6;2
134349;202009;352590;G;4781400;0;1;-1
134467;202009;352590;G;4754702;0;1;-1
134655;202009;352590;K;6424703;1;1;0
134715;202009;352590;N;8291100;2;1;1
135104;202009;352590;H;4930202;1;2;-1
135529;202009;352590;N;8211300;1;4;-3
135688;202009;352590;G;4729699;0;1;-1
135847;202009;352590;G;4530703;2;0;2
136265;202009;352590;G;4781400;7;6;1
136570;202009;352590;G;4744099;3;0;3
136742;202009;352590;G;4530703;1;1;0
136785;202009;352590;C;2790299;19;4;15
136809;202009;352590;M;7500100;0;1;-1
137387;202009;352590;N;8219999;0;1;-1
137409;202009;352590;H;4930202;2;1;1
137695;202009;352590;E;3701100;2;0;2
137749;202009;352590;C;1053800;1;3;-2
137903;202009;352590;Q;8630501;3;6;-3
138292;202009;352590;G;4633801;10;5;5
139261;202009;352590;G;4744099;0;2;-2
139531;202009;352590;P;8599605;1;1;0
140403;202009;352590;I;5611201;0;1;-1
140404;202009;352590;N;8111700;2;4;-2
140992;202009;352590;F;4299599;5;2;3
141062;202009;352590;G;4685100;0;1;-1
141175;202009;352590;G;4713002;2;0;2
141176;202009;352590;G;4713002;0;3;-3
141829;202009;352590;C;1813099;0;1;-1
141976;202009;352590;S;9430800;3;2;1
141985;202009;352590;G;4530703;1;0;1
142176;202009;352590;P;8599604;1;1;0
142627;202009;352590;G;4771701;0;1;-1
142749;202009;352590;H;5223100;0;1;-1
142817;202009;352590;I;5611201;1;2;-1
143067;202009;352590;M;7490104;0;1;-1
143426;202009;352590;G;4652400;1;2;-1
143858;202009;352590;I;5611201;0;2;-2
144769;202009;352590;C;2219600;2;0;2
145169;202009;352590;H;4930202;1;1;0
145215;202009;352590;G;4731800;0;1;-1
145473;202009;352590;C;2029100;10;12;-2
145500;202009;352590;G;4635402;1;1;0
145524;202009;352590;K;6622300;1;0;1
145531;202009;352590;G;4744002;1;0;1
145991;202009;352590;H;4930202;1;0;1
146877;202009;352590;H;4930202;3;1;2
147021;202009;352590;G;4789005;1;0;1
147033;202009;352590;M;6920601;1;0;1
147120;202009;352590;G;4772500;0;1;-1
147155;202009;352590;M;7020400;2;0;2
147317;202009;352590;R;9313100;1;0;1
147430;202009;352590;G;4754703;1;2;-1
147568;202009;352590;G;4520005;1;0;1
148058;202009;352590;G;4617600;1;1;0
148275;202009;352590;H;4923002;1;0;1
148288;202009;352590;C;1062700;1;0;1
148301;202009;352590;J;6311900;0;1;-1
148945;202009;352590;G;4722901;0;1;-1
149038;202009;352590;G;4781400;0;1;-1
149408;202009;352590;J;6204000;2;0;2
149487;202009;352590;J;6201501;0;1;-1
149639;202009;352590;I;5510801;0;5;-5
149823;202009;352590;I;5611201;0;1;-1
149994;202009;352590;C;1031700;0;2;-2
150254;202009;352590;P;8520100;0;4;-4
150261;202009;352590;J;6201500;0;1;-1
150373;202009;352590;G;4771702;0;1;-1
150495;202009;352590;J;6203100;5;1;4
150510;202009;352590;H;4930202;0;2;-2
151108;202009;352590;G;4772500;0;1;-1
151472;202009;352590;C;1053800;10;3;7
151500;202009;352590;S;9499500;1;0;1
151823;202009;352590;H;4930202;3;2;1
151825;202009;352590;H;4930201;0;1;-1
152865;202009;352590;G;4712100;3;2;1
152866;202009;352590;G;4520001;1;0;1
152952;202009;352590;C;1099601;2;2;0
153035;202009;352590;I;5611201;0;1;-1
153036;202009;352590;H;4930201;0;1;-1
153073;202009;352590;G;4771702;1;0;1
153329;202009;352590;C;1042200;1;1;0
153444;202009;352590;N;8219999;0;1;-1
153452;202009;352590;P;8513900;3;2;1
153453;202009;352590;P;8513900;4;4;0
153580;202009;352590;A;210107;0;1;-1
153922;202009;352590;H;4930202;0;1;-1
154233;202009;352590;G;4781400;0;1;-1
154339;202009;352590;N;8219999;1;0;1
154473;202009;352590;H;5212500;1;1;0
154787;202009;352590;N;7911200;0;1;-1
155029;202009;352590;K;6619399;1;0;1
155557;202009;352590;J;6190699;0;1;-1
155574;202009;352590;N;8219901;2;0;2
155606;202009;352590;C;1062700;0;1;-1
156105;202009;352590;G;4511101;1;0;1
156345;202009;352590;M;6920601;2;0;2
156440;202009;352590;M;7112000;4;0;4
156970;202009;352590;I;5611203;1;0;1
156983;202009;352590;I;5611203;1;0;1
157583;202009;352590;N;8130300;0;2;-2
157602;202009;352590;M;7020400;1;0;1
157751;202009;352590;N;8112500;0;1;-1
158046;202009;352590;J;5813100;0;2;-2
158915;202009;352590;N;7732201;0;1;-1
158966;202009;352590;K;6622300;0;1;-1
159337;202009;352590;G;4530703;1;0;1
159510;202009;352590;G;4753900;1;2;-1
159511;202009;352590;G;4753900;3;2;1
159635;202009;352590;G;4789099;1;1;0
160315;202009;352590;G;4639701;1;1;0
160871;202009;352590;G;4721104;0;1;-1
161246;202009;352590;M;6920601;1;1;0
161371;202009;352590;G;4751201;0;1;-1
161491;202009;352590;I;5611201;0;2;-2
161999;202009;352590;M;7490104;1;1;0
162521;202009;352590;C;2621300;22;208;-186
162522;202009;352590;C;2632900;157;14;143
162577;202009;352590;N;8299799;75;64;11
163413;202009;352590;G;4729699;1;1;0
164101;202009;352590;C;1096100;0;2;-2
164165;202009;352590;H;5212500;16;2;14
164570;202009;352590;M;7311400;3;2;1
164608;202009;352590;H;4930202;1;1;0
165111;202009;352590;H;5112901;3;0;3
165610;202009;352590;G;4731800;2;1;1
165634;202009;352590;I;5611203;2;0;2
165635;202009;352590;I;5611203;0;1;-1
166005;202009;352590;F;4321500;0;1;-1
166067;202009;352590;N;7732201;2;3;-1
166329;202009;352590;G;4744099;1;0;1
166441;202009;352590;N;7830200;0;1;-1
166545;202009;352590;N;7733100;0;1;-1
166622;202009;352590;I;5611203;1;0;1
166769;202009;352590;P;8513900;0;1;-1
166861;202009;352590;C;3313999;1;0;1
166909;202009;352590;G;4759899;0;1;-1
168009;202009;352590;H;4930202;2;3;-1
168321;202009;352590;G;4731800;2;0;2
168361;202009;352590;G;4635499;0;5;-5
168911;202009;352590;H;4930202;0;1;-1
169187;202009;352590;Q;8630501;1;1;0
169529;202009;352590;J;5829800;1;0;1
169681;202009;352590;F;4120400;2;3;-1
170086;202009;352590;N;7810800;0;1;-1
170531;202009;352590;G;4744001;3;0;3
171521;202009;352590;N;8112500;0;1;-1
171766;202009;352590;F;4213800;4;4;0
172246;202009;352590;C;2840200;1;0;1
172262;202009;352590;G;4729699;2;1;1
172270;202009;352590;G;4763601;0;2;-2
172535;202009;352590;C;2539001;1;0;1
172709;202009;352590;H;5212500;25;11;14
172800;202009;352590;N;8111700;10;7;3
173873;202009;352590;N;7820500;5;4;1
174501;202009;352590;I;5620104;0;1;-1
174725;202009;352590;C;2093200;0;1;-1
174840;202009;352590;G;4744001;1;0;1
175476;202009;352590;H;4930202;1;0;1
175922;202009;352590;Q;8630503;1;0;1
176094;202009;352590;G;4729699;3;10;-7
176179;202009;352590;F;4120400;2;0;2
176378;202009;352590;G;4744003;1;0;1
176602;202009;352590;F;4110700;3;0;3
176684;202009;352590;P;8599603;1;0;1
177398;202009;352590;G;4774100;0;1;-1
177426;202009;352590;C;3101200;1;0;1
177681;202009;352590;H;4930202;3;0;3
177818;202009;352590;F;4222701;0;1;-1
178048;202009;352590;I;5611203;1;0;1
178054;202009;352590;G;4789099;2;2;0
178246;202009;352590;G;4686902;4;2;2
178736;202009;352590;Q;8711502;2;1;1
179165;202009;352590;G;4759899;3;1;2
179378;202009;352590;C;2222600;1;0;1
179762;202009;352590;I;5611201;0;1;-1
180151;202009;352590;G;4511101;4;2;2
181113;202009;352590;I;5611201;0;4;-4
181275;202009;352590;N;7740300;3;0;3
181404;202009;352590;G;4774100;1;0;1
181917;202009;352590;I;5510801;0;1;-1
182193;202009;352590;G;4754701;14;2;12
182194;202009;352590;G;4754701;2;1;1
182632;202009;352590;H;4930201;0;1;-1
183103;202009;352590;H;4930203;1;0;1
183544;202009;352590;I;5611201;6;0;6
183545;202009;352590;I;5611201;0;1;-1
183951;202009;352590;I;5611201;0;1;-1
183981;202009;352590;G;4731800;1;0;1
184065;202009;352590;I;5611201;1;0;1
184390;202009;352590;I;5611201;0;1;-1
185108;202009;352590;G;4759899;0;1;-1
185219;202009;352590;G;4731800;1;1;0
185509;202009;352590;M;6920601;0;1;-1
185594;202009;352590;G;4789005;1;0;1
185795;202009;352590;G;4520001;0;1;-1
185797;202009;352590;F;4330404;1;0;1
185798;202009;352590;F;4330404;2;1;1
185802;202009;352590;N;7830200;14;37;-23
185829;202009;352590;N;8211300;1;0;1
186035;202009;352590;G;4754701;3;1;2
186218;202009;352590;M;6920601;2;1;1
186304;202009;352590;G;4782201;1;0;1
186523;202009;352590;S;9521500;1;0;1
186524;202009;352590;S;9521500;0;5;-5
186538;202009;352590;Q;8630503;1;0;1
186938;202009;352590;M;7112000;6;2;4
186939;202009;352590;J;6204000;3;2;1
187130;202009;352590;G;4781400;1;0;1
187937;202009;352590;G;4530703;0;1;-1
188228;202009;352590;K;6622300;1;0;1
189219;202009;352590;G;4722901;1;0;1
189328;202009;352590;I;5611201;3;6;-3
189409;202009;352590;G;4541203;1;0;1
189841;202009;352590;H;4930202;0;1;-1
190044;202009;352590;N;8011101;10;2;8
190280;202009;352590;G;4663000;1;0;1
190314;202009;352590;G;4713002;4;0;4
190375;202009;352590;I;5611201;1;1;0
190610;202009;352590;G;4711302;1;0;1
191249;202009;352590;I;5620101;3;3;0
191390;202009;352590;C;1094500;1;0;1
191412;202009;352590;Q;8610101;14;6;8
191576;202009;352590;G;4520002;0;1;-1
191958;202009;352590;N;8219999;0;1;-1
192026;202009;352590;G;4724500;12;9;3
192027;202009;352590;G;4724500;14;13;1
192200;202009;352590;G;4781400;2;0;2
193115;202009;352590;M;7500100;1;0;1
193250;202009;352590;C;2599302;0;1;-1
193355;202009;352590;C;2222600;0;2;-2
193584;202009;352590;P;8593700;2;0;2
193689;202009;352590;C;2812700;0;1;-1
193794;202009;352590;C;2229399;0;1;-1
193838;202009;352590;F;4120400;0;1;-1
193956;202009;352590;G;4721102;1;0;1
194043;202009;352590;J;5914600;0;1;-1
194152;202009;352590;C;1112700;1;0;1
194927;202009;352590;I;5510801;2;1;1
195073;202009;352590;H;5250805;4;2;2
195105;202009;352590;C;2621300;1;2;-1
195593;202009;352590;G;4691500;7;4;3
196318;202009;352590;G;4721103;2;1;1
196432;202009;352590;F;4330401;0;1;-1
196898;202009;352590;C;2511000;1;1;0
197237;202009;352590;Q;8630503;1;0;1
197705;202009;352590;C;1352900;1;0;1
198368;202009;352590;G;4731800;1;0;1
198532;202009;352590;M;6920601;4;1;3
199039;202009;352590;N;8299799;0;1;-1
199206;202009;352590;G;4520005;0;1;-1
199279;202009;352590;M;7111100;4;0;4
199454;202009;352590;G;4618402;0;1;-1
199835;202009;352590;G;4774100;0;1;-1
200025;202009;352590;G;4771701;1;0;1
200126;202009;352590;R;9313100;0;3;-3
200283;202009;352590;G;4712100;1;0;1
200467;202009;352590;G;4633801;0;1;-1
200683;202009;352590;P;8593700;0;1;-1
201524;202009;352590;P;8599604;1;1;0
201541;202009;352590;G;4511101;0;1;-1
201841;202009;352590;H;5211701;0;3;-3
201856;202009;352590;K;6491300;0;1;-1
202230;202009;352590;Q;8711502;0;1;-1
202419;202009;352590;Q;8711502;2;0;2
202496;202009;352590;G;4782201;1;4;-3
202512;202009;352590;H;4930202;0;1;-1
202694;202009;352590;N;8211300;1;0;1
202795;202009;352590;G;4520004;0;1;-1
203101;202009;352590;G;4744002;1;0;1
203659;202009;352590;N;8211300;1;4;-3
203930;202009;352590;G;4789004;1;0;1
204346;202009;352590;N;8220200;0;2;-2
205928;202009;352590;G;4742300;0;1;-1
206445;202009;352590;N;8122200;1;0;1
206609;202009;352590;G;4744099;1;0;1
207142;202009;352590;G;4761003;1;0;1
208074;202009;352590;G;4742300;0;1;-1
208647;202009;352590;H;4930202;0;1;-1
208871;202009;352590;J;6204000;1;0;1
210231;202009;352590;G;4732600;1;0;1
210434;202009;352590;J;6399200;5;0;5
210457;202009;352590;C;2222600;26;2;24
210604;202009;352590;F;4292802;0;2;-2
211001;202009;352590;C;3314707;1;0;1
211935;202009;352590;M;6920601;0;1;-1
212265;202009;352590;H;4930202;0;1;-1
212687;202009;352590;G;4635499;1;0;1
213127;202009;352590;C;1629301;4;0;4
214164;202009;352590;S;9609299;0;1;-1
214180;202009;352590;G;4712100;4;0;4
214181;202009;352590;N;8299799;7;0;7
214503;202009;352590;G;4771701;0;1;-1
214577;202009;352590;G;4511101;0;2;-2
215905;202009;352590;Q;8630502;1;0;1
216062;202009;352590;F;4321500;1;2;-1
216206;202009;352590;M;6920601;1;1;0
216433;202009;352590;H;4930202;1;1;0
216661;202009;352590;G;4530703;2;0;2
217047;202009;352590;F;4330401;1;0;1
217766;202009;352590;C;3313901;0;1;-1
218198;202009;352590;C;3314719;0;1;-1
218311;202009;352590;P;8511200;0;1;-1
218580;202009;352590;G;4651601;0;1;-1
218617;202009;352590;H;4930202;36;18;18
218804;202009;352590;F;4213800;0;1;-1
218893;202009;352590;C;1099699;1;1;0
219837;202009;352590;F;4292801;1;0;1
220100;202009;352590;F;4120400;0;1;-1
220243;202009;352590;G;4646001;0;1;-1
220954;202009;352590;G;4712100;1;0;1
221858;202009;352590;G;4623109;3;2;1
221859;202009;352590;G;4623109;0;1;-1
221877;202009;352590;G;4781400;5;85;-80
221887;202009;352590;G;4511104;1;3;-2
221914;202009;352590;P;8513900;1;0;1
221917;202009;352590;N;8130300;12;11;1
221918;202009;352590;G;4789099;0;3;-3
221997;202009;352590;S;9602501;1;0;1
222506;202009;352590;S;9601701;0;1;-1
222570;202009;352590;G;4761003;1;0;1
223227;202009;352590;C;3250706;1;0;1
223407;202009;352590;G;4782201;0;1;-1
223408;202009;352590;G;4781400;1;1;0
223409;202009;352590;G;4781400;1;0;1
223630;202009;352590;G;4633801;1;1;0
223854;202009;352590;M;6920601;0;1;-1
223941;202009;352590;N;8299799;1;0;1
224005;202009;352590;P;8512100;0;6;-6
224006;202009;352590;P;8512100;0;4;-4
224370;202009;352590;N;8299799;3;6;-3
224701;202009;352590;C;2311700;1;0;1
225342;202009;352590;G;4751201;1;0;1
225360;202009;352590;H;5212500;4;10;-6
225742;202009;352590;C;2349401;4;0;4
226110;202009;352590;G;4520005;1;0;1
226200;202009;352590;Q;8630501;2;1;1
226523;202009;352590;M;7500100;0;2;-2
227232;202009;352590;M;7490199;0;1;-1
227589;202009;352590;S;9430800;0;1;-1
227594;202009;352590;G;4773300;1;0;1
227976;202009;352590;N;8211300;2;0;2
228034;202009;352590;Q;8630506;1;0;1
229431;202009;352590;C;2072000;2;0;2
229443;202009;352590;N;8011101;8;0;8
230550;202009;352590;Q;8711502;0;1;-1
230556;202009;352590;P;8599604;0;1;-1
230647;202009;352590;G;4649499;5;2;3
231292;202009;352590;P;8513900;1;0;1
231637;202009;352590;G;4789002;0;1;-1
231763;202009;352590;G;4744004;0;1;-1
232065;202009;352590;C;2599399;1;0;1
232117;202009;352590;C;1830003;0;1;-1
232179;202009;352590;G;4782201;1;0;1
232589;202009;352590;M;7490199;1;1;0
232849;202009;352590;Q;8712300;1;0;1
232999;202009;352590;N;8299799;0;1;-1
233079;202009;352590;C;1091101;12;7;5
235269;202009;352590;P;8513900;0;1;-1
235270;202009;352590;G;4789004;0;1;-1
235308;202009;352590;G;4789001;0;1;-1
235470;202009;352590;I;5620101;0;1;-1
235481;202009;352590;G;4721102;1;1;0
235497;202009;352590;P;8599603;3;1;2
235752;202009;352590;C;3314799;3;2;1
235923;202009;352590;I;5611201;1;1;0
236428;202009;352590;G;4520001;1;1;0
237221;202009;352590;G;4789002;2;0;2
237622;202009;352590;G;4751201;1;0;1
237829;202009;352590;F;4120400;1;2;-1
238015;202009;352590;C;2229302;1;0;1
238179;202009;352590;H;5250805;1;1;0
238221;202009;352590;N;8299799;0;1;-1
238320;202009;352590;J;6311900;1;0;1
238359;202009;352590;C;2790299;2;2;0
238715;202009;352590;J;5811500;3;1;2
238785;202009;352590;M;6920601;0;1;-1
239079;202009;352590;F;4322302;2;0;2
239271;202009;352590;L;6821802;8;1;7
239502;202009;352590;G;4781400;0;1;-1
239824;202009;352590;I;5611201;2;0;2
240129;202009;352590;H;4930202;0;1;-1
240356;202009;352590;S;9609203;0;1;-1
240359;202009;352590;G;4511102;1;0;1
240541;202009;352590;N;7820500;0;1;-1
240569;202009;352590;C;1733800;8;1;7
240788;202009;352590;P;8520100;0;3;-3
240808;202009;352590;F;4322301;0;1;-1
241059;202009;352590;S;9601701;2;2;0
241589;202009;352590;G;4781400;0;5;-5
241719;202009;352590;J;6203100;1;0;1
241737;202009;352590;P;8599604;1;0;1
241828;202009;352590;G;4689301;1;0;1
241918;202009;352590;G;4731800;1;0;1
243164;202009;352590;F;4399103;0;1;-1
243404;202009;352590;G;4781400;1;1;0
243538;202009;352590;C;1066000;5;8;-3
243952;202009;352590;G;4634601;0;1;-1
243958;202009;352590;G;4781400;0;1;-1
243959;202009;352590;G;4781400;0;1;-1
244025;202009;352590;H;4930202;63;6;57
244050;202009;352590;S;9521500;3;1;2
244604;202009;352590;G;4712100;2;0;2
244660;202009;352590;C;3250705;3;11;-8
245274;202009;352590;M;7490199;2;1;1
245300;202009;352590;E;3821100;15;8;7
245302;202009;352590;I;5611201;2;3;-1
245341;202009;352590;K;6462000;1;1;0
245386;202009;352590;N;8111700;27;13;14
245531;202009;352590;G;4757100;1;1;0
245570;202009;352590;F;4330499;9;0;9
245616;202009;352590;Q;8650003;1;0;1
246030;202009;352590;M;6920601;1;0;1
246177;202009;352590;G;4744005;1;0;1
246628;202009;352590;F;4120400;5;0;5
246762;202009;352590;I;5611201;1;0;1
247234;202009;352590;G;4783101;3;0;3
247255;202009;352590;I;5510801;1;0;1
247564;202009;352590;I;5611201;5;2;3
247765;202009;352590;G;4755503;0;1;-1
247856;202009;352590;I;5611201;0;1;-1
248244;202009;352590;M;7490104;1;1;0
249030;202009;352590;N;8111700;1;2;-1
249158;202009;352590;G;4783101;1;0;1
249366;202009;352590;I;5620104;1;0;1
249918;202009;352590;G;4520005;0;1;-1
250033;202009;352590;C;2342702;1;1;0
250052;202009;352590;G;4744001;1;1;0
250476;202009;352590;G;4782201;0;1;-1
250566;202009;352590;F;4120400;0;3;-3
251484;202009;352590;P;8511200;0;1;-1
251677;202009;352590;L;6821801;1;0;1
252065;202009;352590;R;9329804;0;5;-5
252080;202009;352590;N;7732201;0;1;-1
252352;202009;352590;F;4120400;0;2;-2
253854;202009;352590;G;4754701;1;0;1
254182;202009;352590;H;4930201;0;1;-1
254197;202009;352590;P;8511200;1;0;1
254340;202009;352590;I;5611203;1;0;1
254600;202009;352590;G;4781400;1;0;1
254715;202009;352590;H;4930202;2;1;1
256049;202009;352590;Q;8650004;0;1;-1
256629;202009;352590;G;4772500;1;2;-1
256971;202009;352590;G;4541204;0;1;-1
256981;202009;352590;S;9511800;1;0;1
257104;202009;352590;F;4322301;0;1;-1
257394;202009;352590;G;4530701;1;0;1
257395;202009;352590;G;4530703;1;1;0
258183;202009;352590;N;8291100;1;0;1
258332;202009;352590;G;4691500;4;7;-3
258768;202009;352590;G;4743100;1;0;1
259503;202009;352590;G;4637199;0;2;-2
259761;202009;352590;M;7311400;1;0;1
259762;202009;352590;I;5611201;0;1;-1
259813;202009;352590;I;5611203;0;2;-2
259874;202009;352590;I;5611203;1;0;1
259878;202009;352590;I;5611203;5;1;4
260309;202009;352590;I;5611203;2;3;-1
260474;202009;352590;C;1091102;1;0;1
260904;202009;352590;C;3314704;3;1;2
261300;202009;352590;F;4330403;1;0;1
261301;202009;352590;F;4330403;1;0;1
261303;202009;352590;F;4330499;0;1;-1
262462;202009;352590;F;4330404;0;1;-1
262868;202009;352590;N;7733100;0;1;-1
262912;202009;352590;G;4637199;1;0;1
263022;202009;352590;G;4744099;0;1;-1
263567;202009;352590;I;5611201;4;1;3
263605;202009;352590;I;5611201;2;1;1
264166;202009;352590;I;5620104;0;1;-1
264171;202009;352590;Q;8630502;2;1;1
264990;202009;352590;H;4930201;2;0;2
265158;202009;352590;S;9511800;1;1;0
265447;202009;352590;F;4399101;1;0;1
265576;202009;352590;G;4669999;5;4;1
265677;202009;352590;N;7990200;0;1;-1
266414;202009;352590;G;4763601;2;1;1
266427;202009;352590;F;4399103;1;0;1
266436;202009;352590;H;4930201;1;0;1
267176;202009;352590;I;5611203;0;3;-3
267772;202009;352590;G;4632003;2;0;2
268710;202009;352590;L;6810201;1;0;1
268989;202009;352590;G;4722901;2;0;2
269555;202009;352590;G;4781400;2;0;2
270364;202009;352590;P;8541400;1;0;1
270482;202009;352590;L;6810201;2;0;2
270577;202009;352590;G;4686902;3;1;2
270594;202009;352590;G;4772500;0;1;-1
271646;202009;352590;K;6622300;1;2;-1
271879;202009;352590;G;4763603;1;0;1
271995;202009;352590;G;4646001;0;3;-3
273032;202009;352590;G;4614100;1;0;1
273266;202009;352590;G;4789099;1;1;0
273931;202009;352590;N;8112500;1;0;1
273941;202009;352590;N;7911200;1;1;0
273954;202009;352590;I;5611203;1;0;1
273963;202009;352590;H;5211701;28;17;11
275038;202009;352590;G;4530704;8;1;7
275110;202009;352590;G;4753900;2;0;2
275325;202009;352590;G;4789099;1;0;1
275566;202009;352590;C;2399101;3;0;3
276580;202009;352590;G;4744001;2;0;2
276768;202009;352590;G;4754701;22;31;-9
276831;202009;352590;N;8112500;0;1;-1
276894;202009;352590;G;4633801;0;1;-1
277294;202009;352590;C;1091102;2;2;0
277432;202009;352590;G;4744099;4;0;4
277434;202009;352590;N;8299799;0;1;-1
277440;202009;352590;G;4771702;1;0;1
277443;202009;352590;C;1091101;4;5;-1
277446;202009;352590;C;2599399;3;7;-4
277581;202009;352590;C;3314708;1;2;-1
277768;202009;352590;H;5223100;0;1;-1
278145;202009;352590;C;3314710;1;0;1
278146;202009;352590;C;3314710;0;1;-1
278751;202009;352590;H;4930202;3;0;3
279413;202009;352590;G;4759899;5;0;5
279457;202009;352590;P;8520100;1;0;1
280019;202009;352590;F;4399103;2;2;0
280204;202009;352590;G;4772500;0;1;-1
281781;202009;352590;F;4120400;0;1;-1
281958;202009;352590;G;4511102;1;0;1
282050;202009;352590;F;4399199;2;0;2
282180;202009;352590;F;4330402;0;1;-1
282552;202009;352590;G;4530703;3;0;3
282664;202009;352590;G;4761001;5;4;1
283605;202009;352590;G;4724500;1;0;1
283607;202009;352590;N;8130300;0;1;-1
284214;202009;352590;F;4322303;8;1;7
284954;202009;352590;G;4741500;3;0;3
285696;202009;352590;G;4772500;2;1;1
285782;202009;352590;J;6311900;0;1;-1
286529;202009;352590;N;7911200;0;1;-1
287202;202009;352590;G;4774100;1;0;1
287418;202009;352590;G;4520001;0;1;-1
287443;202009;352590;N;7810800;2;1;1
287449;202009;352590;G;4721104;5;3;2
287450;202009;352590;G;4637107;3;0;3
287524;202009;352590;C;3101200;5;1;4
287526;202009;352590;G;4754701;5;1;4
287930;202009;352590;I;5611203;0;1;-1
288430;202009;352590;J;6190699;0;3;-3
288796;202009;352590;C;1053800;0;2;-2
289134;202009;352590;Q;8712300;5;7;-2
289449;202009;352590;F;4120400;0;12;-12
289648;202009;352590;G;4744099;1;5;-4
289852;202009;352590;G;4744005;0;1;-1
289856;202009;352590;G;4781400;0;1;-1
289947;202009;352590;N;8121400;0;1;-1
289982;202009;352590;N;7732201;1;0;1
290005;202009;352590;G;4663000;0;1;-1
290081;202009;352590;I;5611203;0;1;-1
290310;202009;352590;C;2542000;2;1;1
290383;202009;352590;M;6920601;1;0;1
290480;202009;352590;I;5620104;2;0;2
290651;202009;352590;I;5611201;0;1;-1
290653;202009;352590;G;4781400;0;1;-1
292579;202009;352590;F;4399104;0;1;-1
292652;202009;352590;P;8512100;0;2;-2
292871;202009;352590;C;2229303;0;1;-1
292970;202009;352590;G;4782201;0;1;-1
294113;202009;352590;N;7711000;2;1;1
294235;202009;352590;S;9529105;1;1;0
294440;202009;352590;Q;8630503;1;1;0
294593;202009;352590;C;3101200;2;0;2
295268;202009;352590;N;8299799;0;1;-1
295366;202009;352590;F;4120400;0;1;-1
296033;202009;352590;G;4712100;1;0;1
296213;202009;352590;E;3811400;0;1;-1
296310;202009;352590;G;4782201;0;5;-5
296759;202009;352590;I;5620102;0;1;-1
296884;202009;352590;G;4782201;1;1;0
297115;202009;352590;I;5611203;1;0;1
297366;202009;352590;H;4930202;26;37;-11
297373;202009;352590;F;4321500;0;1;-1
297495;202009;352590;H;5211701;1;2;-1
297764;202009;352590;G;4759899;0;1;-1
297774;202009;352590;I;5611201;0;1;-1
298158;202009;352590;I;5611201;0;1;-1
298316;202009;352590;Q;8650004;1;0;1
299802;202009;352590;N;8219999;0;1;-1
299817;202009;352590;H;4930202;2;0;2
300347;202009;352590;I;5611203;1;0;1
300556;202009;352590;G;4623109;0;1;-1
300910;202009;352590;R;9313100;1;0;1
300911;202009;352590;R;9313100;0;1;-1
301028;202009;352590;S;9602502;4;0;4
301141;202009;352590;S;9603301;4;4;0
301942;202009;352590;H;5240199;1;2;-1
302339;202009;352590;M;6920601;2;0;2
302369;202009;352590;S;9602502;1;1;0
303003;202009;352590;I;5611201;0;1;-1
303620;202009;352590;G;4754701;2;0;2
303719;202009;352590;N;8130300;1;0;1
303722;202009;352590;G;4781400;5;0;5
303733;202009;352590;H;4930202;0;1;-1
305043;202009;352590;Q;8630503;1;0;1
305994;202009;352590;N;8121400;3;2;1
306400;202009;352590;R;9313100;1;0;1
306801;202009;352590;G;4774100;1;1;0
306929;202009;352590;Q;8630503;1;0;1
306933;202009;352590;G;4751201;1;2;-1
307129;202009;352590;H;5250803;1;0;1
307139;202009;352590;G;4781400;0;1;-1
307429;202009;352590;G;4520005;12;6;6
307729;202009;352590;M;7120100;0;1;-1
308023;202009;352590;N;8219999;2;1;1
309013;202009;352590;F;4120400;7;3;4
309255;202009;352590;H;4930202;1;0;1
309794;202009;352590;H;4930202;1;1;0
310144;202009;352590;G;4789004;0;1;-1
310166;202009;352590;G;4530703;0;1;-1
310639;202009;352590;G;4541201;0;2;-2
310646;202009;352590;G;4663000;1;0;1
310812;202009;352590;G;4752100;2;1;1
311149;202009;352590;I;5611201;0;1;-1
311545;202009;352590;F;4120400;0;3;-3
311597;202009;352590;C;3250701;0;1;-1
311826;202009;352590;Q;8630503;1;0;1
312564;202009;352590;G;4711302;1;0;1
313078;202009;352590;G;4771702;3;2;1
313154;202009;352590;N;8299799;4;3;1
313715;202009;352590;F;4222701;0;1;-1
314013;202009;352590;G;4789099;3;0;3
314210;202009;352590;N;8211300;0;1;-1
314763;202009;352590;I;5611201;1;0;1
314965;202009;352590;G;4754701;4;0;4
315300;202009;352590;Q;8630503;1;0;1
315715;202009;352590;G;4752100;3;1;2
316075;202009;352590;F;4120400;0;8;-8
316316;202009;352590;H;4930201;0;3;-3
316318;202009;352590;H;4930201;3;0;3
316336;202009;352590;H;4930202;2;0;2
316426;202009;352590;G;4530703;0;1;-1
317637;202009;352590;G;4789004;1;2;-1
317777;202009;352590;M;7319003;3;0;3
317778;202009;352590;M;7319003;0;1;-1
317840;202009;352590;F;4399199;4;1;3
317888;202009;352590;G;4530703;1;1;0
319338;202009;352590;H;4930201;1;1;0
319340;202009;352590;K;6491300;1;1;0
319451;202009;352590;C;1091102;0;1;-1
319679;202009;352590;H;4930202;1;0;1
320400;202009;352590;G;4782201;0;1;-1
320559;202009;352590;I;5611201;0;1;-1
321482;202009;352590;G;4789004;0;1;-1
321613;202009;352590;G;4781400;1;0;1
321614;202009;352590;N;8011101;4;3;1
322088;202009;352590;I;5611201;0;1;-1
322147;202009;352590;J;6190699;2;0;2
322287;202009;352590;N;8211300;1;0;1
322381;202009;352590;G;4774100;0;1;-1
322495;202009;352590;L;6822600;3;2;1
323356;202009;352590;G;4781400;1;1;0
323833;202009;352590;G;4663000;0;1;-1
323949;202009;352590;H;4930202;6;2;4
324221;202009;352590;N;8111700;5;0;5
324229;202009;352590;G;4722901;2;0;2
324273;202009;352590;G;4781400;0;1;-1
325415;202009;352590;G;4724500;2;0;2
325997;202009;352590;J;6319400;0;1;-1
326444;202009;352590;G;4771701;1;2;-1
326731;202009;352590;S;9602501;1;0;1
327090;202009;352590;F;4321500;0;1;-1
327259;202009;352590;N;8219999;1;0;1
327587;202009;352590;P;8599605;1;1;0
327817;202009;352590;G;4781400;1;0;1
328250;202009;352590;H;5229002;1;0;1
328840;202009;352590;M;6920601;1;1;0
330092;202009;352590;G;4754701;2;0;2
330827;202009;352590;C;2222600;5;1;4
331905;202009;352590;G;4712100;0;10;-10
331984;202009;352590;G;4520002;0;1;-1
332489;202009;352590;M;6920601;0;1;-1
333022;202009;352590;G;4782202;0;1;-1
333383;202009;352590;C;2532201;1;0;1
334060;202009;352590;N;8220200;51;160;-109
334088;202009;352590;M;7490104;1;0;1
334770;202009;352590;F;4399103;12;2;10
334888;202009;352590;M;6920601;2;2;0
335505;202009;352590;G;4753900;3;1;2
336498;202009;352590;I;5611201;0;1;-1
336518;202009;352590;I;5611203;0;1;-1
336886;202009;352590;S;9430800;1;1;0
337225;202009;352590;C;1091102;0;1;-1
337559;202009;352590;S;9602502;0;1;-1
337840;202009;352590;F;4221902;0;1;-1
338806;202009;352590;I;5611201;3;0;3
339840;202009;352590;P;8599604;0;1;-1
340514;202009;352590;S;9602502;0;1;-1
340841;202009;352590;I;5620104;5;0;5
341154;202009;352590;G;4722901;1;1;0
341837;202009;352590;P;8593700;0;1;-1
342065;202009;352590;G;4774100;0;1;-1
342149;202009;352590;N;8130300;11;2;9
342265;202009;352590;G;4652400;2;1;1
342266;202009;352590;G;4752100;0;1;-1
342442;202009;352590;F;4321500;2;0;2
342528;202009;352590;F;4120400;59;24;35
342812;202009;352590;C;2222600;2;0;2
344098;202009;352590;F;4330405;3;3;0
344358;202009;352590;F;4313400;0;1;-1
344460;202009;352590;G;4530703;1;0;1
344771;202009;352590;C;3092000;1;0;1
344831;202009;352590;G;4713002;1;1;0
345177;202009;352590;N;8122200;1;2;-1
345178;202009;352590;G;4530705;2;3;-1
345179;202009;352590;G;4520001;0;1;-1
345182;202009;352590;H;4930201;1;0;1
345266;202009;352590;G;4721102;1;2;-1
346233;202009;352590;I;5620104;0;2;-2
346384;202009;352590;G;4781400;1;0;1
346634;202009;352590;I;5611203;1;0;1
346829;202009;352590;N;8299799;1;1;0
346840;202009;352590;G;4789002;2;0;2
346980;202009;352590;G;4754701;0;2;-2
347342;202009;352590;M;7500100;0;1;-1
347478;202009;352590;G;4781400;0;1;-1
347965;202009;352590;H;4930202;0;2;-2
348567;202009;352590;H;4930202;7;6;1
348735;202009;352590;Q;8712300;7;4;3
348745;202009;352590;Q;8610101;0;1;-1
349226;202009;352590;Q;8630502;0;3;-3
349474;202009;352590;H;5223100;0;1;-1
350405;202009;352590;H;5223100;1;0;1
351193;202009;352590;H;4930201;1;0;1
351263;202009;352590;P;8550302;12;3;9
351752;202009;352590;H;5320201;0;1;-1
352220;202009;352590;G;4721102;0;1;-1
352493;202009;352590;N;8111700;3;6;-3
352530;202009;352590;G;4520001;1;1;0
352535;202009;352590;H;4930201;1;1;0
352718;202009;352590;N;8211300;1;0;1
352786;202009;352590;S;9602502;1;0;1
352948;202009;352590;M;7112000;0;1;-1
353301;202009;352590;I;5611203;0;1;-1
353781;202009;352590;G;4663000;0;1;-1
354603;202009;352590;M;7312200;1;0;1
354752;202009;352590;G;4781400;0;1;-1
355148;202009;352590;G;4712100;0;1;-1
355964;202009;352590;G;4731800;3;1;2
356936;202009;352590;H;4930202;1;0;1
356976;202009;352590;C;3314707;0;1;-1
357382;202009;352590;I;5611203;0;1;-1
358295;202009;352590;I;5611201;1;0;1
358491;202009;352590;G;4772500;1;1;0
358501;202009;352590;J;6204000;3;1;2
358691;202009;352590;F;4330404;0;1;-1
358736;202009;352590;G;4669999;10;5;5
358960;202009;352590;L;6821802;1;0;1
359875;202009;352590;G;4672900;0;2;-2
359938;202009;352590;Q;8630504;1;0;1
360437;202009;352590;G;4754701;0;1;-1
361778;202009;352590;M;6920601;0;1;-1
362066;202009;352590;N;8211300;1;0;1
363564;202009;352590;H;4930202;20;10;10
364595;202009;352590;N;8121400;0;1;-1
364765;202009;352590;P;8512100;0;3;-3
365068;202009;352590;I;5620101;0;2;-2
365157;202009;352590;N;8130300;0;3;-3
365260;202009;352590;F;4399199;1;0;1
366218;202009;352590;I;5611203;0;1;-1
366381;202009;352590;H;4930202;2;0;2
366556;202009;352590;G;4744005;1;0;1
366990;202009;352590;P;8511200;2;0;2
366991;202009;352590;P;8511200;0;1;-1
367790;202009;352590;G;4530703;2;0;2
368156;202009;352590;G;4789002;3;0;3
368193;202009;352590;Q;8630504;1;0;1
368624;202009;352590;G;4754701;0;1;-1
368706;202009;352590;G;4645101;5;2;3
368711;202009;352590;M;6920601;1;0;1
369435;202009;352590;G;4789004;0;1;-1
371074;202009;352590;N;8121400;2;0;2
371534;202009;352590;G;4789099;1;0;1
371645;202009;352590;G;4729699;1;1;0
371693;202009;352590;I;5611201;0;1;-1
372413;202009;352590;M;7112000;1;0;1
372643;202009;352590;M;7112000;0;3;-3
373054;202009;352590;H;5212500;15;6;9
373182;202009;352590;G;4731800;1;3;-2
373265;202009;352590;C;1412601;0;2;-2
373424;202009;352590;G;4713001;1;5;-4
373591;202009;352590;P;8599603;2;0;2
373951;202009;352590;P;8512100;0;1;-1
374224;202009;352590;G;4511101;1;1;0
374441;202009;352590;G;4744001;2;0;2
374690;202009;352590;F;4330403;1;1;0
375750;202009;352590;C;1042200;24;3;21
375765;202009;352590;Q;8630504;1;1;0
375781;202009;352590;G;4520001;1;0;1
375791;202009;352590;C;3314719;0;1;-1
375848;202009;352590;G;4754701;1;0;1
376429;202009;352590;G;4649499;0;1;-1
376637;202009;352590;P;8599604;1;0;1
376696;202009;352590;M;7020400;1;0;1
376740;202009;352590;P;8599604;2;0;2
376987;202009;352590;N;8211300;1;1;0
377061;202009;352590;P;8512100;1;0;1
377063;202009;352590;M;7120100;1;0;1
377210;202009;352590;G;4754701;1;0;1
377335;202009;352590;G;4729699;13;1;12
377576;202009;352590;N;7721700;1;0;1
377888;202009;352590;G;4789099;1;0;1
378067;202009;352590;I;5611201;0;1;-1
378068;202009;352590;G;4789007;0;1;-1
378491;202009;352590;N;8111700;0;1;-1
379146;202009;352590;F;4291000;5;2;3
379768;202009;352590;G;4649402;1;0;1
380226;202009;352590;G;4789099;0;1;-1
380453;202009;352590;N;8112500;1;2;-1
380577;202009;352590;I;5620101;15;9;6
380579;202009;352590;I;5620101;4;6;-2
380580;202009;352590;I;5620101;6;3;3
380581;202009;352590;I;5620101;1;0;1
380770;202009;352590;G;4744003;0;1;-1
380881;202009;352590;G;4742300;0;1;-1
381485;202009;352590;S;9529105;0;2;-2
381627;202009;352590;C;3314708;0;1;-1
382197;202009;352590;S;9521500;0;1;-1
382597;202009;352590;G;4646001;1;0;1
382799;202009;352590;H;5211701;3;3;0
382827;202009;352590;P;8511200;0;1;-1
383646;202009;352590;F;4330404;1;1;0
383788;202009;352590;H;4930202;1;1;0
383927;202009;352590;G;4754701;1;0;1
384129;202009;352590;N;8220200;34;119;-85
384372;202009;352590;N;8299799;1;1;0
384409;202009;352590;G;4781400;0;1;-1
384535;202009;352590;G;4723700;1;0;1
384622;202009;352590;J;6209100;6;3;3
385310;202009;352590;G;4783101;2;1;1
385557;202009;352590;I;5611201;1;0;1
385690;202009;352590;G;4774100;1;0;1
386377;202009;352590;G;4772500;3;1;2
386638;202009;352590;H;4930202;0;1;-1
386685;202009;352590;G;4751201;1;0;1
386700;202009;352590;G;4633801;1;3;-2
387211;202009;352590;I;5611203;1;0;1
387407;202009;352590;F;4120400;2;0;2
387658;202009;352590;Q;8630502;1;1;0
387750;202009;352590;F;4221904;27;9;18
387876;202009;352590;G;4771701;1;0;1
387919;202009;352590;P;8513900;0;1;-1
388808;202009;352590;I;5611203;1;2;-1
388986;202009;352590;G;4530703;1;1;0
389398;202009;352590;M;6920601;0;6;-6
389867;202009;352590;N;8299799;15;3;12
389947;202009;352590;N;8111700;5;3;2
390218;202009;352590;G;4633801;0;10;-10
390306;202009;352590;H;4930202;3;2;1
390561;202009;352590;G;4530703;2;3;-1
391017;202009;352590;L;6810202;0;1;-1
391160;202009;352590;G;4774100;1;0;1
391492;202009;352590;G;4711302;2;2;0
392299;202009;352590;P;8599604;1;4;-3
392470;202009;352590;R;9313100;1;0;1
392900;202009;352590;S;9601701;1;0;1
393333;202009;352590;G;4639701;4;3;1
393738;202009;352590;N;8111700;4;3;1
394068;202009;352590;F;4330499;2;1;1
394316;202009;352590;C;1095300;42;9;33
395344;202009;352590;G;4753900;1;6;-5
395523;202009;352590;C;3321000;1;0;1
395524;202009;352590;G;4530703;0;1;-1
397001;202009;352590;G;4771701;1;0;1
397412;202009;352590;H;4930201;0;2;-2
398021;202009;352590;C;2943300;2;0;2
398299;202009;352590;J;6209100;1;1;0
398850;202009;352590;I;5611201;2;1;1
399190;202009;352590;Q;8630502;0;1;-1
399240;202009;352590;G;4754701;3;0;3
399285;202009;352590;F;4312600;3;1;2
399675;202009;352590;I;5611203;2;0;2
399678;202009;352590;I;5611203;0;1;-1
399680;202009;352590;I;5611203;3;1;2
401170;202009;352590;C;3314707;0;1;-1
401242;202009;352590;G;4781400;2;0;2
401507;202009;352590;J;6204000;0;1;-1
402363;202009;352590;L;6821802;1;0;1
402714;202009;352590;G;4789002;1;1;0
403381;202009;352590;Q;8711502;2;0;2
403508;202009;352590;G;4530703;1;0;1
403721;202009;352590;G;4781400;0;1;-1
404442;202009;352590;I;5611201;0;1;-1
404964;202009;352590;G;4530705;1;0;1
405651;202009;352590;I;5611203;0;1;-1
405912;202009;352590;F;4292801;2;0;2
406090;202009;352590;C;2943300;3;1;2
406124;202009;352590;G;4724500;0;1;-1
406558;202009;352590;R;9313100;2;0;2
407194;202009;352590;M;6920601;0;1;-1
407258;202009;352590;S;9602502;0;1;-1
407698;202009;352590;C;2610800;1;0;1
407864;202009;352590;N;8211300;1;1;0
408008;202009;352590;P;8599603;0;4;-4
408082;202009;352590;Q;8630501;1;0;1
408130;202009;352590;G;4633801;0;1;-1
408828;202009;352590;I;5611201;0;1;-1
409052;202009;352590;C;1412601;0;1;-1
409077;202009;352590;P;8593700;0;1;-1
410099;202009;352590;F;4299599;2;0;2
410289;202009;352590;S;9601701;1;0;1
410392;202009;352590;G;4772500;0;1;-1
410979;202009;352590;H;5212500;9;11;-2
411035;202009;352590;I;5611201;0;1;-1
411897;202009;352590;C;2542000;0;2;-2
412000;202009;352590;I;5620104;0;1;-1
412381;202009;352590;G;4781400;1;0;1
413358;202009;352590;F;4120400;5;0;5
413399;202009;352590;G;4646001;1;1;0
413641;202009;352590;G;4773300;1;0;1
413776;202009;352590;G;4724500;0;1;-1
414386;202009;352590;C;1069400;8;2;6
414662;202009;352590;G;4541205;0;1;-1
414823;202009;352590;G;4530703;1;0;1
414862;202009;352590;F;4221902;2;1;1
415171;202009;352590;G;4744005;0;1;-1
415754;202009;352590;I;5611201;0;1;-1
415815;202009;352590;G;4789099;1;0;1
416020;202009;352590;Q;8630503;0;1;-1
416623;202009;352590;G;4789099;1;0;1
416784;202009;352590;S;9529102;0;1;-1
416856;202009;352590;H;5250804;3;2;1
417111;202009;352590;G;4774100;1;0;1
417112;202009;352590;G;4774100;1;0;1
417731;202009;352590;H;4930202;0;1;-1
417801;202009;352590;I;5611201;0;2;-2
417810;202009;352590;H;5223100;1;0;1
418080;202009;352590;S;9602501;0;1;-1
418187;202009;352590;G;4724500;0;1;-1
418808;202009;352590;G;4713002;1;1;0
418844;202009;352590;G;4721103;0;1;-1
419260;202009;352590;G;4781400;0;1;-1
419323;202009;352590;R;9313100;1;1;0
420190;202009;352590;I;5611203;3;0;3
420265;202009;352590;G;4520006;1;1;0
420418;202009;352590;N;8111700;2;0;2
420682;202009;352590;G;4721102;1;1;0
420801;202009;352590;I;5611203;0;1;-1
421002;202009;352590;H;4930201;0;1;-1
421948;202009;352590;N;8219999;0;1;-1
421996;202009;352590;M;7319003;0;2;-2
422045;202009;352590;G;4722901;4;0;4
422460;202009;352590;F;4330404;4;0;4
422671;202009;352590;G;4686902;1;0;1
422943;202009;352590;C;3314713;0;2;-2
423189;202009;352590;A;121101;0;2;-2
423190;202009;352590;G;4712100;0;1;-1
423200;202009;352590;H;4930202;0;1;-1
423526;202009;352590;S;9511800;1;0;1
423710;202009;352590;C;2071100;1;0;1
424034;202009;352590;M;6920601;1;1;0
424602;202009;352590;F;4330403;2;1;1
424603;202009;352590;F;4292801;2;0;2
424943;202009;352590;H;4930202;1;0;1
425283;202009;352590;G;4729699;0;1;-1
425538;202009;352590;I;5611201;1;1;0
425604;202009;352590;M;7500100;0;1;-1
426087;202009;352590;I;5612100;0;1;-1
426173;202009;352590;I;5611203;1;0;1
426320;202009;352590;N;8211300;1;1;0
426476;202009;352590;R;9321200;2;0;2
426954;202009;352590;G;4781400;1;0;1
427272;202009;352590;N;8211300;2;0;2
427537;202009;352590;H;4930202;4;1;3
427719;202009;352590;K;6462000;0;3;-3
428192;202009;352590;G;4789004;0;1;-1
428287;202009;352590;Q;8630504;1;0;1
429570;202009;352590;M;7112000;0;1;-1
429856;202009;352590;R;9313100;0;1;-1
430322;202009;352590;I;5611203;0;1;-1
430731;202009;352590;F;4330404;11;6;5
430911;202009;352590;G;4722901;1;0;1
431121;202009;352590;P;8593700;0;3;-3
431566;202009;352590;G;4687702;2;5;-3
431608;202009;352590;N;8111700;2;0;2
431616;202009;352590;G;4772500;1;0;1
431646;202009;352590;G;4713001;0;1;-1
432000;202009;352590;I;5611201;2;1;1
432123;202009;352590;G;4520003;2;0;2
433047;202009;352590;G;4729602;1;0;1
433220;202009;352590;Q;8640202;0;1;-1
433230;202009;352590;G;4711302;3;2;1
433335;202009;352590;N;8211300;1;0;1
433462;202009;352590;C;2539001;2;0;2
433520;202009;352590;G;4721102;0;1;-1
433645;202009;352590;I;5611201;1;0;1
433649;202009;352590;G;4781400;2;0;2
434319;202009;352590;N;8121400;1;0;1
434932;202009;352590;F;4120400;9;0;9
435659;202009;352590;G;4729699;0;1;-1
435941;202009;352590;I;5620103;0;1;-1
436158;202009;352590;F;4120400;1;1;0
436434;202009;352590;G;4713002;1;0;1
436485;202009;352590;I;5611203;0;1;-1
438452;202009;352590;M;7112000;0;2;-2
438696;202009;352590;G;4633801;0;1;-1
439568;202009;352590;H;4930201;1;1;0
439598;202009;352590;K;6622300;0;1;-1
439790;202009;352590;S;9602502;1;0;1
440712;202009;352590;G;4754701;1;0;1
441113;202009;352590;Q;8640202;3;1;2
441114;202009;352590;Q;8640202;1;0;1
441172;202009;352590;Q;8630504;3;1;2
441787;202009;352590;G;4722901;0;1;-1
442181;202009;352590;Q;8711502;4;0;4
443019;202009;352590;G;4789099;4;1;3
443373;202009;352590;I;5620104;0;1;-1
443389;202009;352590;N;8111700;2;5;-3
443481;202009;352590;I;5620104;0;1;-1
443576;202009;352590;G;4541203;1;0;1
443612;202009;352590;H;5223100;0;1;-1
444558;202009;352590;I;5620101;2;1;1
444651;202009;352590;F;4120400;7;4;3
444820;202009;352590;G;4789099;1;0;1
445275;202009;352590;G;4729699;1;0;1
445818;202009;352590;P;8512100;1;1;0
445951;202009;352590;F;4322302;0;1;-1
445957;202009;352590;H;4930202;1;0;1
446000;202009;352590;H;5212500;14;9;5
446293;202009;352590;C;1053800;1;10;-9
446481;202009;352590;G;4752100;0;1;-1
446542;202009;352590;I;5611201;1;1;0
446558;202009;352590;I;5611201;0;1;-1
447383;202009;352590;I;5611203;3;0;3
447453;202009;352590;F;4391600;0;1;-1
447661;202009;352590;J;6209100;1;0;1
448099;202009;352590;R;9313100;2;0;2
448358;202009;352590;M;7112000;7;0;7
448401;202009;352590;I;5611203;0;1;-1
448736;202009;352590;G;4712100;1;0;1
449113;202009;352590;S;9603304;2;1;1
449248;202009;352590;G;4789099;2;0;2
449249;202009;352590;P;8599605;0;1;-1
449996;202009;352590;I;5611203;0;1;-1
450453;202009;352590;P;8593700;1;0;1
450776;202009;352590;G;4772500;1;1;0
450841;202009;352590;I;5611203;0;1;-1
450895;202009;352590;G;4781400;2;1;1
451029;202009;352590;I;5611203;0;1;-1
451575;202009;352590;Q;8650003;1;0;1
452246;202009;352590;M;7112000;2;0;2
452464;202009;352590;G;4781400;1;0;1
453069;202009;352590;G;4781400;1;0;1
453530;202009;352590;J;6209100;0;1;-1
453534;202009;352590;G;4781400;0;1;-1
453540;202009;352590;G;4781400;0;1;-1
454278;202009;352590;H;5112901;1;0;1
455417;202009;352590;F;4330401;0;1;-1
455704;202009;352590;N;8291100;8;4;4
456089;202009;352590;I;5612100;1;0;1
456485;202009;352590;F;4120400;2;0;2
456520;202009;352590;G;4781400;0;4;-4
456586;202009;352590;G;4789099;1;0;1
456643;202009;352590;C;2521700;0;1;-1
457316;202009;352590;I;5611201;0;1;-1
457739;202009;352590;G;4744099;1;1;0
457761;202009;352590;G;4511101;3;1;2
458022;202009;352590;I;5611201;0;2;-2
458221;202009;352590;G;4520003;1;0;1
458841;202009;352590;N;8299799;0;1;-1
459416;202009;352590;F;4321500;7;0;7
459481;202009;352590;I;5611203;1;1;0
459675;202009;352590;G;4723700;0;1;-1
459908;202009;352590;M;7112000;0;1;-1
460373;202009;352590;G;4530703;0;1;-1
460544;202009;352590;Q;8630502;1;0;1
461624;202009;352590;S;9601703;24;13;11
461744;202009;352590;S;9491000;0;1;-1
462045;202009;352590;P;8599601;1;0;1
462197;202009;352590;C;3314799;1;0;1
462207;202009;352590;G;4722902;2;1;1
463238;202009;352590;N;8111700;4;0;4
463420;202009;352590;S;9602501;1;0;1
463563;202009;352590;G;4637104;1;0;1
465349;202009;352590;G;4781400;1;0;1
465760;202009;352590;G;4729699;0;1;-1
466002;202009;352590;I;5611201;1;0;1
466108;202009;352590;M;7112000;2;3;-1
466960;202009;352590;M;7112000;8;0;8
467142;202009;352590;H;4930202;1;0;1
467463;202009;352590;I;5611201;0;1;-1
467500;202009;352590;N;8211300;1;0;1
467566;202009;352590;G;4789002;0;1;-1
467798;202009;352590;G;4711301;10;7;3
467970;202009;352590;L;6821802;1;0;1
468145;202009;352590;F;4321500;1;0;1
468168;202009;352590;Q;8630504;1;0;1
468610;202009;352590;I;5611201;0;2;-2
470040;202009;352590;N;8291100;0;1;-1
470176;202009;352590;G;4789004;0;1;-1
470769;202009;352590;G;4711302;0;2;-2
471105;202009;352590;I;5611201;2;0;2
471376;202009;352590;R;9313100;0;1;-1
472115;202009;352590;E;3811400;0;1;-1
472696;202009;352590;G;4789099;0;1;-1
472707;202009;352590;G;4520005;1;0;1
473394;202009;352590;M;6911701;0;1;-1
473495;202009;352590;G;4781400;6;0;6
473575;202009;352590;G;4781400;3;0;3
474104;202009;352590;Q;8650003;0;1;-1
474739;202009;352590;H;5320202;1;1;0
475296;202009;352590;F;4321500;4;0;4
475698;202009;352590;G;4530702;2;0;2
475721;202009;352590;P;8593700;2;0;2
475726;202009;352590;G;4713002;0;1;-1
476696;202009;352590;J;6201502;1;0;1
477354;202009;352590;H;4930201;1;0;1
477534;202009;352590;G;4772500;0;3;-3
477665;202009;352590;N;7810800;1;0;1
479376;202009;352590;N;7739099;12;8;4
479487;202009;352590;G;4752100;1;1;0
479706;202009;352590;G;4637199;4;1;3
480758;202009;352590;I;5620103;0;1;-1
480759;202009;352590;I;5620103;0;1;-1
481069;202009;352590;S;9602502;5;1;4
481616;202009;352590;P;8599604;0;1;-1
481981;202009;352590;Q;8630503;1;0;1
483432;202009;352590;G;4729699;1;0;1
483956;202009;352590;N;7732201;6;1;5
483979;202009;352590;M;6911701;1;0;1
484419;202009;352590;G;4721104;0;1;-1
484766;202009;352590;C;2222600;5;2;3
484822;202009;352590;M;7319002;3;0;3
485293;202009;352590;H;5229099;0;2;-2
485505;202009;352590;G;4774100;0;1;-1
485623;202009;352590;G;4642701;1;1;0
485789;202009;352590;F;4399199;0;1;-1
485838;202009;352590;G;4722902;1;0;1
485938;202009;352590;H;4930201;1;0;1
486063;202009;352590;H;5223100;1;4;-3
487098;202009;352590;K;6619302;1;0;1
487394;202009;352590;C;1413401;2;1;1
487611;202009;352590;C;3321000;1;0;1
487658;202009;352590;G;4781400;0;1;-1
487960;202009;352590;H;5211701;0;1;-1
488113;202009;352590;J;5819100;1;0;1
488213;202009;352590;M;7112000;2;0;2
488976;202009;352590;G;4789002;0;1;-1
489276;202009;352590;G;4721104;1;1;0
489313;202009;352590;N;8211300;0;2;-2
490102;202009;352590;G;4741500;1;0;1
490625;202009;352590;G;4742300;2;1;1
490665;202009;352590;G;4763602;2;1;1
491179;202009;352590;F;4313400;1;2;-1
491261;202009;352590;M;7319002;3;1;2
492189;202009;352590;G;4712100;0;1;-1
492430;202009;352590;G;4781400;1;0;1
493126;202009;352590;N;8219999;0;1;-1
493292;202009;352590;G;4711302;1;0;1
496138;202009;352590;G;4530703;2;0;2
496359;202009;352590;G;4752100;2;0;2
496489;202009;352590;H;4930202;0;3;-3
496672;202009;352590;G;4774100;2;0;2
496937;202009;352590;N;8211300;0;1;-1
497055;202009;352590;G;4789001;0;1;-1
497241;202009;352590;I;5611201;1;0;1
497244;202009;352590;I;5611201;0;2;-2
497920;202009;352590;I;5611203;0;1;-1
499226;202009;352590;H;4930202;1;3;-2
499813;202009;352590;N;8111700;6;3;3
500194;202009;352590;A;163600;59;34;25
500235;202009;352590;H;4930202;2;4;-2
500639;202009;352590;N;8219999;2;2;0
501953;202009;352590;G;4520006;2;1;1
502524;202009;352590;N;8211300;1;0;1
503108;202009;352590;N;8230001;8;2;6
503187;202009;352590;G;4711302;0;2;-2
504400;202009;352590;I;5611201;0;1;-1
504542;202009;352590;G;4753900;7;1;6
504749;202009;352590;G;4753900;50;40;10
504750;202009;352590;G;4753900;7;2;5
505160;202009;352590;G;4753900;7;4;3
505184;202009;352590;G;4753900;2;1;1
505769;202009;352590;G;4712100;4;1;3
505771;202009;352590;G;4712100;5;1;4
506421;202009;352590;C;1812100;0;8;-8
507275;202009;352590;I;5611201;0;2;-2
507305;202009;352590;H;4930202;11;32;-21
507752;202009;352590;G;4781400;2;2;0
507843;202009;352590;G;4781400;2;1;1
508140;202009;352590;H;4930202;2;0;2
508194;202009;352590;G;4744001;0;1;-1
508458;202009;352590;A;210107;1;0;1
508840;202009;352590;G;4744005;1;1;0
508885;202009;352590;G;4752100;2;1;1
509015;202009;352590;H;4930202;1;1;0
509209;202009;352590;G;4511102;0;1;-1
509680;202009;352590;F;4330404;8;1;7
509725;202009;352590;N;8020001;0;1;-1
509829;202009;352590;I;5611201;2;2;0
510228;202009;352590;G;4530703;0;1;-1
510819;202009;352590;M;7112000;0;1;-1
511381;202009;352590;C;1091102;1;0;1
511559;202009;352590;G;4723700;1;0;1
512096;202009;352590;F;4120400;1;0;1
512168;202009;352590;F;4292801;0;1;-1
512749;202009;352590;C;3321000;5;0;5
513297;202009;352590;C;2812700;0;1;-1
514204;202009;352590;C;2099199;1;0;1
515300;202009;352590;P;8599603;1;0;1
515391;202009;352590;I;5611201;1;0;1
515836;202009;352590;I;5611203;5;0;5
517190;202009;352590;I;5611201;0;1;-1
517247;202009;352590;G;4741500;1;0;1
518267;202009;352590;Q;8630504;2;2;0
518359;202009;352590;J;6204000;0;2;-2
518384;202009;352590;G;4721104;1;0;1
518839;202009;352590;G;4752100;0;1;-1
519332;202009;352590;C;3314710;2;0;2
521287;202009;352590;I;5611201;3;0;3
522740;202009;352590;N;8020001;4;2;2
522829;202009;352590;G;4729699;1;0;1
523254;202009;352590;G;4763602;1;1;0
523449;202009;352590;Q;8640202;0;1;-1
523577;202009;352590;N;8291100;1;0;1
525449;202009;352590;H;5229099;15;7;8
526817;202009;352590;H;5211702;0;1;-1
526958;202009;352590;F;4222701;2;0;2
527543;202009;352590;F;4120400;3;0;3
528181;202009;352590;I;5620103;0;5;-5
528458;202009;352590;G;4669999;6;6;0
528460;202009;352590;G;4669999;1;5;-4
528532;202009;352590;G;4729602;1;0;1
528653;202009;352590;I;5620104;0;1;-1
528977;202009;352590;M;7112000;4;2;2
529074;202009;352590;S;9602502;1;0;1
529882;202009;352590;H;4930202;1;0;1
529932;202009;352590;I;5611203;0;1;-1
529944;202009;352590;F;4321500;0;2;-2
530840;202009;352590;C;2599302;6;2;4
531016;202009;352590;G;4772500;2;1;1
531017;202009;352590;G;4772500;3;0;3
531622;202009;352590;I;5620104;0;1;-1
532275;202009;352590;G;4782201;1;0;1
532349;202009;352590;G;4771701;0;2;-2
532602;202009;352590;I;5620104;0;1;-1
533755;202009;352590;I;5620101;1;4;-3
534416;202009;352590;N;8230001;35;5;30
534454;202009;352590;G;4520007;1;0;1
534720;202009;352590;N;8211300;1;0;1
535153;202009;352590;G;4782201;2;1;1
535250;202009;352590;G;4713002;2;0;2
535482;202009;352590;C;3314799;1;0;1
535537;202009;352590;G;4781400;1;0;1
535829;202009;352590;I;5611203;2;0;2
536596;202009;352590;I;5611201;3;4;-1
537082;202009;352590;I;5611201;0;1;-1
538469;202009;352590;N;8211300;2;3;-1
538548;202009;352590;R;9319199;1;2;-1
538944;202009;352590;N;8299799;1;0;1
539787;202009;352590;C;2014200;0;1;-1
539836;202009;352590;I;5620104;1;0;1
540275;202009;352590;G;4744099;1;0;1
541068;202009;352590;F;4329101;1;0;1
541103;202009;352590;H;5320201;0;3;-3
541218;202009;352590;I;5611201;1;0;1
542897;202009;352590;F;4330404;0;1;-1
543230;202009;352590;G;4781400;0;1;-1
543568;202009;352590;G;4633801;2;0;2
543727;202009;352590;N;7739002;1;2;-1
544143;202009;352590;Q;8630503;1;0;1
544611;202009;352590;G;4712100;3;0;3
544704;202009;352590;J;6203100;4;1;3
544787;202009;352590;I;5611201;7;2;5
545046;202009;352590;I;5611201;1;0;1
545392;202009;352590;N;8292000;0;1;-1
545518;202009;352590;G;4781400;1;0;1
545635;202009;352590;N;8111700;4;0;4
545639;202009;352590;R;9313100;1;0;1
545654;202009;352590;C;1091102;1;0;1
546500;202009;352590;G;4729699;0;1;-1
547709;202009;352590;N;8121400;2;0;2
547928;202009;352590;G;4723700;1;2;-1
548004;202009;352590;G;4759899;5;0;5
548037;202009;352590;G;4761003;2;0;2
548476;202009;352590;Q;8711502;0;2;-2
550192;202009;352590;F;4399103;1;0;1
550896;202009;352590;H;4930202;2;1;1
551560;202009;352590;M;7319002;9;2;7
552498;202009;352590;G;4754701;0;1;-1
552614;202009;352590;G;4771701;2;0;2
553103;202009;352590;N;8111700;3;3;0
554741;202009;352590;I;5611201;0;2;-2
554813;202009;352590;G;4744001;2;1;1
555843;202009;352590;I;5611203;2;0;2
556066;202009;352590;H;5320201;4;1;3
556107;202009;352590;G;4789099;3;0;3
556470;202009;352590;G;4789001;4;1;3
556912;202009;352590;I;5611203;1;0;1
556988;202009;352590;P;8599604;1;0;1
557475;202009;352590;H;4930202;2;0;2
557495;202009;352590;G;4729699;1;0;1
557726;202009;352590;P;8599604;2;0;2
559563;202009;352590;H;4930202;1;0;1
560334;202009;352590;F;4330402;3;0;3
561049;202009;352590;Q;8630506;1;0;1
561298;202009;352590;H;4923002;0;1;-1
561460;202009;352590;S;9602502;1;0;1
561660;202009;352590;C;2539001;1;0;1
561804;202009;352590;G;4520002;2;0;2
562296;202009;352590;P;8599604;3;1;2
562316;202009;352590;P;8532500;0;1;-1
562617;202009;352590;I;5611201;5;1;4
564141;202009;352590;J;6120501;0;1;-1
564175;202009;352590;J;6120501;0;2;-2
564219;202009;352590;J;6141800;0;7;-7
567066;202009;352590;I;5611203;3;3;0
567153;202009;352590;C;1062700;1;3;-2
567745;202009;352590;C;1813099;1;1;0
567842;202009;352590;G;4711302;1;0;1
567943;202009;352590;H;5222200;0;2;-2
568111;202009;352590;G;4647801;1;2;-1
568248;202009;352590;C;2091600;1;0;1
568756;202009;352590;G;4753900;0;2;-2
568763;202009;352590;G;4753900;0;1;-1
568815;202009;352590;H;4930202;2;2;0
568822;202009;352590;F;4120400;3;7;-4
568987;202009;352590;C;2019399;0;3;-3
569051;202009;352590;C;2599399;7;0;7
569203;202009;352590;C;2710402;9;22;-13
569234;202009;352590;G;4789099;0;2;-2
569323;202009;352590;L;6822600;0;1;-1
569864;202009;352590;Q;8640202;0;1;-1
569865;202009;352590;G;4744005;0;1;-1
569866;202009;352590;C;2592602;4;1;3
569868;202009;352590;S;9430800;1;0;1
569871;202009;352590;K;6550200;11;11;0
569887;202009;352590;K;6550200;1;2;-1
569902;202009;352590;K;6550200;0;1;-1
569938;202009;352590;K;6550200;1;1;0
569967;202009;352590;F;4399105;6;2;4
569968;202009;352590;C;1013901;1;0;1
569969;202009;352590;G;4530703;1;0;1
569970;202009;352590;M;6920601;0;1;-1
569971;202009;352590;S;9521500;2;0;2
569972;202009;352590;C;2342702;1;0;1
570137;202009;352590;C;2013402;5;7;-2
570138;202009;352590;C;2013402;3;0;3
570761;202009;352590;G;4781400;0;3;-3
571244;202009;352590;G;4782201;0;2;-2
571325;202009;352590;G;4711301;9;20;-11
571441;202009;352590;G;4731800;1;1;0
571533;202009;352590;G;4771701;1;0;1
571684;202009;352590;G;4744005;0;1;-1
571753;202009;352590;C;2821601;1;1;0
571765;202009;352590;O;8411600;7;4;3
572244;202009;352590;S;9420100;0;2;-2
572474;202009;352590;C;2063100;11;12;-1
572494;202009;352590;C;2651500;0;7;-7
572554;202009;352590;G;4781400;1;3;-2
572915;202009;352590;G;4744002;0;2;-2
572934;202009;352590;J;6010100;0;2;-2
572935;202009;352590;H;4930202;0;2;-2
572936;202009;352590;G;4639701;8;2;6
572951;202009;352590;G;4754701;0;1;-1
572952;202009;352590;F;4313400;3;13;-10
572953;202009;352590;H;4929902;0;1;-1
572954;202009;352590;G;4731800;1;1;0
573122;202009;352590;N;8111700;3;1;2
573168;202009;352590;C;2342702;1;0;1
573820;202009;352590;G;4711302;0;6;-6
574043;202009;352590;G;4771701;0;1;-1
574223;202009;352590;G;4711302;0;4;-4
574378;202009;352590;I;5510801;2;0;2
574524;202009;352590;Q;8640202;2;1;1
574526;202009;352590;Q;8690999;1;3;-2
574547;202009;352590;Q;8640202;1;2;-1
574728;202009;352590;F;4110700;1;0;1
575078;202009;352590;G;4713001;0;1;-1
575342;202009;352590;G;4713001;1;0;1
576247;202009;352590;H;4929901;0;1;-1
576248;202009;352590;G;4774100;1;0;1
576249;202009;352590;G;4712100;1;1;0
576265;202009;352590;H;4921301;0;14;-14
576509;202009;352590;G;4731800;1;1;0
576714;202009;352590;G;4744099;2;1;1
577066;202009;352590;H;5211799;0;1;-1
577100;202009;352590;G;4731800;0;1;-1
577147;202009;352590;Q;8640205;3;1;2
577155;202009;352590;G;4711302;1;2;-1
577199;202009;352590;C;2229399;7;7;0
577372;202009;352590;G;4784900;1;0;1
577374;202009;352590;I;5611201;0;1;-1
577447;202009;352590;G;4781400;0;1;-1
577472;202009;352590;G;4741500;0;1;-1
577869;202009;352590;I;5620101;0;1;-1
577921;202009;352590;I;5620101;1;2;-1
578010;202009;352590;I;5620101;1;0;1
578015;202009;352590;I;5620101;1;1;0
578043;202009;352590;I;5620101;1;0;1
578155;202009;352590;I;5620101;0;1;-1
578351;202009;352590;G;4772500;0;2;-2
578355;202009;352590;G;4772500;2;1;1
578363;202009;352590;G;4763604;1;0;1
578365;202009;352590;P;8599601;0;1;-1
578366;202009;352590;C;1813099;0;1;-1
578367;202009;352590;M;6920601;1;0;1
578438;202009;352590;P;8599699;8;1;7
578464;202009;352590;G;4755503;1;0;1
578770;202009;352590;C;1330800;22;10;12
578773;202009;352590;F;4313400;0;5;-5
579098;202009;352590;K;6550200;12;0;12
579102;202009;352590;K;6550200;3;0;3
579103;202009;352590;K;6550200;21;6;15
579104;202009;352590;K;6550200;0;1;-1
579291;202009;352590;F;4120400;1;1;0
579316;202009;352590;H;4921301;0;14;-14
579321;202009;352590;C;1122401;0;4;-4
579322;202009;352590;G;4711302;0;3;-3
579323;202009;352590;C;1081302;2;1;1
579325;202009;352590;G;4712100;1;0;1
579326;202009;352590;C;1112700;1;1;0
579328;202009;352590;G;4744099;1;1;0
579330;202009;352590;C;1112700;1;3;-2
579331;202009;352590;G;4530703;0;1;-1
579336;202009;352590;P;8513900;2;3;-1
579341;202009;352590;R;9312300;3;5;-2
579343;202009;352590;G;4721102;0;1;-1
579346;202009;352590;C;2219600;4;12;-8
579348;202009;352590;G;4689399;1;1;0
579349;202009;352590;C;1099601;4;1;3
579350;202009;352590;C;1629301;2;2;0
579352;202009;352590;G;4729699;2;0;2
579354;202009;352590;K;6622300;1;1;0
579355;202009;352590;G;4511104;2;2;0
579356;202009;352590;C;2212900;1;0;1
579358;202009;352590;G;4672900;0;2;-2
579359;202009;352590;H;4929902;2;11;-9
579360;202009;352590;G;4712100;0;1;-1
579361;202009;352590;C;2330399;1;1;0
579362;202009;352590;Q;8610101;64;50;14
579363;202009;352590;G;4753900;0;1;-1
579364;202009;352590;C;1091101;1;1;0
579371;202009;352590;G;4721102;0;1;-1
579373;202009;352590;G;4763603;0;1;-1
579374;202009;352590;R;9312300;1;0;1
579375;202009;352590;C;3101200;2;0;2
579376;202009;352590;C;2229399;0;1;-1
579377;202009;352590;G;4731800;2;0;2
579378;202009;352590;G;4711302;0;1;-1
579379;202009;352590;G;4711302;0;3;-3
579381;202009;352590;G;4711302;0;2;-2
579384;202009;352590;G;4711302;2;3;-1
579386;202009;352590;G;4711302;8;4;4
579388;202009;352590;G;4731800;1;0;1
579389;202009;352590;G;4711302;11;3;8
579390;202009;352590;G;4711302;1;1;0
579391;202009;352590;G;4711302;14;13;1
579392;202009;352590;G;4711302;4;1;3
579394;202009;352590;G;4711302;5;4;1
579396;202009;352590;G;4711302;5;5;0
579399;202009;352590;G;4711302;1;6;-5
579400;202009;352590;G;4711302;7;5;2
579401;202009;352590;G;4711302;13;18;-5
579402;202009;352590;H;4921301;0;12;-12
579403;202009;352590;C;1311100;2;0;2
579404;202009;352590;C;1311100;22;17;5
579405;202009;352590;C;2229301;77;64;13
579406;202009;352590;C;2229301;44;8;36
579407;202009;352590;C;2229301;35;5;30
579408;202009;352590;C;2229301;4;2;2
579409;202009;352590;C;2229301;27;2;25
579410;202009;352590;P;8513900;1;2;-1
579418;202009;352590;S;9420100;0;1;-1
579420;202009;352590;G;4511101;2;3;-1
579427;202009;352590;S;9430800;1;0;1
579428;202009;352590;S;9430800;0;2;-2
579429;202009;352590;C;1813099;1;0;1
579434;202009;352590;Q;8610101;1;1;0
579438;202009;352590;Q;8610101;16;14;2
579439;202009;352590;M;6920601;0;1;-1
579440;202009;352590;C;2342702;1;1;0
579442;202009;352590;G;4721102;0;1;-1
579449;202009;352590;G;4744005;1;0;1
579450;202009;352590;Q;8711502;5;5;0
579453;202009;352590;G;4744099;0;1;-1
579460;202009;352590;H;4930202;1;0;1
579465;202009;352590;G;4711302;3;6;-3
579466;202009;352590;G;4711302;1;5;-4
579467;202009;352590;G;4711302;0;4;-4
579468;202009;352590;G;4711302;1;2;-1
579470;202009;352590;G;4711302;2;4;-2
579472;202009;352590;M;6920601;1;1;0
579473;202009;352590;F;4221902;0;1;-1
579477;202009;352590;S;9420100;0;1;-1
579478;202009;352590;S;9491000;0;2;-2
579481;202009;352590;S;9491000;0;1;-1
579483;202009;352590;S;9491000;0;1;-1
579486;202009;352590;S;9491000;0;1;-1
579492;202009;352590;G;4633801;8;1;7
579496;202009;352590;H;4929902;2;0;2
579505;202009;352590;S;9491000;0;2;-2
579506;202009;352590;G;4771701;0;1;-1
579558;202009;352590;C;1053800;1;0;1
579804;202009;352590;N;8299706;1;0;1
579811;202009;352590;G;4789099;2;0;2
579812;202009;352590;F;4313400;1;0;1
579813;202009;352590;C;1412601;0;1;-1
579828;202009;352590;C;2071100;4;1;3
580084;202009;352590;C;1013901;8;1;7
580339;202009;352590;G;4744099;1;0;1
580455;202009;352590;Q;8640202;1;0;1
580456;202009;352590;Q;8640202;2;0;2
580457;202009;352590;Q;8640201;0;1;-1
580460;202009;352590;Q;8640205;1;0;1
580461;202009;352590;Q;8650004;2;1;1
580462;202009;352590;S;9601701;0;1;-1
580463;202009;352590;Q;8640202;6;2;4
580464;202009;352590;C;1412601;0;1;-1
580465;202009;352590;H;4930202;1;3;-2
580488;202009;352590;Q;8610101;3;4;-1
580520;202009;352590;S;9430800;1;1;0
580521;202009;352590;S;9499500;0;2;-2
580529;202009;352590;G;4647801;0;2;-2
580531;202009;352590;P;8511200;0;2;-2
580760;202009;352590;C;3250707;5;4;1
580839;202009;352590;C;2342702;3;4;-1
580853;202009;352590;G;4661300;9;5;4
580995;202009;352590;N;8112500;1;1;0
580996;202009;352590;P;8512100;1;1;0
581009;202009;352590;G;4744001;1;0;1
581010;202009;352590;P;8592999;0;1;-1
581012;202009;352590;Q;8630502;0;2;-2
581013;202009;352590;N;7820500;3;8;-5
581061;202009;352590;G;4639701;0;1;-1
581102;202009;352590;H;4930202;6;6;0
581121;202009;352590;G;4782201;2;1;1
581122;202009;352590;G;4782201;3;0;3
581264;202009;352590;H;4930202;0;1;-1
581326;202009;352590;G;4771702;10;5;5
581400;202009;352590;G;4755502;0;1;-1
581504;202009;352590;G;4530703;0;3;-3
581648;202009;352590;G;4721102;1;0;1
581675;202009;352590;C;1031700;7;4;3
581937;202009;352590;G;4771701;1;0;1
581944;202009;352590;G;4771701;0;1;-1
582015;202009;352590;G;4789004;3;1;2
582239;202009;352590;G;4669999;2;1;1
582699;202009;352590;G;4771703;0;1;-1
582890;202009;352590;G;4541203;0;1;-1
583332;202009;352590;Q;8640203;1;3;-2
583375;202009;352590;Q;8711501;2;1;1
583378;202009;352590;M;7112000;0;1;-1
583381;202009;352590;K;6622300;0;1;-1
583458;202009;352590;G;4520001;1;1;0
583495;202009;352590;G;4712100;1;0;1
583517;202009;352590;F;4329103;0;1;-1
583633;202009;352590;C;3101200;2;1;1
583916;202009;352590;C;3101200;0;1;-1
584084;202009;352590;G;4633801;0;2;-2
584107;202009;352590;G;4712100;3;1;2
584361;202009;352590;N;8112500;1;0;1
584362;202009;352590;Q;8630504;1;0;1
584421;202009;352590;G;4511101;4;3;1
584505;202009;352590;C;1093702;1;1;0
584743;202009;352590;G;4520001;1;0;1
584876;202009;352590;G;4789007;1;0;1
585174;202009;352590;C;2821602;0;1;-1
585351;202009;352590;G;4712100;1;0;1
585352;202009;352590;G;4712100;0;1;-1
585490;202009;352590;G;4781400;1;0;1
585630;202009;352590;F;4313400;1;0;1
585638;202009;352590;C;2829199;2;0;2
585776;202009;352590;C;2823200;0;1;-1
585859;202009;352590;G;4661300;6;3;3
585942;202009;352590;C;2449199;1;1;0
586144;202009;352590;G;4789099;0;1;-1
586298;202009;352590;G;4789005;0;1;-1
586301;202009;352590;I;5510803;2;2;0
586476;202009;352590;G;4649403;0;1;-1
586608;202009;352590;H;5223100;1;0;1
586669;202009;352590;G;4761003;0;1;-1
586824;202009;352590;G;4753900;6;2;4
586848;202009;352590;G;4753900;1;2;-1
586984;202009;352590;K;6550200;2;2;0
586985;202009;352590;Q;8630502;1;0;1
586986;202009;352590;Q;8610102;3;0;3
586987;202009;352590;Q;8610101;4;4;0
586988;202009;352590;Q;8640210;0;1;-1
587000;202009;352590;G;4673700;0;1;-1
587214;202009;352590;G;4744005;0;3;-3
587218;202009;352590;G;4761003;1;1;0
587585;202009;352590;G;4530703;0;1;-1
587636;202009;352590;C;3314707;1;0;1
587843;202009;352590;B;810007;1;0;1
587885;202009;352590;G;4774100;1;1;0
587939;202009;352590;M;7119701;1;0;1
588160;202009;352590;G;4721103;1;0;1
588217;202009;352590;H;4930202;0;3;-3
588420;202009;352590;C;2099199;3;1;2
588498;202009;352590;C;2539002;3;2;1
588503;202009;352590;C;2592602;0;1;-1
588589;202009;352590;H;4930202;1;0;1
588750;202009;352590;K;6493000;3;2;1
589006;202009;352590;G;4712100;0;2;-2
589152;202009;352590;I;5611201;5;0;5
589153;202009;352590;I;5611201;1;2;-1
589223;202009;352590;C;2229302;4;1;3
589232;202009;352590;I;5611203;0;1;-1
589250;202009;352590;P;8512100;0;2;-2
589263;202009;352590;N;8112500;0;1;-1
589264;202009;352590;N;8121400;1;3;-2
589265;202009;352590;H;5223100;1;2;-1
589266;202009;352590;N;8112500;0;1;-1
589501;202009;352590;G;4763601;0;1;-1
589555;202009;352590;F;4221902;0;3;-3
589601;202009;352590;H;4929902;9;5;4
589627;202009;352590;I;5611201;0;3;-3
589645;202009;352590;G;4721102;0;1;-1
589683;202009;352590;G;4763601;1;2;-1
589928;202009;352590;G;4635402;7;4;3
590031;202009;352590;C;2229399;22;14;8
590058;202009;352590;H;4930202;6;0;6
590101;202009;352590;Q;8640205;1;1;0
590102;202009;352590;N;8112500;0;1;-1
590139;202009;352590;N;7739099;0;1;-1
590140;202009;352590;J;6202300;0;1;-1
590141;202009;352590;P;8512100;2;0;2
590150;202009;352590;Q;8640202;1;0;1
590277;202009;352590;C;2944100;23;1;22
590313;202009;352590;C;1629301;7;1;6
590443;202009;352590;I;5510803;1;0;1
590570;202009;352590;K;6422100;0;1;-1
590706;202009;352590;F;4292802;6;4;2
590784;202009;352590;G;4772500;0;1;-1
590805;202009;352590;H;4930202;2;2;0
590957;202009;352590;E;3839401;0;2;-2
591084;202009;352590;H;4930202;1;0;1
591111;202009;352590;G;4789099;1;0;1
591122;202009;352590;G;4731800;1;0;1
591181;202009;352590;G;4741500;0;1;-1
591190;202009;352590;I;5620104;1;0;1
591280;202009;352590;G;4789004;0;1;-1
591370;202009;352590;G;4731800;0;2;-2
591405;202009;352590;C;1314600;4;2;2
591941;202009;352590;G;4743100;1;1;0
591971;202009;352590;G;4744002;1;0;1
592266;202009;352590;M;7210000;0;3;-3
592279;202009;352590;G;4530701;1;1;0
592299;202009;352590;G;4771701;1;1;0
592401;202009;352590;C;2522500;16;1;15
592634;202009;352590;Q;8610101;9;3;6
592667;202009;352590;C;2014200;1;2;-1
592801;202009;352590;C;2599399;1;0;1
592802;202009;352590;C;2599399;0;1;-1
592807;202009;352590;C;2812700;4;0;4
592856;202009;352590;K;6422100;0;1;-1
592950;202009;352590;K;6422100;0;2;-2
593284;202009;352590;K;6422100;0;1;-1
593361;202009;352590;K;6422100;0;1;-1
593475;202009;352590;K;6422100;0;1;-1
593585;202009;352590;C;2222600;0;1;-1
593624;202009;352590;I;5612100;0;1;-1
593766;202009;352590;Q;8690999;1;1;0
593767;202009;352590;Q;8690999;1;0;1
593852;202009;352590;G;4744005;1;1;0
593901;202009;352590;C;2539000;0;2;-2
593953;202009;352590;B;810099;4;1;3
593954;202009;352590;C;2330302;4;1;3
594038;202009;352590;P;8513900;0;3;-3
594191;202009;352590;G;4633802;1;0;1
594192;202009;352590;G;4633802;0;2;-2
594230;202009;352590;C;1099603;0;1;-1
594441;202009;352590;C;3104700;0;1;-1
594448;202009;352590;P;8513900;0;2;-2
594450;202009;352590;Q;8711502;1;0;1
594499;202009;352590;I;5611201;0;1;-1
594560;202009;352590;Q;8640212;0;1;-1
594565;202009;352590;Q;8640212;0;1;-1
594922;202009;352590;C;2949299;0;1;-1
595250;202009;352590;G;4713004;2;5;-3
595273;202009;352590;G;4646001;0;1;-1
595288;202009;352590;G;4755502;0;1;-1
595436;202009;352590;C;2591800;1;5;-4
595502;202009;352590;G;4635402;5;4;1
595509;202009;352590;C;1122401;28;34;-6
595687;202009;352590;C;1721400;0;1;-1
595739;202009;352590;K;6512000;0;1;-1
595804;202009;352590;G;4711302;3;5;-2
596306;202009;352590;G;4771701;0;1;-1
596370;202009;352590;G;4771701;1;0;1
596666;202009;352590;G;4771701;1;1;0
596688;202009;352590;G;4771701;0;1;-1
596893;202009;352590;C;2949299;2;1;1
596906;202009;352590;C;2869100;1;0;1
596961;202009;352590;G;4645101;1;1;0
597291;202009;352590;N;8211300;4;11;-7
597318;202009;352590;G;4731800;0;1;-1
597409;202009;352590;C;1411801;6;12;-6
597549;202009;352590;G;4771701;1;0;1
597580;202009;352590;G;4771701;1;1;0
597744;202009;352590;G;4771701;1;0;1
597911;202009;352590;G;4771701;1;0;1
598014;202009;352590;G;4771701;1;0;1
598062;202009;352590;G;4771701;0;1;-1
598125;202009;352590;G;4771701;1;0;1
598140;202009;352590;G;4771701;1;0;1
598324;202009;352590;G;4771701;1;0;1
598404;202009;352590;G;4771701;1;0;1
598418;202009;352590;G;4771701;1;0;1
598496;202009;352590;G;4771701;1;1;0
598608;202009;352590;G;4771701;0;1;-1
598722;202009;352590;Q;8800600;0;12;-12
598783;202009;352590;G;4635402;6;2;4
599035;202009;352590;N;8211300;1;0;1
599037;202009;352590;M;6920601;1;0;1
599038;202009;352590;J;6202300;0;1;-1
599042;202009;352590;N;8121400;12;28;-16
599134;202009;352590;G;4743100;0;1;-1
599720;202009;352590;G;4741500;0;1;-1
599950;202009;352590;G;4679603;1;0;1
600141;202009;352590;C;2592601;1;0;1
600263;202009;352590;F;4321500;2;1;1
600296;202009;352590;L;6822600;0;1;-1
600489;202009;352590;I;5611201;0;1;-1
600951;202009;352590;G;4789002;3;0;3
600965;202009;352590;C;2229301;1;1;0
601094;202009;352590;G;4744099;4;2;2
601127;202009;352590;G;4530701;1;1;0
601172;202009;352590;G;4755503;0;1;-1
602101;202009;352590;J;6209100;1;4;-3
602114;202009;352590;Q;8660700;6;8;-2
602184;202009;352590;G;4649408;0;1;-1
602892;202009;352590;F;4120400;0;1;-1
602895;202009;352590;C;3314710;16;6;10
603120;202009;352590;N;8219999;2;0;2
603926;202009;352590;H;4930202;1;1;0
603935;202009;352590;F;4330401;2;1;1
604042;202009;352590;G;4789099;0;1;-1
604270;202009;352590;G;4711302;20;26;-6
604314;202009;352590;C;1099699;0;3;-3
604468;202009;352590;G;4783101;2;0;2
604531;202009;352590;G;4771702;0;1;-1
604990;202009;352590;L;6822600;0;1;-1
605069;202009;352590;N;7739099;3;6;-3
605091;202009;352590;I;5611203;0;1;-1
605092;202009;352590;I;5611203;8;6;2
605183;202009;352590;G;4773300;1;0;1
605687;202009;352590;P;8512100;0;3;-3
605688;202009;352590;N;8111700;9;34;-25
605689;202009;352590;M;6920601;0;1;-1
605709;202009;352590;N;8112500;2;2;0
605710;202009;352590;P;8513900;1;1;0
605711;202009;352590;P;8513900;1;0;1
605714;202009;352590;Q;8630501;1;0;1
605715;202009;352590;N;8121400;1;1;0
605716;202009;352590;N;8112500;1;0;1
605717;202009;352590;Q;8640207;1;2;-1
605794;202009;352590;G;4771701;1;1;0
605798;202009;352590;G;4754701;0;1;-1
605825;202009;352590;C;2731700;0;1;-1
605894;202009;352590;G;4744005;1;0;1
606078;202009;352590;C;2014200;2;4;-2
606110;202009;352590;G;4711302;0;1;-1
606182;202009;352590;F;4120400;9;12;-3
606227;202009;352590;C;2222600;2;2;0
606330;202009;352590;F;4120400;3;2;1
606424;202009;352590;G;4729699;0;1;-1
606549;202009;352590;G;4789099;1;0;1
606799;202009;352590;I;5620101;0;1;-1
606838;202009;352590;I;5620101;2;1;1
606901;202009;352590;I;5620101;0;2;-2
607099;202009;352590;C;1412601;0;2;-2
607116;202009;352590;G;4744005;3;3;0
607151;202009;352590;G;4623199;14;0;14
607368;202009;352590;G;4721102;0;1;-1
608349;202009;352590;J;6203100;0;3;-3
608476;202009;352590;G;4789004;1;0;1
608506;202009;352590;C;2543800;2;0;2
608530;202009;352590;C;2330302;2;1;1
608854;202009;352590;G;4771702;3;3;0
610469;202009;352590;G;4511101;1;2;-1
610613;202009;352590;C;2229301;74;26;48
610829;202009;352590;F;4110700;0;2;-2
610906;202009;352590;N;7739099;4;0;4
610926;202009;352590;C;3314710;0;3;-3
611266;202009;352590;G;4741500;1;1;0
611269;202009;352590;G;4741500;1;0;1
611272;202009;352590;G;4741500;2;0;2
611308;202009;352590;G;4744005;1;0;1
611347;202009;352590;G;4744001;0;1;-1
612252;202009;352590;C;3299099;0;1;-1
612254;202009;352590;C;3299099;1;1;0
612525;202009;352590;C;2822402;0;1;-1
612630;202009;352590;H;5310502;0;2;-2
612636;202009;352590;G;4530703;1;0;1
612728;202009;352590;I;5611201;0;1;-1
612763;202009;352590;G;4789099;0;1;-1
612791;202009;352590;C;2099199;3;0;3
612792;202009;352590;G;4692300;5;3;2
612917;202009;352590;G;4520005;1;1;0
612961;202009;352590;C;1031700;2;0;2
613076;202009;352590;J;5813100;0;1;-1
613604;202009;352590;G;4635402;0;6;-6
614764;202009;352590;H;5310502;1;1;0
615212;202009;352590;G;4789099;1;0;1
615265;202009;352590;C;1330800;1;0;1
615347;202009;352590;G;4744001;1;0;1
615357;202009;352590;J;5829800;0;1;-1
615433;202009;352590;G;4711302;0;1;-1
615464;202009;352590;G;4771701;1;0;1
615549;202009;352590;N;7820500;0;1;-1
616401;202009;352590;G;4711301;24;14;10
616785;202009;352590;I;5620101;0;3;-3
617025;202009;352590;C;2349401;7;2;5
617031;202009;352590;N;8211300;6;5;1
617529;202009;352590;H;4930202;3;6;-3
618587;202009;352590;G;4672900;6;2;4
619246;202009;352590;C;2812700;0;2;-2
621798;202009;352590;H;4930202;1;0;1
621908;202009;352590;G;4781400;1;1;0
622555;202009;352590;G;4530703;2;1;1
623058;202009;352590;G;4711301;1;8;-7
627965;202009;352590;K;6424703;0;1;-1
627967;202009;352590;K;6424703;0;1;-1
628499;202009;352590;H;4930202;3;4;-1
629869;202009;352590;G;4679604;1;2;-1
630352;202009;352590;C;3314710;26;6;20
631337;202009;352590;G;4783101;2;1;1
631354;202009;352590;G;4783101;1;0;1
635018;202009;352590;G;4661300;3;0;3
636104;202009;352590;C;2330399;1;2;-1
636964;202009;352590;H;4930202;23;4;19
637788;202009;352590;G;4751201;1;0;1
638253;202009;352590;C;1733800;11;2;9
638254;202009;352590;C;1733800;7;6;1
639536;202009;352590;K;6422100;0;1;-1
639537;202009;352590;K;6422100;0;1;-1
639580;202009;352590;K;6422100;0;1;-1
639581;202009;352590;K;6422100;0;1;-1
639813;202009;352590;K;6422100;0;1;-1
642459;202009;352590;G;4744001;6;1;5
642953;202009;352590;G;4781400;0;2;-2
645477;202009;352590;I;5620101;0;1;-1
647014;202009;352590;C;1733800;4;2;2
647217;202009;352590;N;8111700;0;1;-1
647521;202009;352590;E;3832700;1;0;1
647522;202009;352590;I;5620101;1;1;0
647567;202009;352590;G;4781400;2;0;2
647705;202009;352590;I;5611201;3;2;1
647716;202009;352590;C;2829199;1;1;0
647756;202009;352590;C;2599399;0;1;-1
647779;202009;352590;G;4642702;1;1;0
648350;202009;352590;N;8299799;1;0;1
648678;202009;352590;F;4330401;2;4;-2
648971;202009;352590;G;4752100;1;0;1
649249;202009;352590;C;2813500;14;8;6
649250;202009;352590;C;2349401;32;7;25
666188;202009;352590;M;6912500;2;0;2
74;202102;352590;K;6422100;0;1;-1
965;202102;352590;G;4751201;1;1;0
1047;202102;352590;F;4329103;1;0;1
1848;202102;352590;Q;8640202;1;0;1
3293;202102;352590;C;2599399;3;11;-8
3365;202102;352590;G;4633801;1;0;1
3532;202102;352590;G;4744005;0;1;-1
4144;202102;352590;C;2812700;1;2;-1
4178;202102;352590;H;4930203;14;2;12
4253;202102;352590;C;1091101;2;1;1
4256;202102;352590;G;4744005;1;0;1
4315;202102;352590;I;5510803;1;0;1
4684;202102;352590;C;2222600;1;0;1
4707;202102;352590;C;1629301;1;0;1
4821;202102;352590;C;2949299;3;8;-5
4971;202102;352590;G;4672900;1;0;1
5897;202102;352590;C;2040100;5;9;-4
6040;202102;352590;N;7739099;2;0;2
6108;202102;352590;H;4924800;10;1;9
6140;202102;352590;N;7810800;8;62;-54
6340;202102;352590;K;6622300;1;0;1
7044;202102;352590;G;4789099;0;1;-1
7045;202102;352590;C;2512800;0;1;-1
7352;202102;352590;J;6201501;0;1;-1
7765;202102;352590;G;4732600;1;0;1
7933;202102;352590;G;4757100;0;1;-1
8149;202102;352590;G;4753900;4;6;-2
8207;202102;352590;G;4753900;1;0;1
8762;202102;352590;C;2229303;1;1;0
9331;202102;352590;C;2710402;0;3;-3
9711;202102;352590;G;4789099;0;1;-1
9841;202102;352590;Q;8711502;0;1;-1
9941;202102;352590;G;4744002;0;1;-1
10088;202102;352590;C;3101200;0;1;-1
10165;202102;352590;P;8599601;1;1;0
10402;202102;352590;J;5829800;0;1;-1
10508;202102;352590;G;4672900;0;1;-1
11808;202102;352590;G;4789099;0;1;-1
12544;202102;352590;S;9529199;0;2;-2
12927;202102;352590;L;6810202;0;1;-1
13403;202102;352590;H;5211701;9;4;5
13746;202102;352590;G;4721102;0;1;-1
14009;202102;352590;G;4772500;0;1;-1
14359;202102;352590;I;5611203;2;2;0
14463;202102;352590;Q;8610101;7;1;6
14848;202102;352590;G;4633801;1;1;0
15098;202102;352590;C;1610201;1;1;0
15162;202102;352590;C;2342702;4;1;3
15441;202102;352590;G;4763604;1;0;1
15797;202102;352590;J;6203100;2;1;1
15923;202102;352590;G;4771702;0;1;-1
15927;202102;352590;H;4929902;9;4;5
16129;202102;352590;S;9601703;9;4;5
16133;202102;352590;S;9601703;85;27;58
16458;202102;352590;C;1413401;7;0;7
16630;202102;352590;G;4530705;2;0;2
16986;202102;352590;C;2341900;1;2;-1
17439;202102;352590;G;4789099;1;0;1
17609;202102;352590;N;8112500;0;2;-2
17610;202102;352590;N;8112500;0;1;-1
17825;202102;352590;M;6920601;1;0;1
18013;202102;352590;I;5611201;0;1;-1
18332;202102;352590;G;4789099;0;3;-3
18794;202102;352590;P;8512100;3;0;3
19765;202102;352590;S;9601701;4;0;4
19998;202102;352590;M;6920601;0;1;-1
20823;202102;352590;C;2229303;0;1;-1
21200;202102;352590;C;2731700;2;2;0
21330;202102;352590;G;4711301;11;9;2
21396;202102;352590;G;4511101;5;8;-3
22040;202102;352590;S;9420100;4;0;4
22093;202102;352590;G;4742300;2;1;1
22094;202102;352590;K;6622300;1;0;1
22175;202102;352590;G;4644301;35;34;1
22211;202102;352590;I;5620101;2;1;1
22268;202102;352590;M;7112000;0;3;-3
22936;202102;352590;H;5250804;1;1;0
23057;202102;352590;P;8512100;0;1;-1
23128;202102;352590;G;4771701;1;0;1
23178;202102;352590;N;8292000;0;2;-2
23270;202102;352590;I;5611201;3;1;2
23864;202102;352590;N;8299701;123;25;98
24048;202102;352590;S;9430800;3;2;1
24704;202102;352590;G;4763602;0;1;-1
25089;202102;352590;I;5611203;0;1;-1
25372;202102;352590;G;4721102;3;1;2
25911;202102;352590;C;2229302;3;5;-2
25978;202102;352590;G;4781400;0;1;-1
26159;202102;352590;G;4689399;2;2;0
26944;202102;352590;C;2822402;0;1;-1
26983;202102;352590;G;4652400;7;3;4
27399;202102;352590;C;3102100;12;5;7
27912;202102;352590;H;4930203;2;16;-14
28066;202102;352590;G;4772500;1;1;0
28242;202102;352590;G;4689301;2;0;2
28261;202102;352590;N;8112500;0;1;-1
28262;202102;352590;M;6920601;3;3;0
28263;202102;352590;Q;8640299;2;2;0
28274;202102;352590;F;4329104;1;5;-4
28401;202102;352590;Q;8630504;1;0;1
28635;202102;352590;G;4751201;2;0;2
29110;202102;352590;C;2222600;1;2;-1
29245;202102;352590;G;4530703;1;1;0
29334;202102;352590;L;6810202;0;1;-1
29747;202102;352590;C;2542000;2;0;2
30636;202102;352590;G;4744001;0;1;-1
30708;202102;352590;F;4399199;1;1;0
31025;202102;352590;H;4930202;4;2;2
31164;202102;352590;G;4639701;3;2;1
31244;202102;352590;C;1062700;0;1;-1
31305;202102;352590;M;7120100;1;1;0
31307;202102;352590;P;8593700;0;1;-1
31308;202102;352590;M;6920601;1;2;-1
31800;202102;352590;G;4781400;0;1;-1
31808;202102;352590;G;4789099;0;1;-1
32079;202102;352590;C;1081302;5;2;3
32631;202102;352590;M;7112000;0;1;-1
32677;202102;352590;M;6920601;2;1;1
32719;202102;352590;C;2539001;0;1;-1
32824;202102;352590;G;4712100;0;1;-1
33685;202102;352590;C;3101200;2;0;2
33766;202102;352590;G;4789099;4;0;4
34155;202102;352590;G;4530703;0;1;-1
34196;202102;352590;G;4687703;3;0;3
34741;202102;352590;P;8512100;2;0;2
34829;202102;352590;N;8211300;19;15;4
34830;202102;352590;G;4634601;1;5;-4
35182;202102;352590;G;4752100;1;1;0
35679;202102;352590;G;4712100;1;1;0
35776;202102;352590;G;4751201;0;1;-1
35821;202102;352590;C;2222600;2;1;1
36085;202102;352590;G;4763603;1;0;1
36817;202102;352590;I;5611201;2;1;1
37372;202102;352590;G;4530701;2;2;0
37691;202102;352590;I;5611201;2;0;2
37910;202102;352590;C;2949299;1;0;1
38446;202102;352590;G;4712100;1;1;0
38826;202102;352590;G;4530702;0;3;-3
38977;202102;352590;C;2539001;0;1;-1
39028;202102;352590;G;4772500;0;1;-1
39133;202102;352590;N;8112500;0;2;-2
39178;202102;352590;C;2592602;0;1;-1
39334;202102;352590;C;2599399;0;1;-1
39337;202102;352590;G;4759899;1;0;1
39685;202102;352590;C;2640000;0;1;-1
39780;202102;352590;C;1610202;1;0;1
39932;202102;352590;G;4763601;0;1;-1
40009;202102;352590;J;6209100;1;0;1
40673;202102;352590;H;4930202;0;2;-2
40790;202102;352590;C;2099199;1;0;1
42514;202102;352590;P;8512100;0;1;-1
42700;202102;352590;I;5611201;1;0;1
42728;202102;352590;N;8211300;10;7;3
42749;202102;352590;C;2539001;1;2;-1
42928;202102;352590;S;9430800;2;0;2
43309;202102;352590;C;2511000;2;2;0
43383;202102;352590;R;9312300;0;1;-1
43908;202102;352590;P;8511200;0;1;-1
43909;202102;352590;P;8512100;1;0;1
43924;202102;352590;C;2869100;1;1;0
44518;202102;352590;G;4763602;1;3;-2
44763;202102;352590;N;8230001;0;1;-1
44993;202102;352590;C;1081302;4;3;1
45272;202102;352590;N;8011101;14;4;10
45671;202102;352590;N;7820500;27;9;18
46108;202102;352590;G;4731800;1;1;0
46280;202102;352590;C;1749400;0;1;-1
46595;202102;352590;G;4754701;1;1;0
46791;202102;352590;G;4781400;0;1;-1
47301;202102;352590;G;4781400;0;1;-1
47303;202102;352590;C;1340501;1;0;1
47451;202102;352590;F;4120400;0;3;-3
47497;202102;352590;G;4541204;2;0;2
47523;202102;352590;M;6920601;1;1;0
47538;202102;352590;G;4511101;1;4;-3
47583;202102;352590;H;5221400;39;32;7
47711;202102;352590;C;2941700;6;10;-4
47720;202102;352590;R;9313100;0;1;-1
47800;202102;352590;I;5510801;3;1;2
47988;202102;352590;G;4614100;0;1;-1
48540;202102;352590;G;4731800;1;2;-1
48648;202102;352590;H;4930203;1;2;-1
48757;202102;352590;G;4754701;1;0;1
48758;202102;352590;G;4754701;0;3;-3
48773;202102;352590;G;4619200;0;1;-1
49227;202102;352590;C;2751100;12;0;12
49662;202102;352590;C;2229302;4;4;0
49816;202102;352590;I;5611203;1;0;1
49895;202102;352590;J;6120501;1;1;0
50027;202102;352590;J;6110801;0;2;-2
50292;202102;352590;F;4120400;0;1;-1
50874;202102;352590;C;1099604;1;1;0
51647;202102;352590;P;8532500;1;1;0
51777;202102;352590;G;4731800;1;0;1
51805;202102;352590;H;4930202;1;3;-2
51873;202102;352590;S;9430800;3;1;2
52113;202102;352590;P;8513900;4;1;3
52375;202102;352590;G;4541205;1;1;0
53401;202102;352590;G;4712100;1;0;1
53773;202102;352590;I;5611203;2;1;1
53843;202102;352590;G;4511101;1;0;1
53864;202102;352590;Q;8640205;0;1;-1
54964;202102;352590;C;2091600;21;1;20
54965;202102;352590;G;4684299;1;0;1
55012;202102;352590;G;4520001;0;1;-1
55135;202102;352590;G;4530705;0;1;-1
55150;202102;352590;P;8512100;2;0;2
55461;202102;352590;F;4211101;1;0;1
55785;202102;352590;G;4781400;0;2;-2
55882;202102;352590;H;4930202;2;8;-6
55907;202102;352590;Q;8800600;1;0;1
56245;202102;352590;C;2391503;1;0;1
56382;202102;352590;H;5211799;10;14;-4
56515;202102;352590;C;3101200;1;0;1
56582;202102;352590;G;4731800;0;1;-1
56616;202102;352590;N;8211300;6;5;1
57268;202102;352590;Q;8630503;1;0;1
57723;202102;352590;M;6920601;0;1;-1
58023;202102;352590;I;5620103;2;1;1
58083;202102;352590;H;4930202;23;8;15
58414;202102;352590;C;1013901;21;9;12
58473;202102;352590;G;4722901;3;0;3
58533;202102;352590;G;4784900;1;0;1
59013;202102;352590;C;2814301;0;2;-2
59057;202102;352590;G;4754701;0;1;-1
59239;202102;352590;H;5223100;1;0;1
59318;202102;352590;P;8599602;1;3;-2
59595;202102;352590;G;4781400;0;1;-1
60244;202102;352590;G;4754702;0;1;-1
60245;202102;352590;G;4754702;0;1;-1
60362;202102;352590;C;2539001;1;0;1
60843;202102;352590;G;4755503;0;2;-2
60965;202102;352590;G;4679601;0;2;-2
61570;202102;352590;H;4930202;0;1;-1
62130;202102;352590;H;4930202;17;15;2
62423;202102;352590;G;4789001;1;0;1
62427;202102;352590;G;4789001;1;0;1
62551;202102;352590;M;7119701;0;3;-3
62556;202102;352590;G;4789099;1;0;1
62668;202102;352590;N;8121400;35;22;13
62755;202102;352590;S;9493600;1;0;1
62760;202102;352590;N;8291100;0;1;-1
63012;202102;352590;G;4771702;0;2;-2
63060;202102;352590;C;2222600;10;12;-2
63180;202102;352590;G;4731800;0;2;-2
63386;202102;352590;M;7112000;0;1;-1
63641;202102;352590;G;4752100;1;0;1
63642;202102;352590;G;4752100;0;2;-2
63643;202102;352590;G;4752100;0;2;-2
63692;202102;352590;I;5611201;1;0;1
64307;202102;352590;C;2539001;1;2;-1
64663;202102;352590;G;4639701;1;0;1
64772;202102;352590;K;6622300;1;0;1
65415;202102;352590;F;4330499;3;4;-1
65829;202102;352590;G;4789099;1;0;1
66583;202102;352590;I;5612100;0;1;-1
66899;202102;352590;P;8512100;0;1;-1
67170;202102;352590;G;4646001;1;3;-2
67282;202102;352590;G;4789004;0;1;-1
67351;202102;352590;K;6491300;0;1;-1
67771;202102;352590;G;4789004;1;0;1
67813;202102;352590;I;5620101;0;1;-1
67817;202102;352590;I;5620101;0;1;-1
67840;202102;352590;Q;8720401;6;3;3
67933;202102;352590;S;9491000;0;1;-1
68030;202102;352590;G;4772500;0;2;-2
69550;202102;352590;I;5611201;1;0;1
69566;202102;352590;G;4759899;1;1;0
70868;202102;352590;K;6622300;1;0;1
71111;202102;352590;G;4744099;3;1;2
71143;202102;352590;G;4771702;1;0;1
71166;202102;352590;G;4781400;1;3;-2
72035;202102;352590;G;4723700;0;1;-1
72156;202102;352590;G;4711302;1;0;1
72314;202102;352590;G;4711302;0;1;-1
72918;202102;352590;F;4391600;3;2;1
73935;202102;352590;G;4520005;3;1;2
74161;202102;352590;C;2539002;0;1;-1
74319;202102;352590;H;4930202;1;1;0
75112;202102;352590;E;3600601;1;0;1
75135;202102;352590;M;7119701;0;1;-1
75139;202102;352590;I;5611203;6;2;4
75527;202102;352590;C;1093702;75;13;62
75965;202102;352590;N;7820500;263;343;-80
76053;202102;352590;F;4120400;3;2;1
77565;202102;352590;Q;8800600;1;1;0
77753;202102;352590;J;6209100;1;1;0
78139;202102;352590;C;3292202;1;1;0
78233;202102;352590;H;4930202;1;0;1
78375;202102;352590;C;3314703;0;1;-1
78743;202102;352590;C;2829199;0;1;-1
78938;202102;352590;H;4930202;0;1;-1
78960;202102;352590;N;7820500;1;1;0
78996;202102;352590;N;7820500;319;307;12
79328;202102;352590;P;8599601;1;0;1
80074;202102;352590;G;4754701;0;2;-2
80308;202102;352590;P;8599699;1;1;0
80713;202102;352590;P;8599699;1;1;0
80759;202102;352590;P;8599699;2;0;2
80760;202102;352590;P;8599699;3;0;3
80903;202102;352590;G;4613300;1;0;1
81988;202102;352590;M;6920601;1;0;1
82009;202102;352590;Q;8630501;1;0;1
82244;202102;352590;N;8129000;92;41;51
82326;202102;352590;G;4744005;1;3;-2
82382;202102;352590;C;2222600;3;7;-4
82404;202102;352590;C;2439300;0;1;-1
82872;202102;352590;G;4721104;0;1;-1
83210;202102;352590;G;4789099;1;0;1
83248;202102;352590;H;4930202;3;25;-22
83249;202102;352590;H;4930202;5;19;-14
83393;202102;352590;G;4731800;2;0;2
83558;202102;352590;H;5120000;3;2;1
83561;202102;352590;H;5120000;0;1;-1
84383;202102;352590;G;4744005;1;1;0
84446;202102;352590;I;5611203;2;0;2
84447;202102;352590;G;4637106;8;5;3
85530;202102;352590;I;5611203;1;0;1
85537;202102;352590;S;9521500;1;0;1
86259;202102;352590;Q;8630501;2;0;2
86497;202102;352590;Q;8650006;1;0;1
86993;202102;352590;P;8599601;0;1;-1
87066;202102;352590;G;4649499;0;5;-5
87502;202102;352590;G;4751200;0;3;-3
87533;202102;352590;N;8211300;2;2;0
87758;202102;352590;Q;8630504;0;1;-1
87816;202102;352590;N;8291100;2;0;2
88563;202102;352590;G;4774100;0;1;-1
88861;202102;352590;Q;8630504;2;0;2
88873;202102;352590;G;4672900;0;5;-5
88984;202102;352590;I;5611201;15;7;8
88986;202102;352590;I;5611201;5;3;2
89262;202102;352590;N;8299799;2;5;-3
89263;202102;352590;N;8299799;0;1;-1
89325;202102;352590;Q;8711502;4;4;0
89635;202102;352590;J;6203100;1;2;-1
89862;202102;352590;N;7820500;2;0;2
89893;202102;352590;G;4742300;1;1;0
90239;202102;352590;K;6622300;2;0;2
90308;202102;352590;F;4120400;3;1;2
90633;202102;352590;H;4930202;1;1;0
90804;202102;352590;Q;8650004;1;2;-1
90928;202102;352590;K;6622300;0;1;-1
91764;202102;352590;H;4930202;1;0;1
92061;202102;352590;I;5611201;0;1;-1
92114;202102;352590;N;8121400;1;2;-1
92188;202102;352590;H;4930201;7;2;5
92856;202102;352590;H;5112901;2;1;1
93276;202102;352590;G;4520001;1;1;0
93911;202102;352590;G;4781400;0;1;-1
94104;202102;352590;P;8532500;6;1;5
94177;202102;352590;G;4789002;1;0;1
94205;202102;352590;P;8599699;9;4;5
94760;202102;352590;G;4541202;1;0;1
95445;202102;352590;S;9601701;1;0;1
95574;202102;352590;G;4712100;0;1;-1
96450;202102;352590;G;4782202;1;0;1
96685;202102;352590;C;3314721;6;0;6
96973;202102;352590;C;1412601;1;0;1
97119;202102;352590;G;4511101;4;2;2
97361;202102;352590;N;7711000;0;1;-1
97638;202102;352590;F;4299599;25;6;19
97641;202102;352590;F;4299599;3;14;-11
98131;202102;352590;Q;8640210;1;1;0
98132;202102;352590;Q;8640210;0;1;-1
98462;202102;352590;G;4743100;1;1;0
98500;202102;352590;G;4753900;1;1;0
98694;202102;352590;G;4731800;2;3;-1
98767;202102;352590;G;4639701;7;12;-5
98886;202102;352590;G;4729699;0;1;-1
99366;202102;352590;G;4731800;1;1;0
99792;202102;352590;M;6911701;0;1;-1
100023;202102;352590;I;5611201;0;1;-1
100041;202102;352590;H;5250804;0;3;-3
100045;202102;352590;M;6911701;0;1;-1
100733;202102;352590;N;8299799;11;6;5
101305;202102;352590;I;5620101;1;0;1
102203;202102;352590;G;4782201;1;3;-2
102876;202102;352590;P;8512100;13;4;9
103051;202102;352590;H;5250801;1;0;1
103198;202102;352590;I;5611203;1;1;0
103321;202102;352590;H;4930202;0;1;-1
103414;202102;352590;G;4789007;0;1;-1
103571;202102;352590;M;7112000;1;0;1
103627;202102;352590;G;4511102;1;0;1
103650;202102;352590;G;4744005;1;0;1
103780;202102;352590;G;4731800;1;0;1
103818;202102;352590;N;8211300;81;31;50
103911;202102;352590;G;4781400;1;0;1
104084;202102;352590;G;4789002;0;1;-1
104229;202102;352590;N;8211300;2;0;2
104330;202102;352590;R;9329802;0;1;-1
104359;202102;352590;C;3299004;2;0;2
104837;202102;352590;G;4731800;2;0;2
105303;202102;352590;G;4759899;1;0;1
105766;202102;352590;J;6203100;3;1;2
105837;202102;352590;I;5611201;1;3;-2
106343;202102;352590;C;2399199;0;1;-1
106829;202102;352590;F;4399105;1;2;-1
106961;202102;352590;Q;8630504;1;0;1
107209;202102;352590;G;4520001;0;1;-1
107357;202102;352590;E;3600602;1;0;1
107819;202102;352590;Q;8650099;19;14;5
108076;202102;352590;G;4789007;6;2;4
108107;202102;352590;C;2949299;1;4;-3
108188;202102;352590;G;4753900;1;1;0
108694;202102;352590;I;5611201;0;3;-3
108698;202102;352590;F;4120400;0;1;-1
108769;202102;352590;G;4744005;2;0;2
108770;202102;352590;L;6810202;0;1;-1
108781;202102;352590;F;4321500;1;0;1
109946;202102;352590;I;5611203;0;3;-3
110677;202102;352590;H;4930201;6;3;3
111428;202102;352590;M;6920601;0;1;-1
111772;202102;352590;C;2222600;4;4;0
111880;202102;352590;G;4724500;10;16;-6
111893;202102;352590;G;4724500;4;2;2
112061;202102;352590;I;5611202;0;2;-2
112457;202102;352590;R;9313100;0;1;-1
112610;202102;352590;H;4929901;2;0;2
113445;202102;352590;G;4511101;0;1;-1
114158;202102;352590;C;1813001;3;0;3
114682;202102;352590;H;4930202;0;1;-1
114787;202102;352590;G;4672900;0;1;-1
114799;202102;352590;G;4712100;2;1;1
114982;202102;352590;C;1412601;1;0;1
115042;202102;352590;G;4731800;1;0;1
115051;202102;352590;F;4299599;0;2;-2
115318;202102;352590;R;9313100;1;1;0
115948;202102;352590;S;9430800;2;2;0
116446;202102;352590;G;4744001;1;0;1
116460;202102;352590;S;9430800;2;2;0
116997;202102;352590;I;5611203;1;0;1
117280;202102;352590;N;8299706;1;1;0
117286;202102;352590;N;8299706;1;0;1
117320;202102;352590;Q;8630504;2;1;1
117581;202102;352590;G;4729699;3;1;2
118324;202102;352590;N;8299706;0;2;-2
119303;202102;352590;I;5611201;0;6;-6
119316;202102;352590;G;4781400;1;0;1
119877;202102;352590;G;4751201;2;0;2
119890;202102;352590;G;4530703;7;2;5
120438;202102;352590;N;7911200;1;0;1
120473;202102;352590;G;4731800;2;0;2
120477;202102;352590;G;4782201;0;1;-1
120503;202102;352590;F;4313400;3;3;0
120529;202102;352590;G;4724500;0;1;-1
120854;202102;352590;M;6920601;1;0;1
120962;202102;352590;I;5611203;0;1;-1
120966;202102;352590;C;2330302;1;0;1
121048;202102;352590;F;4313400;11;9;2
121123;202102;352590;P;8512100;2;0;2
121222;202102;352590;G;4511101;7;5;2
121836;202102;352590;P;8513900;2;1;1
121902;202102;352590;G;4781400;1;1;0
122172;202102;352590;R;9313100;2;1;1
123444;202102;352590;J;6201501;0;1;-1
124114;202102;352590;G;4687703;1;0;1
124405;202102;352590;G;4729699;1;1;0
124407;202102;352590;G;4789099;1;0;1
124444;202102;352590;N;8112500;2;2;0
124553;202102;352590;P;8512100;1;0;1
124923;202102;352590;G;4722901;1;0;1
125000;202102;352590;N;7820500;108;200;-92
125985;202102;352590;C;2592601;1;1;0
126158;202102;352590;Q;8712300;4;3;1
126239;202102;352590;N;8299799;0;1;-1
126341;202102;352590;C;1621800;1;0;1
126365;202102;352590;G;4781400;0;1;-1
126487;202102;352590;G;4520001;0;1;-1
126885;202102;352590;J;6202300;0;2;-2
127025;202102;352590;I;5611203;0;1;-1
127545;202102;352590;G;4755502;0;2;-2
127589;202102;352590;M;6920601;1;0;1
127683;202102;352590;S;9430800;1;0;1
128432;202102;352590;G;4781400;1;0;1
128618;202102;352590;G;4744002;1;0;1
128662;202102;352590;G;4772500;0;1;-1
129356;202102;352590;G;4541203;1;2;-1
129425;202102;352590;G;4761001;1;0;1
130138;202102;352590;Q;8630503;1;0;1
130197;202102;352590;P;8511200;1;1;0
130198;202102;352590;P;8511200;5;0;5
130376;202102;352590;R;9313100;1;2;-1
130902;202102;352590;G;4774100;1;0;1
131232;202102;352590;I;5611201;1;0;1
131370;202102;352590;G;4721102;0;1;-1
131638;202102;352590;N;8299799;1;1;0
132554;202102;352590;G;4687702;1;0;1
133073;202102;352590;G;4711302;7;16;-9
133104;202102;352590;G;4774100;0;1;-1
133233;202102;352590;G;4753900;2;1;1
133348;202102;352590;G;4649499;2;1;1
133412;202102;352590;G;4771701;1;0;1
133798;202102;352590;G;4751201;0;1;-1
134745;202102;352590;C;2219600;1;0;1
134849;202102;352590;M;6920601;1;1;0
134851;202102;352590;G;4759899;1;0;1
134939;202102;352590;Q;8650003;0;1;-1
134943;202102;352590;G;4754701;1;0;1
135056;202102;352590;G;4744099;1;0;1
135468;202102;352590;C;2825900;1;1;0
135642;202102;352590;M;7112000;0;1;-1
136437;202102;352590;G;4741500;1;1;0
136587;202102;352590;G;4639701;0;1;-1
136678;202102;352590;G;4741500;2;0;2
136737;202102;352590;C;2399101;3;1;2
137294;202102;352590;G;4759899;2;2;0
137296;202102;352590;G;4759899;0;3;-3
137297;202102;352590;G;4759899;0;3;-3
137298;202102;352590;G;4759899;8;5;3
137306;202102;352590;G;4649499;2;9;-7
137348;202102;352590;M;6920601;1;1;0
137409;202102;352590;G;4761001;2;2;0
137613;202102;352590;G;4520001;2;1;1
138187;202102;352590;G;4744002;1;0;1
138393;202102;352590;H;4930203;0;2;-2
138427;202102;352590;N;8299799;1;1;0
138450;202102;352590;G;4712100;10;3;7
138516;202102;352590;N;8299799;29;4;25
138817;202102;352590;C;1099699;0;1;-1
138969;202102;352590;C;1082100;12;4;8
139571;202102;352590;F;4120400;1;0;1
140278;202102;352590;G;4711302;0;3;-3
140419;202102;352590;G;4711301;13;7;6
140711;202102;352590;G;4511102;1;0;1
141274;202102;352590;C;2829199;2;1;1
141331;202102;352590;I;5611201;2;2;0
141344;202102;352590;I;5611203;4;0;4
141345;202102;352590;I;5611203;2;0;2
141446;202102;352590;G;4751201;1;1;0
141650;202102;352590;P;8531700;5;7;-2
142846;202102;352590;F;4322302;0;1;-1
142890;202102;352590;G;4753900;0;1;-1
142916;202102;352590;G;4789002;0;1;-1
143903;202102;352590;I;5611201;0;1;-1
145245;202102;352590;G;4781400;1;0;1
145669;202102;352590;C;2330302;1;0;1
145787;202102;352590;G;4759899;4;1;3
145877;202102;352590;G;4530703;1;1;0
145931;202102;352590;G;4789001;0;1;-1
146011;202102;352590;F;4313400;9;8;1
146030;202102;352590;G;4721102;0;1;-1
146623;202102;352590;G;4744099;0;1;-1
146828;202102;352590;C;1013902;12;5;7
147548;202102;352590;R;9313100;0;2;-2
147622;202102;352590;H;4930202;2;1;1
148086;202102;352590;G;4722901;0;1;-1
148139;202102;352590;C;1413402;0;1;-1
148175;202102;352590;I;5611203;1;0;1
148185;202102;352590;G;4712100;3;4;-1
148362;202102;352590;G;4789002;4;1;3
148417;202102;352590;G;4687701;1;0;1
148807;202102;352590;G;4763602;1;3;-2
149207;202102;352590;H;4930202;11;9;2
151157;202102;352590;I;5611203;0;1;-1
151250;202102;352590;I;5611201;0;1;-1
151479;202102;352590;J;5829800;1;0;1
152060;202102;352590;F;4120400;1;0;1
152066;202102;352590;N;8299799;3;7;-4
152159;202102;352590;F;4120400;5;0;5
152565;202102;352590;G;4763601;0;1;-1
153588;202102;352590;H;5250804;1;1;0
154116;202102;352590;C;2710402;0;3;-3
154326;202102;352590;G;4633801;2;0;2
154345;202102;352590;G;4711302;24;14;10
156126;202102;352590;I;5611201;0;1;-1
156134;202102;352590;G;4763603;2;0;2
156187;202102;352590;G;4731800;1;2;-1
156288;202102;352590;G;4781400;0;1;-1
156347;202102;352590;I;5611201;1;0;1
156722;202102;352590;N;8011101;33;12;21
156858;202102;352590;G;4754701;2;0;2
157276;202102;352590;G;4781400;1;0;1
157478;202102;352590;G;4530703;1;0;1
157713;202102;352590;H;4923002;0;1;-1
158159;202102;352590;H;4930202;0;1;-1
158655;202102;352590;N;8211300;5;5;0
158937;202102;352590;K;6622300;0;1;-1
159517;202102;352590;G;4781400;0;6;-6
160119;202102;352590;C;2790299;8;4;4
160972;202102;352590;C;3314710;0;1;-1
161117;202102;352590;G;4781400;0;1;-1
161155;202102;352590;E;3701100;0;1;-1
161183;202102;352590;H;4930201;0;1;-1
161226;202102;352590;C;1053800;0;3;-3
161368;202102;352590;Q;8630502;1;0;1
161407;202102;352590;Q;8630501;3;3;0
161413;202102;352590;G;4774100;0;1;-1
161882;202102;352590;G;4633801;3;9;-6
162749;202102;352590;K;6622300;1;0;1
163050;202102;352590;G;4744099;1;1;0
163144;202102;352590;N;8211300;0;1;-1
163393;202102;352590;P;8599605;1;0;1
163524;202102;352590;P;8513900;0;1;-1
163814;202102;352590;C;2622100;0;1;-1
164262;202102;352590;F;4321500;1;1;0
164434;202102;352590;I;5611201;0;1;-1
164435;202102;352590;N;8111700;0;2;-2
164939;202102;352590;G;4751201;1;0;1
165107;202102;352590;G;4520005;1;1;0
165109;202102;352590;F;4299599;0;1;-1
165333;202102;352590;F;4110700;1;0;1
165867;202102;352590;G;4731800;0;1;-1
166944;202102;352590;P;8520100;1;0;1
167056;202102;352590;G;4771701;0;1;-1
167057;202102;352590;G;4771701;0;1;-1
167187;202102;352590;C;2543800;0;1;-1
167207;202102;352590;H;5223100;0;1;-1
167213;202102;352590;I;5620101;1;1;0
167565;202102;352590;M;7490104;1;1;0
168449;202102;352590;I;5611201;1;1;0
169119;202102;352590;G;4752100;0;2;-2
169386;202102;352590;I;5620101;1;0;1
169489;202102;352590;C;2219600;8;2;6
169525;202102;352590;G;4722901;0;1;-1
169698;202102;352590;G;4781400;0;1;-1
170014;202102;352590;G;4741500;1;0;1
170081;202102;352590;N;8211300;2;2;0
170324;202102;352590;C;2029100;1;3;-2
170352;202102;352590;G;4635402;1;2;-1
170920;202102;352590;I;5620104;1;0;1
171361;202102;352590;S;9493600;1;0;1
171933;202102;352590;H;4930202;5;3;2
172115;202102;352590;G;4789005;0;1;-1
172133;202102;352590;M;6920601;1;1;0
172408;202102;352590;G;4724500;1;0;1
172515;202102;352590;R;9313100;0;1;-1
172659;202102;352590;G;4754703;1;2;-1
173380;202102;352590;G;4617600;2;0;2
174231;202102;352590;G;4721102;2;2;0
174280;202102;352590;P;8511200;0;1;-1
174873;202102;352590;G;4772500;1;1;0
175068;202102;352590;J;6201501;1;0;1
175875;202102;352590;G;4520001;1;0;1
175995;202102;352590;P;8520100;7;1;6
176003;202102;352590;J;6201501;2;1;1
176272;202102;352590;J;6203100;3;0;3
176506;202102;352590;C;2543800;2;2;0
177374;202102;352590;N;8112500;4;3;1
177404;202102;352590;C;1053800;0;2;-2
177845;202102;352590;H;4930202;3;2;1
177960;202102;352590;G;4754702;0;1;-1
179014;202102;352590;G;4712100;1;2;-1
179128;202102;352590;C;1099601;9;6;3
179267;202102;352590;P;8520100;2;1;1
179271;202102;352590;L;6810202;1;0;1
179586;202102;352590;C;1042200;2;1;1
179624;202102;352590;G;4541203;1;0;1
179725;202102;352590;P;8513900;3;1;2
179728;202102;352590;P;8513900;1;0;1
179996;202102;352590;Q;8650004;2;0;2
180247;202102;352590;H;4930202;3;2;1
180530;202102;352590;G;4789099;0;2;-2
180627;202102;352590;G;4781400;0;2;-2
180761;202102;352590;G;4742300;0;1;-1
180890;202102;352590;G;4781400;0;1;-1
180916;202102;352590;H;5212500;2;2;0
181285;202102;352590;N;7911200;0;3;-3
181575;202102;352590;K;6619399;3;0;3
182061;202102;352590;I;5611203;2;0;2
182207;202102;352590;J;6190699;3;1;2
182257;202102;352590;C;1062700;0;64;-64
182564;202102;352590;A;133499;1;1;0
182831;202102;352590;G;4511101;1;1;0
183126;202102;352590;M;6920601;1;0;1
183224;202102;352590;M;7112000;0;1;-1
183438;202102;352590;G;4530703;1;0;1
183557;202102;352590;N;7711000;1;0;1
183887;202102;352590;I;5611203;1;0;1
183911;202102;352590;I;5611203;2;1;1
183913;202102;352590;I;5611203;0;1;-1
184727;202102;352590;I;5611201;0;1;-1
185109;202102;352590;J;5813100;1;0;1
185138;202102;352590;G;4782201;1;1;0
186110;202102;352590;N;7732201;2;0;2
186169;202102;352590;K;6622300;1;0;1
186601;202102;352590;G;4530703;1;0;1
186795;202102;352590;G;4753900;2;3;-1
186932;202102;352590;G;4789099;1;2;-1
187748;202102;352590;G;4639701;4;1;3
188097;202102;352590;G;4744001;1;0;1
188380;202102;352590;G;4721104;1;0;1
188384;202102;352590;G;4530703;2;0;2
188993;202102;352590;G;4731800;1;0;1
189447;202102;352590;G;4744001;0;2;-2
189500;202102;352590;G;4686902;1;0;1
189600;202102;352590;B;891600;2;3;-1
190252;202102;352590;C;2621300;1;131;-130
190253;202102;352590;C;2632900;17;31;-14
190301;202102;352590;G;4759899;1;0;1
190332;202102;352590;N;8299799;131;90;41
190352;202102;352590;G;4742300;1;0;1
191042;202102;352590;P;8512100;0;1;-1
192164;202102;352590;H;5212500;4;7;-3
192343;202102;352590;G;4761001;1;0;1
193291;202102;352590;C;3316301;0;1;-1
193442;202102;352590;G;4752100;1;0;1
193458;202102;352590;G;4752100;0;1;-1
194341;202102;352590;F;4321500;2;1;1
194733;202102;352590;G;4744099;1;0;1
194866;202102;352590;N;7830200;4;2;2
195096;202102;352590;I;5611203;0;1;-1
195246;202102;352590;P;8513900;2;0;2
195380;202102;352590;H;4930202;1;0;1
195684;202102;352590;G;4687703;1;0;1
195937;202102;352590;J;6201501;3;0;3
196681;202102;352590;H;4930202;0;6;-6
196973;202102;352590;F;4399199;3;1;2
197020;202102;352590;G;4731800;1;1;0
197084;202102;352590;K;6491300;1;0;1
198427;202102;352590;J;5829800;1;1;0
198608;202102;352590;F;4120400;3;3;0
198949;202102;352590;P;8512100;0;1;-1
199094;202102;352590;G;4530703;3;2;1
199112;202102;352590;N;7810800;0;1;-1
199607;202102;352590;G;4744001;1;2;-1
200461;202102;352590;P;8512100;9;2;7
200590;202102;352590;G;4789004;3;0;3
201138;202102;352590;F;4213800;10;8;2
201430;202102;352590;G;4530703;0;1;-1
201699;202102;352590;C;2840200;1;2;-1
201716;202102;352590;G;4729699;3;1;2
202050;202102;352590;G;4663000;1;0;1
202067;202102;352590;K;6424703;1;0;1
202245;202102;352590;H;5212500;24;19;5
202253;202102;352590;G;4729699;1;0;1
202351;202102;352590;N;8111700;16;8;8
202854;202102;352590;G;4789001;0;1;-1
203534;202102;352590;N;7820500;2;0;2
203606;202102;352590;G;4511101;0;4;-4
203885;202102;352590;I;5611201;0;1;-1
204993;202102;352590;Q;8640212;0;1;-1
205678;202102;352590;Q;8610101;0;1;-1
206151;202102;352590;G;4729699;5;6;-1
206718;202102;352590;F;4110700;1;0;1
207400;202102;352590;G;4774100;2;0;2
207700;202102;352590;C;3101200;1;0;1
207990;202102;352590;H;4930202;0;3;-3
208179;202102;352590;Q;8630504;1;0;1
208191;202102;352590;F;4222701;8;2;6
208473;202102;352590;I;5611203;0;1;-1
208481;202102;352590;G;4789099;1;0;1
208754;202102;352590;G;4686902;17;1;16
209699;202102;352590;I;5611201;8;4;4
209726;202102;352590;I;5611201;3;3;0
209733;202102;352590;I;5611201;2;1;1
209913;202102;352590;G;4759899;0;1;-1
210097;202102;352590;I;5611203;1;0;1
210183;202102;352590;C;2222600;1;0;1
210470;202102;352590;G;4781400;1;0;1
210629;202102;352590;J;6209100;0;1;-1
211076;202102;352590;G;4511101;5;3;2
211738;202102;352590;G;4781400;1;0;1
212037;202102;352590;G;4789099;3;0;3
212566;202102;352590;G;4774100;1;0;1
212970;202102;352590;N;8111700;1;2;-1
213417;202102;352590;G;4754701;4;4;0
213940;202102;352590;H;4930201;0;2;-2
214402;202102;352590;G;4729699;1;0;1
215410;202102;352590;P;8541400;0;1;-1
215411;202102;352590;G;4541205;0;1;-1
215445;202102;352590;G;4731800;0;1;-1
215708;202102;352590;I;5611203;0;1;-1
216252;202102;352590;I;5620101;5;4;1
216740;202102;352590;G;4759899;0;1;-1
216951;202102;352590;G;4729699;0;1;-1
217278;202102;352590;G;4789005;0;1;-1
217467;202102;352590;N;8299799;1;0;1
217537;202102;352590;F;4330404;2;1;1
217538;202102;352590;F;4330404;0;2;-2
217539;202102;352590;F;4330404;1;1;0
218060;202102;352590;M;6920601;1;0;1
218133;202102;352590;G;4782201;1;0;1
218415;202102;352590;S;9521500;6;0;6
218416;202102;352590;S;9521500;0;3;-3
218431;202102;352590;Q;8630503;1;1;0
218839;202102;352590;M;7112000;1;2;-1
218840;202102;352590;J;6204000;7;2;5
220099;202102;352590;G;4530703;0;1;-1
220426;202102;352590;K;6622300;1;0;1
221324;202102;352590;G;4772500;3;4;-1
221705;202102;352590;I;5611201;7;3;4
221795;202102;352590;G;4541203;1;0;1
222793;202102;352590;G;4789099;1;1;0
222834;202102;352590;G;4713002;0;2;-2
222895;202102;352590;I;5611201;2;0;2
223607;202102;352590;N;8211300;1;0;1
223657;202102;352590;M;6920601;1;0;1
224165;202102;352590;Q;8610101;8;11;-3
224788;202102;352590;G;4686902;5;1;4
224875;202102;352590;G;4724500;11;9;2
224876;202102;352590;G;4633801;2;1;1
224877;202102;352590;G;4724500;4;13;-9
224957;202102;352590;I;5620101;1;1;0
225087;202102;352590;G;4781400;1;0;1
225088;202102;352590;G;4781400;0;1;-1
225183;202102;352590;G;4663000;1;0;1
226590;202102;352590;G;4751201;1;0;1
226803;202102;352590;P;8593700;1;1;0
226928;202102;352590;C;2812700;1;0;1
226934;202102;352590;G;4789004;1;0;1
227343;202102;352590;J;5914600;0;1;-1
228336;202102;352590;I;5510801;3;2;1
228515;202102;352590;H;5250805;1;1;0
228560;202102;352590;C;2621300;2;7;-5
229143;202102;352590;G;4691500;7;6;1
229299;202102;352590;I;5611204;1;1;0
229562;202102;352590;C;3299099;3;0;3
229571;202102;352590;C;3291400;0;1;-1
229709;202102;352590;Q;8711502;2;0;2
229828;202102;352590;G;4781400;1;0;1
230623;202102;352590;F;4399103;0;1;-1
230648;202102;352590;G;4520006;1;0;1
230671;202102;352590;C;2511000;12;8;4
230785;202102;352590;G;4731800;1;0;1
231952;202102;352590;I;5611201;0;1;-1
232000;202102;352590;I;5611201;1;1;0
232419;202102;352590;G;4731800;0;2;-2
232584;202102;352590;M;6920601;2;1;1
232759;202102;352590;I;5611201;0;1;-1
233162;202102;352590;N;8299799;0;2;-2
233440;202102;352590;M;7119701;1;1;0
233672;202102;352590;C;2660400;21;7;14
233708;202102;352590;G;4781400;0;1;-1
234355;202102;352590;N;8299799;0;1;-1
234369;202102;352590;G;4771701;1;0;1
234475;202102;352590;Q;8640205;3;2;1
234588;202102;352590;I;5611201;0;1;-1
234685;202102;352590;G;4712100;1;0;1
234876;202102;352590;G;4633801;0;1;-1
236125;202102;352590;G;4511101;5;0;5
236489;202102;352590;K;6491300;1;0;1
237221;202102;352590;G;4731800;2;1;1
237243;202102;352590;G;4782201;1;1;0
237263;202102;352590;H;4930202;0;1;-1
237586;202102;352590;G;4520004;0;1;-1
238111;202102;352590;G;4754701;22;2;20
238115;202102;352590;G;4754701;4;0;4
238568;202102;352590;N;8211300;1;4;-3
238604;202102;352590;G;4713002;1;0;1
239451;202102;352590;N;8220200;6;3;3
239957;202102;352590;G;4530703;1;4;-3
240192;202102;352590;S;9499500;1;0;1
241803;202102;352590;P;8599601;1;0;1
241972;202102;352590;N;8122200;2;0;2
242184;202102;352590;G;4744099;1;0;1
242290;202102;352590;H;5250804;1;1;0
242292;202102;352590;G;4744003;1;0;1
244399;202102;352590;M;7500100;0;1;-1
244647;202102;352590;H;4930202;3;7;-4
244765;202102;352590;M;6920601;0;1;-1
244916;202102;352590;J;6204000;0;4;-4
245678;202102;352590;L;6810201;1;0;1
245729;202102;352590;I;5611201;0;1;-1
245977;202102;352590;K;6622300;0;1;-1
246490;202102;352590;G;4732600;0;1;-1
246731;202102;352590;J;6399200;0;2;-2
246765;202102;352590;C;2222600;17;12;5
246937;202102;352590;G;4754701;1;0;1
247359;202102;352590;G;4771701;1;0;1
247374;202102;352590;C;3314707;12;8;4
247580;202102;352590;S;9602502;1;0;1
248902;202102;352590;H;4930202;2;4;-2
249045;202102;352590;G;4751201;0;1;-1
249903;202102;352590;C;1629301;0;1;-1
250142;202102;352590;G;4731800;2;2;0
250251;202102;352590;M;6911701;0;1;-1
251128;202102;352590;S;9609299;2;0;2
251142;202102;352590;G;4712100;2;1;1
251143;202102;352590;N;8299799;0;1;-1
251610;202102;352590;G;4511101;1;1;0
253170;202102;352590;Q;8630502;0;1;-1
253364;202102;352590;F;4321500;2;3;-1
253489;202102;352590;I;5611203;0;1;-1
253539;202102;352590;M;6920601;0;1;-1
253782;202102;352590;H;4930202;3;2;1
253795;202102;352590;G;4530703;0;1;-1
253957;202102;352590;M;6920601;4;2;2
254322;202102;352590;H;4930202;0;1;-1
254529;202102;352590;F;4330401;0;1;-1
254847;202102;352590;G;4686902;1;0;1
255204;202102;352590;I;5611203;0;1;-1
255908;202102;352590;C;3314719;1;0;1
256039;202102;352590;P;8511200;0;1;-1
256255;202102;352590;Q;8630502;0;1;-1
256331;202102;352590;G;4651601;0;1;-1
256358;202102;352590;H;4930202;19;23;-4
256579;202102;352590;F;4213800;1;2;-1
257027;202102;352590;K;6622300;5;0;5
257975;202102;352590;M;7020400;0;1;-1
258470;202102;352590;G;4530703;0;1;-1
259001;202102;352590;P;8599604;1;1;0
259016;202102;352590;N;8299799;1;1;0
259033;202102;352590;G;4712100;2;1;1
259071;202102;352590;G;4669999;1;0;1
260047;202102;352590;G;4623109;0;2;-2
260078;202102;352590;G;4781400;8;25;-17
260087;202102;352590;G;4511104;3;0;3
260113;202102;352590;N;8130300;52;24;28
260114;202102;352590;G;4789099;1;2;-1
260595;202102;352590;H;5223100;0;1;-1
260815;202102;352590;S;9601701;0;1;-1
260906;202102;352590;G;4761003;1;1;0
261231;202102;352590;G;4789099;0;1;-1
261931;202102;352590;G;4781400;0;1;-1
262217;202102;352590;A;132600;0;1;-1
262268;202102;352590;M;6920601;1;1;0
262468;202102;352590;M;6920601;0;1;-1
262580;202102;352590;N;8299799;0;1;-1
263069;202102;352590;P;8593700;3;0;3
263086;202102;352590;N;8299799;2;2;0
263354;202102;352590;G;4721102;0;1;-1
263478;202102;352590;C;2311700;0;1;-1
263479;202102;352590;G;4744002;1;1;0
263802;202102;352590;I;5611203;1;0;1
263952;202102;352590;F;4322302;1;0;1
264339;202102;352590;H;5212500;10;7;3
264744;202102;352590;C;3314721;2;0;2
264793;202102;352590;C;2349401;3;1;2
265348;202102;352590;Q;8630501;2;1;1
265717;202102;352590;M;7500100;3;1;2
266595;202102;352590;M;7490199;1;0;1
266598;202102;352590;N;8292000;1;1;0
266970;202102;352590;G;4789099;1;0;1
267116;202102;352590;F;4321500;2;0;2
267373;202102;352590;G;4754701;0;1;-1
267414;202102;352590;N;8211300;1;1;0
267478;202102;352590;Q;8630506;2;1;1
267748;202102;352590;G;4530703;1;0;1
268568;202102;352590;J;5911102;2;0;2
269181;202102;352590;C;2072000;5;4;1
269244;202102;352590;G;4781400;1;0;1
270235;202102;352590;G;4771701;1;0;1
270497;202102;352590;Q;8711502;1;1;0
270620;202102;352590;G;4649499;6;1;5
271103;202102;352590;I;5611201;2;1;1
271413;202102;352590;P;8513900;4;0;4
271435;202102;352590;G;4520007;3;3;0
272068;202102;352590;H;4930202;1;0;1
272476;202102;352590;C;1830003;1;1;0
272563;202102;352590;G;4782201;1;0;1
273387;202102;352590;Q;8712300;0;1;-1
273548;202102;352590;N;8299799;2;0;2
273634;202102;352590;C;1091101;1;4;-3
275139;202102;352590;I;5611201;0;1;-1
275316;202102;352590;N;8299799;2;0;2
275327;202102;352590;R;9313100;1;0;1
275574;202102;352590;G;4744099;2;2;0
275762;202102;352590;C;1733800;5;5;0
275986;202102;352590;I;5611203;0;1;-1
276417;202102;352590;I;5620101;1;0;1
276426;202102;352590;G;4721102;0;1;-1
276441;202102;352590;P;8599603;1;0;1
276489;202102;352590;H;4930202;3;1;2
276759;202102;352590;I;5611204;0;1;-1
276939;202102;352590;I;5611201;0;1;-1
277164;202102;352590;G;4781400;4;8;-4
277552;202102;352590;G;4520001;0;1;-1
278992;202102;352590;G;4751201;1;0;1
279095;202102;352590;L;6822600;0;1;-1
279208;202102;352590;G;4520002;2;0;2
279215;202102;352590;F;4120400;0;4;-4
279608;202102;352590;G;4530703;0;1;-1
279790;202102;352590;J;6311900;0;3;-3
279839;202102;352590;C;2790299;1;0;1
280098;202102;352590;G;4722901;1;0;1
280269;202102;352590;J;5811500;5;0;5
280347;202102;352590;M;6920601;1;0;1
280674;202102;352590;F;4322302;1;3;-2
280920;202102;352590;L;6821802;0;1;-1
281191;202102;352590;G;4781400;0;1;-1
281498;202102;352590;G;4789004;0;1;-1
281901;202102;352590;I;5611201;1;0;1
282136;202102;352590;S;9609208;1;0;1
282141;202102;352590;G;4713002;0;1;-1
282388;202102;352590;C;1733800;9;3;6
282638;202102;352590;P;8520100;1;2;-1
282658;202102;352590;F;4322301;0;2;-2
282765;202102;352590;G;4530703;0;1;-1
282945;202102;352590;S;9601701;1;0;1
283563;202102;352590;G;4781400;1;0;1
283850;202102;352590;G;4689301;1;1;0
283894;202102;352590;M;6920601;0;1;-1
283973;202102;352590;G;4731800;1;1;0
284454;202102;352590;F;4330404;1;0;1
284987;202102;352590;G;4761001;1;2;-1
285397;202102;352590;G;4782201;2;1;1
285770;202102;352590;C;1066000;6;6;0
286234;202102;352590;G;4781400;9;1;8
286331;202102;352590;S;9521500;6;2;4
286463;202102;352590;P;8599604;0;1;-1
286820;202102;352590;Q;8650004;1;1;0
286999;202102;352590;C;3250705;11;1;10
287027;202102;352590;G;4772500;0;2;-2
287660;202102;352590;M;7490199;1;1;0
287696;202102;352590;P;8512100;2;0;2
287699;202102;352590;E;3821100;13;7;6
287701;202102;352590;I;5611201;0;1;-1
287748;202102;352590;K;6462000;1;2;-1
287808;202102;352590;N;8111700;19;22;-3
287867;202102;352590;J;6319400;1;0;1
287933;202102;352590;G;4541204;1;0;1
288011;202102;352590;F;4330499;1;2;-1
288261;202102;352590;G;4789001;0;2;-2
288971;202102;352590;I;5612100;1;0;1
289211;202102;352590;F;4120400;8;3;5
289364;202102;352590;I;5611201;0;1;-1
289910;202102;352590;G;4783101;0;1;-1
289941;202102;352590;I;5510801;2;0;2
290293;202102;352590;I;5611201;9;3;6
290294;202102;352590;I;5611201;6;2;4
290498;202102;352590;I;5620104;1;0;1
290499;202102;352590;G;4755503;1;1;0
290908;202102;352590;K;6462000;2;0;2
291245;202102;352590;G;4520007;0;1;-1
291457;202102;352590;C;3314703;1;0;1
291528;202102;352590;G;4744099;0;2;-2
292137;202102;352590;G;4783101;1;0;1
293027;202102;352590;J;6190601;4;2;2
293028;202102;352590;N;8121400;1;1;0
293033;202102;352590;G;4520005;0;1;-1
293159;202102;352590;G;4744001;1;0;1
293169;202102;352590;P;8513900;1;0;1
293642;202102;352590;G;4782201;0;3;-3
293760;202102;352590;F;4120400;0;1;-1
294018;202102;352590;P;8511200;1;0;1
294159;202102;352590;G;4771701;0;1;-1
294175;202102;352590;F;4322302;1;0;1
294812;202102;352590;P;8511200;1;0;1
295052;202102;352590;L;6821801;2;3;-1
295425;202102;352590;F;4321500;1;0;1
295536;202102;352590;R;9329804;1;1;0
296444;202102;352590;P;8511200;1;0;1
297665;202102;352590;G;4619200;1;0;1
297940;202102;352590;G;4530703;1;0;1
297947;202102;352590;P;8511200;2;2;0
297951;202102;352590;G;4743100;1;1;0
298539;202102;352590;G;4772500;1;1;0
298543;202102;352590;H;4930202;4;1;3
299192;202102;352590;C;3314708;0;1;-1
300064;202102;352590;Q;8650004;2;1;1
300065;202102;352590;Q;8650004;1;0;1
300752;202102;352590;G;4772500;2;2;0
301558;202102;352590;Q;8711501;2;1;1
301606;202102;352590;G;4530701;1;3;-2
301827;202102;352590;N;8111700;0;1;-1
302511;202102;352590;G;4757100;2;0;2
302664;202102;352590;G;4691500;4;10;-6
303211;202102;352590;G;4743100;1;0;1
303994;202102;352590;N;8211300;0;1;-1
304027;202102;352590;G;4637199;0;2;-2
304309;202102;352590;M;7311400;3;0;3
304363;202102;352590;I;5611203;0;1;-1
304403;202102;352590;I;5611203;0;5;-5
304408;202102;352590;I;5611203;0;2;-2
304825;202102;352590;I;5611203;1;1;0
305050;202102;352590;C;1091102;1;0;1
305114;202102;352590;S;9511800;0;1;-1
305371;202102;352590;G;4687702;1;0;1
305884;202102;352590;H;4930202;4;11;-7
305998;202102;352590;F;4330403;2;1;1
306002;202102;352590;F;4330499;1;1;0
306467;202102;352590;G;4781400;1;0;1
307829;202102;352590;N;7733100;1;1;0
309086;202102;352590;F;4330401;1;0;1
309173;202102;352590;G;4520004;1;0;1
309265;202102;352590;N;8299706;1;1;0
309269;202102;352590;Q;8630502;1;3;-2
309483;202102;352590;G;4761003;2;0;2
309933;202102;352590;G;4689399;1;0;1
310088;202102;352590;P;8511200;0;1;-1
310089;202102;352590;P;8511200;2;0;2
310211;202102;352590;F;4213800;4;0;4
310218;202102;352590;H;4930201;0;2;-2
310524;202102;352590;G;4772500;0;1;-1
310778;202102;352590;F;4399101;1;1;0
310945;202102;352590;G;4669999;5;3;2
311711;202102;352590;G;4724500;0;1;-1
311944;202102;352590;F;4399103;1;0;1
311958;202102;352590;H;4930201;0;1;-1
312364;202102;352590;C;3314713;0;1;-1
312433;202102;352590;I;5611203;0;1;-1
312847;202102;352590;I;5611203;1;0;1
313270;202102;352590;J;6311900;2;1;1
313525;202102;352590;G;4632003;0;1;-1
314277;202102;352590;D;3511502;1;0;1
314582;202102;352590;G;4649402;0;1;-1
315416;202102;352590;C;1093701;1;1;0
315561;202102;352590;G;4781400;2;1;1
315800;202102;352590;J;6110803;1;0;1
316110;202102;352590;G;4781400;1;1;0
316535;202102;352590;P;8541400;1;1;0
316774;202102;352590;G;4686902;1;0;1
316790;202102;352590;G;4772500;0;2;-2
316974;202102;352590;G;4530703;1;0;1
317662;202102;352590;C;2229399;1;0;1
317755;202102;352590;F;4399103;0;1;-1
317900;202102;352590;J;6201501;0;1;-1
317997;202102;352590;K;6619399;1;2;-1
317998;202102;352590;K;6622300;0;1;-1
318153;202102;352590;G;4731800;0;1;-1
318276;202102;352590;G;4763603;1;0;1
318435;202102;352590;G;4646001;0;1;-1
318643;202102;352590;Q;8630504;0;3;-3
318995;202102;352590;F;4321500;1;0;1
319390;202102;352590;C;2731700;0;1;-1
319451;202102;352590;J;6190601;0;1;-1
319543;202102;352590;C;3101200;1;0;1
319959;202102;352590;G;4789099;3;1;2
319962;202102;352590;Q;8640205;0;1;-1
319963;202102;352590;Q;8640205;1;0;1
320725;202102;352590;N;8112500;0;2;-2
320760;202102;352590;H;5211701;40;30;10
322084;202102;352590;G;4530704;6;1;5
322170;202102;352590;G;4753900;0;2;-2
322420;202102;352590;N;8219999;1;0;1
322595;202102;352590;C;3299099;2;0;2
322709;202102;352590;C;2399101;0;1;-1
322749;202102;352590;G;4530705;0;2;-2
322981;202102;352590;G;4771701;1;0;1
323443;202102;352590;M;7119704;3;4;-1
323649;202102;352590;N;8111700;0;1;-1
323654;202102;352590;F;4322302;1;0;1
323905;202102;352590;C;3314702;27;18;9
323909;202102;352590;G;4744001;2;0;2
324140;202102;352590;G;4754701;2;6;-4
324373;202102;352590;G;4781400;19;0;19
324949;202102;352590;G;4771702;2;0;2
324953;202102;352590;C;1091101;5;6;-1
324957;202102;352590;C;2599399;5;3;2
325134;202102;352590;C;3314708;5;5;0
326417;202102;352590;C;1413401;0;5;-5
326500;202102;352590;H;4930202;3;2;1
327313;202102;352590;P;8520100;5;0;5
327446;202102;352590;G;4763603;1;0;1
327991;202102;352590;F;4399103;0;1;-1
329135;202102;352590;G;4721102;2;0;2
329311;202102;352590;G;4771701;2;1;1
330419;202102;352590;I;5611203;0;2;-2
330607;202102;352590;F;4330402;1;0;1
331072;202102;352590;G;4530703;1;3;-2
331204;202102;352590;G;4761001;2;2;0
331550;202102;352590;F;4321500;1;0;1
331779;202102;352590;M;6920601;0;1;-1
332575;202102;352590;R;9313100;0;1;-1
332911;202102;352590;K;6622300;2;2;0
332949;202102;352590;G;4763601;0;4;-4
333017;202102;352590;F;4322303;0;3;-3
333127;202102;352590;N;8219999;0;1;-1
333271;202102;352590;G;4713002;3;0;3
333860;202102;352590;G;4741500;1;0;1
333862;202102;352590;G;4741500;1;0;1
333866;202102;352590;C;2522500;3;1;2
334489;202102;352590;G;4781400;1;1;0
334759;202102;352590;G;4772500;1;1;0
334867;202102;352590;J;6311900;0;1;-1
335502;202102;352590;G;4741500;0;1;-1
335753;202102;352590;Q;8650003;0;1;-1
336203;202102;352590;N;7739099;1;0;1
336752;202102;352590;M;6920601;0;1;-1
336791;202102;352590;N;7810800;6;7;-1
336800;202102;352590;G;4721104;12;5;7
336801;202102;352590;G;4637107;4;0;4
336891;202102;352590;C;3101200;4;5;-1
336893;202102;352590;G;4754701;1;3;-2
336894;202102;352590;G;4754701;0;1;-1
337054;202102;352590;J;6209100;0;1;-1
337150;202102;352590;I;5611201;1;0;1
337394;202102;352590;I;5611203;0;1;-1
337529;202102;352590;G;4752100;0;6;-6
337618;202102;352590;G;4744002;1;0;1
337976;202102;352590;J;6190699;1;0;1
338000;202102;352590;I;5611201;4;4;0
338236;202102;352590;Q;8800600;1;0;1
338438;202102;352590;C;1053800;6;2;4
338823;202102;352590;Q;8712300;0;1;-1
339075;202102;352590;G;4744099;1;0;1
339186;202102;352590;F;4120400;0;3;-3
339692;202102;352590;G;4781400;0;1;-1
339708;202102;352590;N;8020001;1;0;1
339715;202102;352590;G;4721104;1;0;1
339820;202102;352590;N;8121400;1;0;1
339854;202102;352590;N;7732201;2;0;2
340161;202102;352590;I;5611202;0;2;-2
340627;202102;352590;I;5611201;0;1;-1
341628;202102;352590;G;4781400;1;0;1
342197;202102;352590;G;4772500;0;1;-1
342972;202102;352590;C;3314708;1;0;1
343425;202102;352590;I;5611201;2;0;2
343793;202102;352590;H;5212500;0;2;-2
344317;202102;352590;G;4781400;0;2;-2
344406;202102;352590;G;4520002;2;1;1
344507;202102;352590;F;4120400;0;1;-1
344641;202102;352590;M;7112000;0;13;-13
344820;202102;352590;N;7711000;0;1;-1
344924;202102;352590;N;7711000;0;1;-1
344974;202102;352590;S;9529105;0;2;-2
345104;202102;352590;C;2823200;1;0;1
345200;202102;352590;Q;8630503;1;0;1
345365;202102;352590;C;3101200;2;1;1
345878;202102;352590;J;6209100;1;0;1
345934;202102;352590;S;9521500;0;1;-1
346001;202102;352590;G;4712100;1;1;0
346149;202102;352590;N;8299799;2;0;2
346268;202102;352590;F;4120400;0;1;-1
346407;202102;352590;P;8511200;0;2;-2
346549;202102;352590;M;7311400;0;1;-1
346896;202102;352590;N;8111700;0;2;-2
347014;202102;352590;I;5611201;0;1;-1
347053;202102;352590;G;4712100;1;0;1
347398;202102;352590;G;4782201;0;2;-2
347736;202102;352590;N;7911200;1;5;-4
347960;202102;352590;G;4781400;0;2;-2
347962;202102;352590;R;9313100;0;1;-1
348002;202102;352590;G;4782201;0;1;-1
348347;202102;352590;I;5611203;0;1;-1
348416;202102;352590;S;9601701;0;1;-1
348453;202102;352590;N;8111700;9;0;9
348646;202102;352590;H;4930202;4;8;-4
348654;202102;352590;F;4321500;0;1;-1
348660;202102;352590;R;9313100;2;0;2
349174;202102;352590;I;5611201;1;0;1
349177;202102;352590;P;8511200;4;0;4
349516;202102;352590;G;4755502;3;4;-1
349808;202102;352590;H;4930201;1;0;1
350329;202102;352590;P;8511200;1;0;1
350620;202102;352590;G;4712100;1;0;1
350773;202102;352590;M;6920601;1;0;1
351558;202102;352590;N;8219999;1;0;1
351559;202102;352590;N;8219999;1;1;0
351574;202102;352590;H;4930202;1;0;1
351578;202102;352590;P;8512100;1;1;0
351579;202102;352590;P;8512100;2;0;2
352179;202102;352590;I;5611203;2;0;2
352536;202102;352590;C;2229302;1;1;0
352842;202102;352590;I;5611201;0;1;-1
352844;202102;352590;R;9313100;1;0;1
353121;202102;352590;S;9603301;4;1;3
353554;202102;352590;K;6422100;1;0;1
354098;202102;352590;H;5240199;1;2;-1
354100;202102;352590;Q;8630504;1;0;1
354271;202102;352590;P;8511200;0;1;-1
354559;202102;352590;M;6920601;1;1;0
355348;202102;352590;I;5611201;3;3;0
355521;202102;352590;G;4774100;0;1;-1
356221;202102;352590;N;8130300;1;0;1
356223;202102;352590;G;4781400;1;1;0
356226;202102;352590;M;7500100;0;1;-1
356453;202102;352590;I;5611201;1;1;0
357147;202102;352590;I;5620103;1;0;1
357427;202102;352590;H;4930202;2;0;2
359804;202102;352590;G;4774100;0;1;-1
360189;202102;352590;G;4729699;1;0;1
360198;202102;352590;H;5250803;1;1;0
360411;202102;352590;G;4763601;1;0;1
360527;202102;352590;G;4520005;7;11;-4
360899;202102;352590;M;7120100;3;2;1
361282;202102;352590;N;8219999;3;1;2
361382;202102;352590;G;4721104;1;2;-1
361407;202102;352590;G;4721104;1;2;-1
361755;202102;352590;H;4930202;1;0;1
361849;202102;352590;N;7911200;3;2;1
362521;202102;352590;F;4120400;5;6;-1
362975;202102;352590;G;4772500;0;1;-1
363251;202102;352590;G;4663000;6;4;2
363274;202102;352590;G;4511102;0;1;-1
363275;202102;352590;F;4321500;0;1;-1
364430;202102;352590;G;4541201;1;0;1
364481;202102;352590;Q;8711502;2;0;2
364482;202102;352590;Q;8711502;0;1;-1
364648;202102;352590;G;4752100;0;2;-2
365034;202102;352590;I;5611201;2;0;2
365491;202102;352590;F;4120400;1;0;1
365554;202102;352590;C;3250701;1;0;1
365802;202102;352590;N;8111700;3;1;2
367194;202102;352590;G;4741500;1;1;0
367233;202102;352590;G;4614100;0;1;-1
367246;202102;352590;G;4771702;2;0;2
367332;202102;352590;N;8299799;1;4;-3
367995;202102;352590;F;4222701;1;0;1
368367;202102;352590;G;4789099;2;1;1
369220;202102;352590;N;8219999;0;1;-1
369537;202102;352590;G;4754701;2;0;2
369622;202102;352590;S;9609299;1;0;1
369791;202102;352590;M;6920601;0;1;-1
370219;202102;352590;G;4744002;0;1;-1
370224;202102;352590;G;4618499;1;0;1
370376;202102;352590;G;4752100;2;1;1
370985;202102;352590;J;6209100;1;0;1
371044;202102;352590;H;4930201;0;1;-1
371046;202102;352590;H;4930201;10;2;8
371417;202102;352590;I;5611201;0;1;-1
371620;202102;352590;M;7500100;1;0;1
371870;202102;352590;G;4789002;0;1;-1
372005;202102;352590;G;4634601;4;1;3
372040;202102;352590;G;4783102;0;1;-1
372557;202102;352590;G;4789004;3;4;-1
372714;202102;352590;M;7319003;0;1;-1
372782;202102;352590;F;4399199;4;7;-3
372831;202102;352590;G;4530703;0;1;-1
373628;202102;352590;G;4687702;0;1;-1
373734;202102;352590;G;4530704;0;1;-1
373735;202102;352590;G;4713002;1;2;-1
374023;202102;352590;G;4712100;1;0;1
374501;202102;352590;H;4930201;0;1;-1
375629;202102;352590;G;4732600;0;2;-2
375704;202102;352590;G;4782201;1;1;0
375706;202102;352590;G;4782201;1;0;1
375888;202102;352590;I;5611201;0;1;-1
376177;202102;352590;G;4642701;0;1;-1
376959;202102;352590;C;2033900;1;1;0
377001;202102;352590;G;4789004;1;1;0
377130;202102;352590;N;8011101;2;4;-2
377920;202102;352590;N;8211300;1;0;1
377985;202102;352590;K;6491300;0;1;-1
378049;202102;352590;G;4774100;2;0;2
378189;202102;352590;L;6822600;2;2;0
379195;202102;352590;P;8593700;0;2;-2
379197;202102;352590;N;7911200;0;4;-4
379457;202102;352590;F;4399103;0;1;-1
379902;202102;352590;H;5112901;2;0;2
379906;202102;352590;G;4757100;0;1;-1
380068;202102;352590;N;8111700;8;1;7
380124;202102;352590;G;4781400;1;0;1
380446;202102;352590;P;8599603;1;1;0
380482;202102;352590;N;7912100;2;3;-1
380639;202102;352590;Q;8630503;1;0;1
380649;202102;352590;N;7911200;0;1;-1
381430;202102;352590;G;4724500;1;0;1
381592;202102;352590;G;4772500;0;2;-2
381825;202102;352590;L;6822600;0;1;-1
382405;202102;352590;G;4782201;0;1;-1
382465;202102;352590;S;9511800;2;0;2
382988;202102;352590;S;9602501;1;1;0
383128;202102;352590;L;6821801;1;0;1
383312;202102;352590;S;9601701;2;0;2
383401;202102;352590;F;4321500;0;1;-1
383583;202102;352590;N;8219999;0;1;-1
383592;202102;352590;G;4782201;0;1;-1
383818;202102;352590;M;6911701;1;0;1
383971;202102;352590;P;8599605;1;1;0
384245;202102;352590;G;4781400;0;1;-1
384684;202102;352590;I;5611203;3;0;3
384728;202102;352590;S;9609208;1;0;1
384804;202102;352590;H;5229002;1;0;1
385801;202102;352590;G;4751200;1;0;1
387515;202102;352590;N;8112500;0;2;-2
387877;202102;352590;C;2222600;4;5;-1
388287;202102;352590;G;4789004;1;0;1
388767;202102;352590;M;7119701;1;0;1
389237;202102;352590;G;4520002;0;1;-1
390166;202102;352590;N;8219999;1;0;1
390298;202102;352590;I;5611201;0;1;-1
390327;202102;352590;G;4520001;0;1;-1
390341;202102;352590;R;9313100;0;1;-1
390639;202102;352590;C;3212400;0;3;-3
390783;202102;352590;N;8291100;0;1;-1
391099;202102;352590;N;8112500;1;1;0
391309;202102;352590;C;3329501;2;0;2
391571;202102;352590;F;4330402;1;0;1
391708;202102;352590;P;8512100;2;0;2
391732;202102;352590;N;8220200;158;73;85
392600;202102;352590;F;4399103;2;0;2
392748;202102;352590;M;6920601;1;1;0
393436;202102;352590;G;4753900;1;1;0
393867;202102;352590;J;6202300;0;1;-1
394604;202102;352590;I;5611201;2;1;1
395014;202102;352590;G;4520002;0;2;-2
395074;202102;352590;S;9430800;2;1;1
395505;202102;352590;C;1091102;0;1;-1
396880;202102;352590;G;4789001;0;1;-1
397510;202102;352590;S;9511800;0;1;-1
397553;202102;352590;J;6204000;0;1;-1
398016;202102;352590;C;2610800;1;0;1
398043;202102;352590;G;4744099;1;0;1
398079;202102;352590;M;7119703;1;0;1
398463;202102;352590;F;4330402;2;1;1
398576;202102;352590;P;8599604;2;1;1
399578;202102;352590;G;4761001;0;1;-1
399589;202102;352590;F;4330403;0;1;-1
399791;202102;352590;I;5620104;1;0;1
400163;202102;352590;G;4722901;0;1;-1
400276;202102;352590;I;5611201;1;0;1
400638;202102;352590;J;6201501;1;0;1
401044;202102;352590;P;8593700;5;4;1
401337;202102;352590;G;4520002;0;1;-1
401405;202102;352590;N;8130300;4;14;-10
401535;202102;352590;G;4652400;0;1;-1
401536;202102;352590;G;4752100;1;2;-1
401669;202102;352590;G;4744002;0;1;-1
401764;202102;352590;F;4321500;3;2;1
401883;202102;352590;F;4120400;118;33;85
402208;202102;352590;C;2222600;1;0;1
402338;202102;352590;G;4751201;2;0;2
403795;202102;352590;F;4330405;3;4;-1
404147;202102;352590;G;4530703;2;0;2
404187;202102;352590;G;4530703;1;1;0
404560;202102;352590;C;3092000;0;1;-1
404633;202102;352590;G;4713002;2;0;2
404647;202102;352590;G;4729699;1;0;1
404829;202102;352590;P;8511200;1;0;1
404830;202102;352590;P;8511200;0;1;-1
404917;202102;352590;M;7020400;0;1;-1
405060;202102;352590;G;4530705;0;1;-1
405061;202102;352590;G;4520001;1;0;1
405063;202102;352590;H;4930201;1;2;-1
405173;202102;352590;G;4721102;3;1;2
405269;202102;352590;F;4120400;18;3;15
405298;202102;352590;H;4930202;0;1;-1
405320;202102;352590;G;4721102;1;1;0
406099;202102;352590;G;4721102;1;1;0
406509;202102;352590;G;4781400;1;1;0
406567;202102;352590;G;4781400;1;0;1
406643;202102;352590;G;4763602;0;1;-1
406777;202102;352590;I;5611203;1;1;0
407028;202102;352590;G;4789002;2;0;2
407586;202102;352590;M;7500100;1;0;1
407738;202102;352590;G;4781400;1;0;1
407957;202102;352590;M;7319003;0;1;-1
408784;202102;352590;J;6201501;3;0;3
409066;202102;352590;H;4930202;7;3;4
409228;202102;352590;Q;8712300;3;1;2
409669;202102;352590;G;4520001;0;1;-1
410300;202102;352590;C;2222600;1;0;1
411394;202102;352590;S;9491000;1;0;1
411453;202102;352590;I;5611203;1;1;0
411644;202102;352590;M;7112000;0;2;-2
412212;202102;352590;H;4930201;1;0;1
412304;202102;352590;P;8550302;9;1;8
413340;202102;352590;G;4721102;1;1;0
413348;202102;352590;L;6810202;0;1;-1
413961;202102;352590;G;4752100;1;0;1
413993;202102;352590;S;9602502;1;4;-3
414077;202102;352590;G;4530703;0;1;-1
414171;202102;352590;M;7112000;0;2;-2
414613;202102;352590;N;7820500;4;3;1
415244;202102;352590;G;4781400;0;1;-1
415767;202102;352590;P;8512100;2;1;1
415899;202102;352590;G;4721102;0;1;-1
416180;202102;352590;M;7312200;0;1;-1
416203;202102;352590;C;3313902;0;1;-1
416356;202102;352590;G;4781400;2;0;2
416485;202102;352590;S;9601701;2;0;2
416849;202102;352590;G;4712100;1;1;0
417330;202102;352590;I;5611203;1;1;0
417419;202102;352590;G;4781400;1;0;1
417447;202102;352590;G;4782202;1;1;0
417762;202102;352590;I;5611201;1;0;1
417848;202102;352590;G;4731800;0;2;-2
418797;202102;352590;C;3329599;0;1;-1
418873;202102;352590;C;2949299;10;11;-1
419003;202102;352590;C;3314707;0;1;-1
419465;202102;352590;I;5611203;2;1;1
420258;202102;352590;A;111302;0;1;-1
420634;202102;352590;I;5611201;1;0;1
420818;202102;352590;N;8111700;3;4;-1
421147;202102;352590;G;4669999;0;4;-4
421162;202102;352590;M;6920601;1;0;1
421428;202102;352590;L;6821802;2;1;1
423204;202102;352590;G;4754701;0;1;-1
423284;202102;352590;N;8112500;1;0;1
423285;202102;352590;N;8112500;0;3;-3
423358;202102;352590;N;8220200;0;1;-1
423712;202102;352590;G;4642702;1;0;1
424754;202102;352590;S;9602502;1;0;1
425220;202102;352590;N;8211300;1;0;1
425260;202102;352590;G;4771701;1;1;0
426208;202102;352590;G;4789099;0;3;-3
426392;202102;352590;I;5611201;0;1;-1
426399;202102;352590;G;4721102;0;1;-1
427011;202102;352590;H;4930202;31;9;22
427404;202102;352590;C;1091102;0;1;-1
428111;202102;352590;G;4672900;1;0;1
428211;202102;352590;N;8121400;2;0;2
428238;202102;352590;S;9512600;1;0;1
428388;202102;352590;H;4930202;1;0;1
428391;202102;352590;G;4789001;0;1;-1
428473;202102;352590;L;6821802;1;2;-1
428819;202102;352590;N;8130300;0;3;-3
428936;202102;352590;F;4399199;3;1;2
429129;202102;352590;M;6920601;1;0;1
430278;202102;352590;H;4930202;2;1;1
430380;202102;352590;G;4781400;1;0;1
430950;202102;352590;P;8511200;3;1;2
431875;202102;352590;G;4530703;1;1;0
432074;202102;352590;G;4752100;1;0;1
432266;202102;352590;G;4789002;0;1;-1
432570;202102;352590;F;4322302;1;0;1
432913;202102;352590;G;4645101;8;4;4
434688;202102;352590;G;4789001;0;1;-1
435237;202102;352590;G;4721102;4;0;4
435238;202102;352590;G;4721102;0;1;-1
435618;202102;352590;N;8121400;5;2;3
435995;202102;352590;G;4781400;0;1;-1
436157;202102;352590;G;4789099;0;1;-1
436906;202102;352590;M;6920601;2;1;1
437377;202102;352590;G;4631100;1;1;0
437544;202102;352590;M;7112000;3;1;2
437984;202102;352590;H;5212500;1;5;-4
438066;202102;352590;M;7020400;0;1;-1
438133;202102;352590;G;4731800;2;1;1
438229;202102;352590;C;1412601;3;5;-2
438372;202102;352590;F;4321500;1;0;1
438420;202102;352590;G;4713004;0;2;-2
438642;202102;352590;P;8599603;1;2;-1
439046;202102;352590;P;8512100;2;0;2
439131;202102;352590;G;4774100;1;0;1
439258;202102;352590;C;2950600;2;1;1
439337;202102;352590;G;4520001;2;2;0
439609;202102;352590;G;4744001;3;0;3
439624;202102;352590;L;6822600;1;0;1
439817;202102;352590;G;4752100;1;0;1
439932;202102;352590;F;4330403;0;2;-2
440893;202102;352590;J;6209100;1;0;1
441332;202102;352590;C;3314719;3;2;1
441382;202102;352590;G;4754701;1;0;1
441731;202102;352590;G;4731800;1;0;1
441763;202102;352590;I;5611201;0;1;-1
441875;202102;352590;Q;8630504;1;0;1
441917;202102;352590;R;9313100;1;1;0
442059;202102;352590;G;4649499;0;1;-1
442312;202102;352590;P;8599604;2;0;2
442393;202102;352590;M;7020400;1;0;1
442588;202102;352590;M;7490104;1;0;1
442589;202102;352590;M;7490104;1;0;1
442717;202102;352590;N;8211300;0;1;-1
442793;202102;352590;P;8512100;3;0;3
442794;202102;352590;M;7120100;1;0;1
442833;202102;352590;P;8512100;2;0;2
443114;202102;352590;G;4729699;2;36;-34
443245;202102;352590;F;4313400;0;1;-1
443258;202102;352590;G;4520001;2;0;2
443906;202102;352590;I;5611201;0;1;-1
444158;202102;352590;G;4781400;1;1;0
444299;202102;352590;S;9602502;1;0;1
444378;202102;352590;N;8111700;0;2;-2
444990;202102;352590;H;4930202;1;0;1
445145;202102;352590;F;4291000;3;1;2
445662;202102;352590;G;4679699;0;1;-1
446542;202102;352590;G;4789099;1;0;1
446869;202102;352590;I;5620101;11;14;-3
446872;202102;352590;I;5620101;9;8;1
446875;202102;352590;I;5620101;5;3;2
446879;202102;352590;I;5620101;3;0;3
448030;202102;352590;G;4753900;0;1;-1
448065;202102;352590;H;5229002;1;0;1
448155;202102;352590;C;3314708;1;0;1
448372;202102;352590;G;4633801;2;0;2
448722;202102;352590;I;5611203;1;0;1
449359;202102;352590;G;4646001;1;1;0
449590;202102;352590;H;5211701;9;8;1
449625;202102;352590;P;8511200;2;0;2
450342;202102;352590;G;4712100;1;0;1
450411;202102;352590;M;7490104;0;1;-1
450697;202102;352590;P;8512100;1;1;0
450850;202102;352590;H;4930202;2;1;1
450860;202102;352590;H;4930202;1;0;1
451017;202102;352590;G;4754701;0;3;-3
451228;202102;352590;N;8220200;69;139;-70
451231;202102;352590;N;8211300;0;7;-7
451562;202102;352590;G;4781400;1;0;1
451834;202102;352590;J;6209100;1;3;-2
452621;202102;352590;G;4783101;0;2;-2
453046;202102;352590;C;2229399;2;1;1
453610;202102;352590;M;6911701;1;0;1
453902;202102;352590;G;4772500;0;2;-2
454199;202102;352590;H;5212500;0;1;-1
455400;202102;352590;H;4930201;26;39;-13
455424;202102;352590;Q;8630502;2;1;1
455520;202102;352590;F;4221904;0;11;-11
455692;202102;352590;P;8513900;4;2;2
455733;202102;352590;H;4930201;0;1;-1
457073;202102;352590;R;9313100;0;1;-1
457365;202102;352590;M;6920601;3;0;3
457572;202102;352590;G;4679603;1;1;0
457898;202102;352590;G;4721102;0;1;-1
457900;202102;352590;N;8299799;34;16;18
457978;202102;352590;F;4399103;1;0;1
457996;202102;352590;N;8111700;5;2;3
458334;202102;352590;G;4633801;4;0;4
458443;202102;352590;H;4930202;6;7;-1
458749;202102;352590;G;4530703;0;1;-1
459356;202102;352590;G;4520003;1;0;1
459852;202102;352590;G;4711302;1;2;-1
460327;202102;352590;C;2391503;2;0;2
460751;202102;352590;P;8599604;9;11;-2
461025;202102;352590;G;4751201;0;1;-1
461909;202102;352590;G;4639701;6;15;-9
462134;202102;352590;G;4520007;3;0;3
462439;202102;352590;N;8111700;2;3;-1
462850;202102;352590;F;4330499;0;1;-1
463051;202102;352590;C;3313999;1;0;1
463169;202102;352590;G;4520004;1;0;1
463180;202102;352590;C;1095300;0;74;-74
464400;202102;352590;G;4753900;8;7;1
464431;202102;352590;G;4530704;2;2;0
464623;202102;352590;G;4530703;1;0;1
465291;202102;352590;G;4781400;1;0;1
465331;202102;352590;G;4781400;0;1;-1
465406;202102;352590;H;4930202;1;0;1
466271;202102;352590;G;4759899;1;2;-1
467046;202102;352590;N;8219999;1;0;1
467967;202102;352590;J;6209100;11;1;10
468059;202102;352590;C;2941700;2;0;2
468406;202102;352590;M;7112000;2;0;2
468590;202102;352590;N;8211300;3;0;3
468591;202102;352590;L;6821802;1;1;0
468618;202102;352590;G;4781400;1;0;1
468998;202102;352590;Q;8630502;1;0;1
469098;202102;352590;F;4312600;1;2;-1
469487;202102;352590;I;5611201;0;2;-2
469564;202102;352590;I;5611203;2;1;1
469567;202102;352590;I;5611203;3;4;-1
469568;202102;352590;I;5611203;0;1;-1
469570;202102;352590;I;5611203;4;5;-1
469641;202102;352590;G;4781400;0;1;-1
469776;202102;352590;N;8211300;1;0;1
470991;202102;352590;G;4789099;1;0;1
471308;202102;352590;G;4723700;1;0;1
471348;202102;352590;G;4646001;4;0;4
471381;202102;352590;C;3314707;0;3;-3
471465;202102;352590;G;4781400;1;0;1
471631;202102;352590;H;4930202;0;1;-1
472501;202102;352590;K;6622300;1;0;1
473406;202102;352590;J;6319400;2;1;1
473825;202102;352590;G;4782201;0;1;-1
473833;202102;352590;Q;8711502;0;1;-1
474005;202102;352590;G;4530703;0;1;-1
475708;202102;352590;G;4530705;2;1;1
476523;202102;352590;G;4722901;0;1;-1
476882;202102;352590;F;4292801;0;1;-1
477016;202102;352590;N;8112500;0;1;-1
477069;202102;352590;C;2943300;0;1;-1
477180;202102;352590;G;4759899;1;0;1
478373;202102;352590;M;6920601;0;1;-1
478457;202102;352590;F;4330404;0;2;-2
479311;202102;352590;P;8599603;0;2;-2
479325;202102;352590;G;4781400;0;2;-2
479654;202102;352590;G;4781400;0;1;-1
480195;202102;352590;I;5611201;2;4;-2
480571;202102;352590;I;5620104;1;0;1
481779;202102;352590;G;4759899;2;0;2
481956;202102;352590;G;4772500;1;1;0
482643;202102;352590;H;5250804;0;6;-6
483749;202102;352590;C;2542000;0;1;-1
483798;202102;352590;C;3321000;1;0;1
483889;202102;352590;S;9602501;0;2;-2
484148;202102;352590;P;8511200;0;1;-1
484301;202102;352590;I;5620101;1;0;1
484707;202102;352590;G;4789099;1;0;1
485402;202102;352590;F;4120400;0;1;-1
485441;202102;352590;G;4646001;1;0;1
485743;202102;352590;S;9602502;1;0;1
485817;202102;352590;E;3812200;1;0;1
485881;202102;352590;G;4724500;1;0;1
486567;202102;352590;C;1069400;0;2;-2
486898;202102;352590;G;4541205;0;1;-1
487925;202102;352590;Q;8630504;0;1;-1
488230;202102;352590;F;4321500;1;1;0
488244;202102;352590;G;4789099;1;0;1
488399;202102;352590;G;4761001;1;0;1
488465;202102;352590;F;4330404;0;1;-1
488919;202102;352590;I;5611203;0;1;-1
489051;202102;352590;G;4729699;0;1;-1
489052;202102;352590;G;4729699;1;0;1
489120;202102;352590;S;9601701;0;1;-1
489511;202102;352590;H;5250804;7;6;1
489966;202102;352590;C;1821100;2;1;1
490069;202102;352590;N;8291100;1;0;1
490241;202102;352590;G;4721102;0;1;-1
490412;202102;352590;N;8111700;0;2;-2
490602;202102;352590;N;8011101;1;0;1
490625;202102;352590;M;7500100;2;0;2
490645;202102;352590;I;5611201;5;1;4
490653;202102;352590;H;5223100;0;1;-1
490954;202102;352590;S;9602501;0;1;-1
491078;202102;352590;G;4724500;0;1;-1
491341;202102;352590;G;4729602;0;1;-1
491346;202102;352590;G;4729602;6;0;6
491360;202102;352590;G;4712100;5;0;5
491509;202102;352590;G;4520003;1;0;1
491847;202102;352590;G;4721103;1;1;0
492273;202102;352590;P;8511200;1;1;0
492313;202102;352590;G;4781400;1;1;0
493175;202102;352590;F;4292802;34;16;18
493286;202102;352590;G;4782201;0;1;-1
493406;202102;352590;I;5611203;3;1;2
493494;202102;352590;G;4520006;4;1;3
493687;202102;352590;N;8111700;0;4;-4
493958;202102;352590;G;4721102;1;0;1
494921;202102;352590;J;6319400;1;0;1
495345;202102;352590;L;6821801;1;0;1
495479;202102;352590;M;7319003;1;3;-2
495573;202102;352590;F;4120400;0;2;-2
495895;202102;352590;G;4789001;1;0;1
496267;202102;352590;G;4686902;1;0;1
496561;202102;352590;C;3314713;4;0;4
496686;202102;352590;I;5611201;1;0;1
496687;202102;352590;I;5611201;0;2;-2
496718;202102;352590;J;6319400;1;1;0
497746;202102;352590;G;4771701;2;2;0
497747;202102;352590;G;4771701;1;1;0
497823;202102;352590;M;6920601;3;1;2
498457;202102;352590;F;4330403;2;0;2
498461;202102;352590;F;4292801;1;0;1
498899;202102;352590;H;4930202;7;3;4
499587;202102;352590;I;5611201;1;2;-1
500147;202102;352590;I;5611201;1;0;1
500220;202102;352590;G;4754703;1;0;1
500332;202102;352590;I;5611203;1;0;1
500614;202102;352590;G;4712100;1;0;1
500681;202102;352590;R;9321200;0;1;-1
500926;202102;352590;N;8299799;1;0;1
501261;202102;352590;F;4321500;0;1;-1
501960;202102;352590;H;4930202;0;2;-2
502187;202102;352590;K;6462000;0;6;-6
502321;202102;352590;G;4789004;1;1;0
502344;202102;352590;H;5320202;1;0;1
502744;202102;352590;G;4789004;3;2;1
502886;202102;352590;H;4930202;1;0;1
503420;202102;352590;M;7490104;2;1;1
503852;202102;352590;I;5611203;1;0;1
503951;202102;352590;P;8593700;1;0;1
504156;202102;352590;N;8121400;0;1;-1
504413;202102;352590;M;7112000;0;1;-1
504414;202102;352590;I;5611203;0;1;-1
505314;202102;352590;F;4120400;0;1;-1
505377;202102;352590;G;4755501;1;0;1
505685;202102;352590;M;6911701;0;1;-1
505752;202102;352590;C;2512800;1;0;1
505825;202102;352590;F;4330404;0;3;-3
506178;202102;352590;G;4722901;1;1;0
506419;202102;352590;C;2511000;2;1;1
506538;202102;352590;J;6201501;1;0;1
506800;202102;352590;G;4687702;2;1;1
506889;202102;352590;G;4693100;0;3;-3
507090;202102;352590;M;7020400;0;1;-1
507483;202102;352590;N;8299799;5;0;5
507484;202102;352590;N;8299799;0;1;-1
508127;202102;352590;G;4744005;0;1;-1
508802;202102;352590;Q;8640202;3;1;2
508813;202102;352590;G;4711302;2;1;1
508946;202102;352590;G;4664800;0;1;-1
509165;202102;352590;G;4721102;0;1;-1
509254;202102;352590;N;7820500;12;5;7
510446;202102;352590;N;7729299;2;2;0
510751;202102;352590;G;4789004;1;0;1
510846;202102;352590;F;4120400;1;2;-1
511472;202102;352590;G;4771701;1;0;1
512104;202102;352590;I;5611201;3;1;2
512183;202102;352590;I;5611201;0;1;-1
512453;202102;352590;F;4330404;0;1;-1
512718;202102;352590;I;5611203;0;1;-1
513951;202102;352590;N;7739099;1;0;1
514153;202102;352590;H;4930202;2;1;1
514591;202102;352590;P;8593700;0;1;-1
514984;202102;352590;M;7112000;0;2;-2
515414;202102;352590;G;4729602;1;0;1
515783;202102;352590;N;8121400;0;1;-1
515961;202102;352590;I;5611201;0;1;-1
516032;202102;352590;G;4520002;0;1;-1
516279;202102;352590;H;4930201;1;0;1
516314;202102;352590;H;5240101;1;1;0
516324;202102;352590;K;6622300;2;0;2
516456;202102;352590;R;9321200;2;0;2
517469;202102;352590;I;5611203;0;1;-1
517810;202102;352590;G;4757100;0;1;-1
517958;202102;352590;C;3314707;2;0;2
518061;202102;352590;Q;8640202;0;2;-2
518129;202102;352590;Q;8630504;5;1;4
518267;202102;352590;C;2542000;0;1;-1
518281;202102;352590;I;5620104;2;0;2
518401;202102;352590;G;4729699;1;1;0
518466;202102;352590;G;4772500;1;0;1
519301;202102;352590;M;6920601;1;0;1
519353;202102;352590;Q;8711502;3;1;2
519446;202102;352590;I;5611201;0;1;-1
520356;202102;352590;G;4789099;1;1;0
520477;202102;352590;I;5611203;1;0;1
520808;202102;352590;N;8111700;0;5;-5
521071;202102;352590;H;5223100;4;0;4
521228;202102;352590;J;6110803;1;0;1
521681;202102;352590;I;5620104;5;0;5
522059;202102;352590;P;8599604;3;1;2
522251;202102;352590;I;5620101;0;1;-1
522252;202102;352590;I;5620101;3;2;1
522360;202102;352590;F;4120400;7;7;0
523215;202102;352590;G;4729602;1;1;0
523819;202102;352590;P;8512100;8;1;7
524037;202102;352590;H;5212500;10;5;5
524385;202102;352590;C;1053800;1;4;-3
524594;202102;352590;G;4789099;1;0;1
524596;202102;352590;G;4752100;0;1;-1
524610;202102;352590;G;4752100;0;2;-2
524635;202102;352590;G;4721102;0;1;-1
524684;202102;352590;I;5611201;5;1;4
524765;202102;352590;S;9511800;1;0;1
525063;202102;352590;G;4781400;0;1;-1
525312;202102;352590;G;4723700;0;1;-1
526539;202102;352590;R;9313100;0;1;-1
526873;202102;352590;M;7112000;0;2;-2
526922;202102;352590;J;6311900;1;0;1
527309;202102;352590;G;4712100;2;2;0
527419;202102;352590;I;5611201;1;1;0
527896;202102;352590;P;8599605;0;2;-2
528798;202102;352590;N;8111700;0;1;-1
528906;202102;352590;Q;8630504;1;0;1
529277;202102;352590;P;8593700;0;2;-2
529664;202102;352590;G;4772500;5;1;4
530013;202102;352590;I;5611203;1;0;1
531472;202102;352590;M;7112000;2;1;1
531723;202102;352590;G;4781400;1;0;1
532208;202102;352590;F;4399199;1;2;-1
532360;202102;352590;H;4930201;2;0;2
532989;202102;352590;J;6209100;0;2;-2
533466;202102;352590;G;4721102;2;1;1
534104;202102;352590;G;4744001;0;1;-1
534295;202102;352590;Q;8630502;0;1;-1
534759;202102;352590;K;6622300;2;0;2
534880;202102;352590;I;5611201;1;0;1
535502;202102;352590;N;8111700;1;0;1
535659;202102;352590;N;8291100;2;3;-1
535834;202102;352590;G;4729699;1;1;0
535854;202102;352590;I;5611201;1;0;1
536057;202102;352590;K;6491300;1;0;1
536737;202102;352590;C;2521700;1;0;1
536872;202102;352590;I;5611201;0;1;-1
537219;202102;352590;P;8512100;2;1;1
537585;202102;352590;I;5611201;0;1;-1
538084;202102;352590;S;9602502;0;1;-1
538116;202102;352590;G;4744099;0;1;-1
538139;202102;352590;G;4511101;1;1;0
538274;202102;352590;H;4930202;1;1;0
539366;202102;352590;N;8299799;0;2;-2
539614;202102;352590;P;8511200;1;2;-1
539620;202102;352590;N;8211300;1;0;1
539823;202102;352590;C;1091102;1;0;1
539877;202102;352590;G;4772500;1;1;0
540336;202102;352590;G;4723700;1;1;0
540857;202102;352590;J;6110803;0;1;-1
541026;202102;352590;H;4930202;1;0;1
541204;202102;352590;J;6204000;1;0;1
541432;202102;352590;P;8512100;2;0;2
541452;202102;352590;N;8291100;1;0;1
541868;202102;352590;H;4930202;1;0;1
542097;202102;352590;R;9313100;2;0;2
542114;202102;352590;H;4930202;1;0;1
542455;202102;352590;C;1412601;2;2;0
542683;202102;352590;S;9601703;12;14;-2
543167;202102;352590;H;4930202;0;2;-2
543219;202102;352590;P;8599601;2;0;2
543425;202102;352590;C;3314799;0;2;-2
543453;202102;352590;G;4781400;0;1;-1
543793;202102;352590;N;7732201;2;1;1
544231;202102;352590;N;8219999;1;0;1
544343;202102;352590;C;2543800;0;1;-1
544950;202102;352590;N;8211300;0;1;-1
546553;202102;352590;S;9602501;2;0;2
546554;202102;352590;G;4781400;2;1;1
546560;202102;352590;J;6202300;2;1;1
547109;202102;352590;G;4781400;0;1;-1
547608;202102;352590;N;8230001;1;0;1
547614;202102;352590;G;4729699;1;0;1
547715;202102;352590;P;8512100;4;1;3
547908;202102;352590;I;5611201;1;0;1
547909;202102;352590;I;5611201;2;0;2
548021;202102;352590;M;7112000;2;0;2
548457;202102;352590;G;4712100;1;0;1
548519;202102;352590;G;4771701;1;0;1
548592;202102;352590;G;4782201;1;0;1
549135;202102;352590;M;7112000;1;7;-6
549648;202102;352590;N;8230001;1;0;1
549826;202102;352590;N;8211300;1;0;1
550054;202102;352590;I;5620101;0;1;-1
550175;202102;352590;G;4781400;2;0;2
550204;202102;352590;G;4711301;5;8;-3
550399;202102;352590;L;6821802;1;0;1
550647;202102;352590;Q;8630504;1;1;0
550869;202102;352590;G;4781400;0;1;-1
551122;202102;352590;G;4511102;0;1;-1
551162;202102;352590;I;5611201;0;2;-2
552353;202102;352590;G;4744099;1;0;1
552354;202102;352590;G;4783101;0;2;-2
553163;202102;352590;I;5611202;0;1;-1
553188;202102;352590;P;8511200;0;4;-4
553245;202102;352590;M;7119701;1;0;1
553269;202102;352590;S;9529199;0;2;-2
553405;202102;352590;M;7112000;1;0;1
553806;202102;352590;G;4711302;4;1;3
554071;202102;352590;P;8599699;2;1;1
554199;202102;352590;I;5611201;3;0;3
554534;202102;352590;R;9313100;1;1;0
555078;202102;352590;Q;8640299;1;0;1
555399;202102;352590;H;4930202;0;2;-2
555402;202102;352590;E;3811400;1;1;0
555608;202102;352590;G;4731800;0;1;-1
555995;202102;352590;Q;8630503;1;0;1
556100;202102;352590;G;4520005;0;2;-2
557026;202102;352590;G;4781400;5;1;4
557541;202102;352590;P;8513900;0;1;-1
557644;202102;352590;N;7911200;0;1;-1
558213;202102;352590;G;4781400;0;2;-2
558505;202102;352590;H;5320202;6;3;3
558635;202102;352590;G;4782202;1;0;1
558842;202102;352590;G;4530703;0;1;-1
559154;202102;352590;F;4321500;0;1;-1
559630;202102;352590;G;4530702;1;0;1
559668;202102;352590;P;8593700;0;2;-2
560027;202102;352590;G;4782201;3;3;0
561829;202102;352590;N;8111700;3;0;3
561830;202102;352590;N;8111700;0;2;-2
561885;202102;352590;P;8599604;0;1;-1
561977;202102;352590;N;7810800;2;6;-4
562253;202102;352590;N;8121400;3;1;2
562671;202102;352590;G;4789001;0;1;-1
563042;202102;352590;F;4299599;2;1;1
563276;202102;352590;F;4120400;4;0;4
563408;202102;352590;G;4639701;22;7;15
563808;202102;352590;P;8599699;0;1;-1
564111;202102;352590;N;7739099;13;7;6
564349;202102;352590;G;4713002;1;0;1
564507;202102;352590;G;4637199;10;3;7
565775;202102;352590;I;5620103;3;1;2
565776;202102;352590;I;5620103;0;1;-1
565777;202102;352590;I;5620103;0;1;-1
565803;202102;352590;Q;8630504;1;1;0
566824;202102;352590;P;8599604;4;2;2
567590;202102;352590;M;7119701;0;1;-1
568071;202102;352590;Q;8630503;1;1;0
568096;202102;352590;P;8599603;0;1;-1
568111;202102;352590;G;4723700;1;0;1
568569;202102;352590;G;4723700;1;0;1
568878;202102;352590;G;4744005;1;0;1
569000;202102;352590;G;4729699;1;0;1
569635;202102;352590;N;7732201;0;2;-2
570501;202102;352590;H;4930201;0;1;-1
570690;202102;352590;M;7319002;1;0;1
571224;202102;352590;H;5229099;3;0;3
571653;202102;352590;G;4642701;0;1;-1
572024;202102;352590;H;4930201;0;1;-1
573038;202102;352590;M;7490104;0;1;-1
573182;202102;352590;I;5620104;2;0;2
573575;202102;352590;I;5611203;1;1;0
573638;202102;352590;N;8111700;1;2;-1
574248;202102;352590;S;9499500;0;4;-4
574687;202102;352590;I;5611201;1;0;1
575090;202102;352590;I;5611203;1;0;1
575859;202102;352590;G;4789002;9;3;6
576775;202102;352590;G;4771701;1;0;1
577092;202102;352590;G;4781400;3;2;1
577212;202102;352590;G;4741500;1;0;1
578091;202102;352590;G;4781400;6;1;5
578683;202102;352590;I;5611203;0;1;-1
578932;202102;352590;I;5611203;1;0;1
579037;202102;352590;G;4744005;0;1;-1
579649;202102;352590;G;4712100;1;0;1
580364;202102;352590;G;4771701;1;0;1
580700;202102;352590;G;4782201;1;0;1
580789;202102;352590;K;6622300;1;0;1
580928;202102;352590;P;8512100;1;1;0
580978;202102;352590;G;4711302;1;1;0
581280;202102;352590;M;7112000;7;4;3
582827;202102;352590;G;4773300;1;0;1
583009;202102;352590;L;6821801;0;1;-1
584649;202102;352590;G;4752100;0;1;-1
584816;202102;352590;H;4930202;1;0;1
584858;202102;352590;N;8219999;1;0;1
585511;202102;352590;G;4789001;0;1;-1
585739;202102;352590;I;5611201;1;2;-1
585846;202102;352590;I;5611203;0;1;-1
586053;202102;352590;N;8219999;1;0;1
586961;202102;352590;S;9601701;2;0;2
587696;202102;352590;G;4752100;1;0;1
587749;202102;352590;L;6822600;1;0;1
588152;202102;352590;H;4930202;1;1;0
588395;202102;352590;H;4930202;1;0;1
588883;202102;352590;N;8111700;6;5;1
589137;202102;352590;I;5611201;1;0;1
589833;202102;352590;N;8219999;1;1;0
589945;202102;352590;C;3314707;0;2;-2
590164;202102;352590;N;8299799;0;1;-1
591172;202102;352590;P;8512100;3;0;3
591204;202102;352590;H;4930201;1;0;1
591401;202102;352590;M;7119701;1;3;-2
591426;202102;352590;G;4520006;3;0;3
592165;202102;352590;N;8211300;1;2;-1
592826;202102;352590;N;8230001;7;1;6
592920;202102;352590;G;4711302;0;2;-2
593149;202102;352590;N;7722500;1;2;-1
594450;202102;352590;I;5611201;1;0;1
594582;202102;352590;G;4753900;1;0;1
594777;202102;352590;G;4753900;26;52;-26
594778;202102;352590;G;4753900;3;4;-1
594779;202102;352590;G;4753900;3;3;0
594780;202102;352590;G;4753900;2;1;1
595160;202102;352590;G;4753900;40;21;19
595183;202102;352590;G;4753900;3;1;2
595223;202102;352590;G;4753900;0;4;-4
595785;202102;352590;N;7820500;37;39;-2
595846;202102;352590;G;4712100;1;4;-3
595847;202102;352590;G;4712100;0;5;-5
596397;202102;352590;C;3101200;1;0;1
596612;202102;352590;C;1812100;0;1;-1
596743;202102;352590;G;4744099;1;0;1
597231;202102;352590;G;4744001;2;0;2
597609;202102;352590;I;5611201;4;0;4
597643;202102;352590;H;4930202;6;1;5
598172;202102;352590;G;4781400;1;0;1
598266;202102;352590;G;4781400;2;2;0
598516;202102;352590;H;5320201;1;0;1
598685;202102;352590;G;4744001;1;0;1
599010;202102;352590;G;4781400;0;1;-1
599498;202102;352590;G;4744005;1;1;0
599542;202102;352590;G;4752100;2;1;1
599711;202102;352590;H;4930202;3;1;2
600375;202102;352590;G;4781400;0;1;-1
600554;202102;352590;F;4330404;2;1;1
600731;202102;352590;I;5611201;0;1;-1
600964;202102;352590;C;2311700;0;1;-1
601532;202102;352590;G;4684299;0;2;-2
601874;202102;352590;C;2599399;17;6;11
602493;202102;352590;C;1091102;1;1;0
604839;202102;352590;C;2812700;0;3;-3
605400;202102;352590;Q;8630504;0;1;-1
605987;202102;352590;C;2099199;1;0;1
606094;202102;352590;L;6822600;1;0;1
607037;202102;352590;M;6911701;2;0;2
607334;202102;352590;P;8513900;3;0;3
607611;202102;352590;I;5611203;0;1;-1
607890;202102;352590;I;5611203;2;0;2
608152;202102;352590;F;4110700;1;0;1
608332;202102;352590;G;4712100;1;0;1
609582;202102;352590;I;5611201;1;0;1
609771;202102;352590;P;8512100;3;0;3
610556;202102;352590;G;4774100;0;1;-1
610729;202102;352590;G;4724500;1;0;1
610747;202102;352590;M;7119701;0;2;-2
610884;202102;352590;Q;8630504;1;1;0
611105;202102;352590;Q;8711502;5;3;2
611613;202102;352590;G;4752100;1;0;1
612115;202102;352590;F;4399103;1;0;1
612256;202102;352590;G;4782201;2;0;2
612897;202102;352590;H;5310501;0;1;-1
613499;202102;352590;H;5310501;0;1;-1
613562;202102;352590;H;5310501;0;1;-1
614200;202102;352590;K;6622300;1;0;1
616183;202102;352590;J;5813100;1;0;1
616836;202102;352590;G;4712100;1;1;0
617228;202102;352590;F;4299599;1;0;1
617446;202102;352590;P;8532500;1;0;1
617691;202102;352590;G;4731800;3;0;3
617849;202102;352590;G;4520002;2;0;2
618585;202102;352590;G;4763602;0;5;-5
618799;202102;352590;Q;8640202;8;4;4
618957;202102;352590;I;5611203;0;1;-1
619131;202102;352590;Q;8630503;1;0;1
619313;202102;352590;S;9602502;1;0;1
619956;202102;352590;G;4785799;2;2;0
621318;202102;352590;H;5229099;9;9;0
621621;202102;352590;G;4753900;1;0;1
622002;202102;352590;P;8593700;2;2;0
622466;202102;352590;G;4712100;1;0;1
622666;202102;352590;N;8121400;5;2;3
623100;202102;352590;F;4330404;1;0;1
623302;202102;352590;C;1721400;1;0;1
623534;202102;352590;G;4789004;1;0;1
623667;202102;352590;P;8599604;1;1;0
623713;202102;352590;H;4930201;0;1;-1
623852;202102;352590;F;4120400;0;2;-2
624105;202102;352590;G;4721102;4;0;4
624590;202102;352590;I;5620103;2;0;2
624912;202102;352590;G;4669999;6;3;3
624913;202102;352590;G;4669999;1;0;1
625006;202102;352590;G;4729602;0;1;-1
625155;202102;352590;I;5620104;6;3;3
625813;202102;352590;I;5611201;1;0;1
626718;202102;352590;I;5611203;1;0;1
626972;202102;352590;I;5611203;0;1;-1
627815;202102;352590;P;8513900;2;0;2
627847;202102;352590;C;2599302;10;3;7
627922;202102;352590;N;8211300;3;1;2
628346;202102;352590;I;5611201;2;0;2
628953;202102;352590;I;5611201;2;3;-1
629656;202102;352590;G;4782201;0;1;-1
630103;202102;352590;I;5620104;2;0;2
630533;202102;352590;N;8211300;1;0;1
631039;202102;352590;G;4763602;0;1;-1
631585;202102;352590;C;1091102;2;0;2
631616;202102;352590;I;5620101;2;2;0
632396;202102;352590;G;4771701;0;1;-1
632420;202102;352590;N;8230001;2;10;-8
632657;202102;352590;C;1813099;1;0;1
632818;202102;352590;N;8211300;9;2;7
633110;202102;352590;G;4774100;0;1;-1
633373;202102;352590;R;9313100;2;0;2
633444;202102;352590;G;4713002;0;1;-1
633704;202102;352590;C;3092000;2;0;2
633719;202102;352590;G;4774100;0;1;-1
633722;202102;352590;G;4774100;1;1;0
634197;202102;352590;G;4721102;2;0;2
634356;202102;352590;G;4511101;1;0;1
635104;202102;352590;I;5611201;1;1;0
635893;202102;352590;R;9329899;0;1;-1
636122;202102;352590;G;4781400;0;1;-1
636718;202102;352590;G;4731800;2;0;2
636744;202102;352590;R;9313100;3;1;2
637519;202102;352590;N;8211300;4;2;2
637606;202102;352590;I;5611201;1;0;1
637615;202102;352590;R;9319199;0;3;-3
637986;202102;352590;G;4781400;2;2;0
637987;202102;352590;G;4781400;1;0;1
637988;202102;352590;G;4781400;1;2;-1
638889;202102;352590;P;8541400;5;0;5
638904;202102;352590;P;8513900;4;0;4
639191;202102;352590;I;5620104;1;0;1
639756;202102;352590;G;4744099;1;0;1
640790;202102;352590;H;5320201;4;0;4
640803;202102;352590;M;7311400;1;0;1
640954;202102;352590;I;5611201;0;1;-1
642448;202102;352590;I;5611203;1;0;1
642544;202102;352590;S;9609208;1;1;0
643877;202102;352590;G;4520005;1;0;1
643878;202102;352590;S;9601701;1;0;1
643895;202102;352590;H;4930201;0;2;-2
644275;202102;352590;S;9602502;1;0;1
644684;202102;352590;K;6492100;1;0;1
645399;202102;352590;G;4712100;0;2;-2
645541;202102;352590;J;6203100;0;1;-1
645602;202102;352590;F;4329199;1;6;-5
645656;202102;352590;I;5611201;1;3;-2
645697;202102;352590;G;4744005;1;0;1
645741;202102;352590;Q;8630504;1;0;1
645984;202102;352590;I;5611201;0;1;-1
646427;202102;352590;N;8292000;2;0;2
646739;202102;352590;N;8111700;7;1;6
646762;202102;352590;C;1091102;1;1;0
647811;202102;352590;N;8291100;25;9;16
649278;202102;352590;F;4313400;8;0;8
649753;202102;352590;G;4723700;0;1;-1
649833;202102;352590;G;4759899;0;2;-2
650001;202102;352590;G;4744003;1;0;1
650447;202102;352590;Q;8711502;1;0;1
650866;202102;352590;G;4520001;0;1;-1
652748;202102;352590;H;4930202;2;0;2
653848;202102;352590;G;4721104;0;1;-1
654424;202102;352590;M;7319002;3;2;1
654610;202102;352590;C;3299003;1;0;1
655119;202102;352590;C;3329501;1;0;1
655690;202102;352590;G;4754701;1;1;0
656035;202102;352590;G;4530703;1;0;1
656505;202102;352590;G;4530703;1;0;1
656535;202102;352590;N;8111700;1;0;1
656918;202102;352590;G;4723700;0;1;-1
658660;202102;352590;S;9602502;0;1;-1
658952;202102;352590;G;4744001;2;0;2
659839;202102;352590;I;5611203;4;0;4
660293;202102;352590;G;4789001;1;0;1
660296;202102;352590;I;5611203;1;1;0
660607;202102;352590;H;5320201;0;1;-1
660938;202102;352590;G;4721104;1;0;1
660939;202102;352590;G;4721104;0;1;-1
661147;202102;352590;G;4789099;0;1;-1
661343;202102;352590;N;8219999;1;0;1
661717;202102;352590;R;9313100;2;0;2
661751;202102;352590;I;5611203;1;0;1
661926;202102;352590;P;8599604;0;2;-2
661938;202102;352590;N;8211300;1;0;1
662176;202102;352590;M;6920601;2;0;2
662343;202102;352590;G;4729699;1;1;0
662771;202102;352590;N;8291100;1;0;1
662979;202102;352590;G;4781400;1;0;1
663435;202102;352590;M;7112000;1;0;1
663747;202102;352590;G;4729602;1;1;0
665707;202102;352590;G;4744005;3;1;2
666010;202102;352590;G;4781400;1;1;0
666089;202102;352590;P;8599699;1;0;1
668731;202102;352590;G;4729699;2;0;2
669032;202102;352590;M;7490104;8;0;8
669057;202102;352590;C;1091102;1;0;1
669248;202102;352590;H;5320202;0;1;-1
669333;202102;352590;G;4686902;5;2;3
669404;202102;352590;N;8211300;3;2;1
669451;202102;352590;S;9602502;2;0;2
669503;202102;352590;J;6209100;5;10;-5
669734;202102;352590;S;9602502;3;1;2
670685;202102;352590;G;4712100;0;2;-2
670774;202102;352590;C;1091102;0;1;-1
670872;202102;352590;G;4789001;1;0;1
671130;202102;352590;I;5611204;5;1;4
671214;202102;352590;G;4723700;1;0;1
671854;202102;352590;G;4520001;2;0;2
673093;202102;352590;G;4761001;1;2;-1
673220;202102;352590;P;8599604;1;1;0
673804;202102;352590;G;4789004;1;0;1
674032;202102;352590;G;4713001;2;2;0
674057;202102;352590;I;5611201;0;3;-3
675514;202102;352590;N;8299706;0;1;-1
675640;202102;352590;P;8599604;1;1;0
676123;202102;352590;F;4399103;2;1;1
676380;202102;352590;I;5620104;1;0;1
676450;202102;352590;G;4761001;2;1;1
676648;202102;352590;G;4729699;0;1;-1
677123;202102;352590;P;8512100;1;0;1
677125;202102;352590;S;9602502;5;0;5
677220;202102;352590;G;4744005;1;0;1
678500;202102;352590;G;4781400;1;0;1
678778;202102;352590;Q;8630504;1;0;1
678878;202102;352590;I;5611203;2;3;-1
680635;202102;352590;G;4772500;0;1;-1
680985;202102;352590;I;5611201;9;0;9
681020;202102;352590;I;5611203;0;1;-1
681023;202102;352590;G;4772500;2;0;2
681316;202102;352590;G;4635499;6;2;4
681637;202102;352590;P;8599604;1;0;1
681696;202102;352590;Q;8650099;1;0;1
681729;202102;352590;H;5250804;15;3;12
681920;202102;352590;C;3314799;1;0;1
683778;202102;352590;G;4633801;1;2;-1
683971;202102;352590;I;5611203;1;1;0
684356;202102;352590;G;4637107;2;0;2
684476;202102;352590;I;5611203;1;0;1
686019;202102;352590;R;9001999;1;0;1
686152;202102;352590;G;4729699;1;0;1
686342;202102;352590;G;4669999;8;1;7
686344;202102;352590;C;1094500;2;0;2
686619;202102;352590;G;4729699;3;1;2
687123;202102;352590;I;5611203;1;0;1
688147;202102;352590;J;6120501;1;1;0
689284;202102;352590;N;8211300;2;0;2
691751;202102;352590;H;4930202;1;0;1
693882;202102;352590;I;5611203;7;5;2
693981;202102;352590;C;1062700;1;5;-4
694626;202102;352590;C;1813099;1;0;1
694855;202102;352590;H;5222200;1;1;0
695080;202102;352590;G;4647801;0;1;-1
695195;202102;352590;G;4774100;0;1;-1
695324;202102;352590;C;2091600;1;1;0
695629;202102;352590;G;4721104;0;1;-1
695779;202102;352590;P;8513900;3;1;2
695917;202102;352590;F;4313400;1;0;1
695961;202102;352590;G;4753900;2;1;1
695969;202102;352590;G;4753900;0;1;-1
696027;202102;352590;H;4930202;4;4;0
696035;202102;352590;F;4120400;1;5;-4
696114;202102;352590;G;4772500;0;1;-1
696137;202102;352590;C;2019399;2;1;1
696219;202102;352590;C;2543800;3;0;3
696220;202102;352590;C;2599399;1;1;0
696221;202102;352590;C;2599399;2;1;1
696379;202102;352590;C;2710402;16;12;4
696420;202102;352590;G;4789099;0;1;-1
696522;202102;352590;L;6822600;1;0;1
697128;202102;352590;M;6920601;0;1;-1
697129;202102;352590;G;4744005;1;0;1
697131;202102;352590;C;2592602;1;1;0
697132;202102;352590;G;4721102;1;0;1
697133;202102;352590;S;9430800;2;0;2
697134;202102;352590;G;4731800;1;1;0
697138;202102;352590;K;6550200;22;16;6
697154;202102;352590;K;6550200;1;10;-9
697205;202102;352590;K;6550200;2;1;1
697239;202102;352590;F;4399105;2;0;2
697240;202102;352590;C;1413401;1;0;1
697241;202102;352590;G;4530703;1;2;-1
697242;202102;352590;M;6920601;3;1;2
697243;202102;352590;I;5611201;1;0;1
697244;202102;352590;G;4755502;0;1;-1
697245;202102;352590;R;9312300;0;2;-2
697246;202102;352590;Q;8640201;0;1;-1
697418;202102;352590;C;2013402;12;2;10
697419;202102;352590;C;2013402;13;1;12
698173;202102;352590;G;4781400;4;7;-3
698335;202102;352590;G;4781400;3;6;-3
698654;202102;352590;F;4120400;1;2;-1
698668;202102;352590;C;2862300;0;2;-2
698788;202102;352590;G;4782201;1;0;1
698792;202102;352590;G;4782201;0;2;-2
698795;202102;352590;G;4782201;0;12;-12
698796;202102;352590;G;4782201;0;2;-2
698884;202102;352590;G;4711301;4;7;-3
699012;202102;352590;G;4731800;1;2;-1
699149;202102;352590;G;4771701;1;2;-1
699325;202102;352590;G;4744005;0;1;-1
699404;202102;352590;C;2821601;1;0;1
699412;202102;352590;G;4672900;0;1;-1
699415;202102;352590;O;8411600;103;4;99
700062;202102;352590;C;3250705;6;4;2
700213;202102;352590;C;2063100;10;6;4
700230;202102;352590;C;2651500;1;7;-6
700299;202102;352590;G;4781400;0;29;-29
700382;202102;352590;G;4646001;0;1;-1
700412;202102;352590;H;4930202;0;1;-1
700707;202102;352590;L;6821802;1;0;1
700714;202102;352590;G;4761003;0;1;-1
700721;202102;352590;G;4744002;1;3;-2
700736;202102;352590;Q;8630504;1;0;1
700740;202102;352590;H;4930202;1;0;1
700741;202102;352590;G;4639701;5;3;2
700763;202102;352590;G;4729601;1;0;1
700764;202102;352590;F;4313400;0;6;-6
700838;202102;352590;G;4781400;0;1;-1
701011;202102;352590;C;2342702;2;2;0
701276;202102;352590;G;4781400;1;0;1
701327;202102;352590;G;4781400;0;1;-1
701825;202102;352590;G;4711302;1;5;-4
702045;202102;352590;G;4771701;0;1;-1
702214;202102;352590;G;4711302;0;1;-1
702518;202102;352590;Q;8640202;1;0;1
702521;202102;352590;Q;8690999;1;0;1
702535;202102;352590;Q;8640202;0;4;-4
702842;202102;352590;G;4789007;1;0;1
702843;202102;352590;G;4789002;3;0;3
702844;202102;352590;G;4637107;2;0;2
703164;202102;352590;G;4713004;1;3;-2
703485;202102;352590;G;4713004;1;2;-1
704503;202102;352590;C;2330302;1;0;1
704526;202102;352590;H;4921301;4;8;-4
704776;202102;352590;N;8299706;0;1;-1
704777;202102;352590;G;4789099;0;1;-1
705396;202102;352590;H;5211799;3;4;-1
705432;202102;352590;G;4731800;0;1;-1
705433;202102;352590;S;9521500;0;1;-1
705490;202102;352590;Q;8640205;6;3;3
705495;202102;352590;G;4732600;0;1;-1
705499;202102;352590;C;1412602;1;0;1
705500;202102;352590;G;4711302;1;0;1
705551;202102;352590;C;2229399;1;3;-2
705676;202102;352590;G;4712100;1;0;1
705769;202102;352590;G;4784900;0;1;-1
705771;202102;352590;G;4731800;1;1;0
705845;202102;352590;G;4781400;1;0;1
705875;202102;352590;G;4781400;2;2;0
705909;202102;352590;G;4741500;0;3;-3
706375;202102;352590;I;5620101;1;1;0
706435;202102;352590;I;5620101;0;1;-1
706521;202102;352590;I;5620101;1;0;1
706608;202102;352590;I;5620101;0;1;-1
706763;202102;352590;I;5620101;0;2;-2
706769;202102;352590;I;5620101;2;0;2
706789;202102;352590;I;5620101;2;0;2
706791;202102;352590;I;5620101;0;1;-1
706802;202102;352590;I;5620101;5;0;5
706943;202102;352590;G;4744005;1;0;1
706944;202102;352590;Q;8630503;2;1;1
706947;202102;352590;P;8599601;3;2;1
706948;202102;352590;C;1813099;21;2;19
706949;202102;352590;P;8599601;1;0;1
706950;202102;352590;G;4530703;2;0;2
707024;202102;352590;P;8599699;8;0;8
707038;202102;352590;R;9313100;0;1;-1
707408;202102;352590;C;1330800;35;31;4
707411;202102;352590;F;4313400;0;3;-3
707805;202102;352590;K;6550200;0;3;-3
707806;202102;352590;K;6550200;1;0;1
707807;202102;352590;K;6550200;13;15;-2
707808;202102;352590;K;6550200;0;1;-1
708026;202102;352590;F;4120400;1;3;-2
708027;202102;352590;G;4731800;0;2;-2
708056;202102;352590;H;4921301;41;5;36
708063;202102;352590;C;1623400;1;1;0
708065;202102;352590;C;1122401;0;3;-3
708066;202102;352590;G;4711302;1;1;0
708067;202102;352590;G;4712100;0;1;-1
708068;202102;352590;C;1112700;2;4;-2
708070;202102;352590;G;4744099;0;1;-1
708071;202102;352590;C;1112700;0;1;-1
708072;202102;352590;G;4530703;1;0;1
708074;202102;352590;G;4731800;1;1;0
708076;202102;352590;P;8513900;33;10;23
708077;202102;352590;G;4511101;5;3;2
708079;202102;352590;C;2229302;2;2;0
708082;202102;352590;R;9312300;4;1;3
708083;202102;352590;G;4721102;1;3;-2
708087;202102;352590;C;1033301;0;4;-4
708088;202102;352590;C;1062700;0;1;-1
708089;202102;352590;C;2219600;9;3;6
708091;202102;352590;G;4689399;1;0;1
708092;202102;352590;C;1099601;0;2;-2
708093;202102;352590;C;1629301;5;2;3
708098;202102;352590;K;6622300;1;3;-2
708101;202102;352590;G;4530703;0;1;-1
708102;202102;352590;G;4530705;0;1;-1
708103;202102;352590;C;2212900;0;1;-1
708104;202102;352590;G;4530703;0;1;-1
708107;202102;352590;H;4929902;5;2;3
708108;202102;352590;G;4712100;0;1;-1
708111;202102;352590;Q;8610101;22;21;1
708113;202102;352590;C;1091101;0;1;-1
708119;202102;352590;C;3101200;1;0;1
708120;202102;352590;G;4731800;2;1;1
708121;202102;352590;G;4711302;0;2;-2
708122;202102;352590;G;4711302;1;2;-1
708124;202102;352590;G;4711302;9;6;3
708126;202102;352590;G;4711302;4;4;0
708128;202102;352590;G;4711302;6;3;3
708130;202102;352590;C;1531901;1;1;0
708131;202102;352590;G;4711302;3;9;-6
708132;202102;352590;G;4711302;0;3;-3
708133;202102;352590;G;4711302;13;11;2
708134;202102;352590;G;4711302;4;3;1
708136;202102;352590;G;4711302;7;9;-2
708137;202102;352590;G;4639701;1;0;1
708139;202102;352590;G;4711302;1;3;-2
708141;202102;352590;G;4711302;1;1;0
708143;202102;352590;G;4711302;4;3;1
708144;202102;352590;G;4711302;4;2;2
708145;202102;352590;G;4711302;5;7;-2
708146;202102;352590;H;4921301;2;9;-7
708147;202102;352590;C;1311100;3;0;3
708148;202102;352590;C;1311100;13;12;1
708149;202102;352590;C;2229301;16;43;-27
708150;202102;352590;C;2229301;4;25;-21
708151;202102;352590;C;2229301;4;50;-46
708152;202102;352590;C;2229301;1;2;-1
708153;202102;352590;C;2229301;2;17;-15
708155;202102;352590;Q;8730102;1;0;1
708161;202102;352590;I;5590699;0;2;-2
708162;202102;352590;Q;8800600;2;1;1
708166;202102;352590;G;4721102;1;0;1
708167;202102;352590;G;4511101;3;4;-1
708168;202102;352590;R;9329899;0;1;-1
708169;202102;352590;R;9329899;0;1;-1
708176;202102;352590;S;9430800;1;0;1
708177;202102;352590;M;7112000;2;1;1
708178;202102;352590;C;1813099;1;1;0
708184;202102;352590;Q;8610101;1;3;-2
708185;202102;352590;S;9430800;1;1;0
708188;202102;352590;S;9430800;0;1;-1
708189;202102;352590;P;8511200;0;1;-1
708190;202102;352590;Q;8610101;25;9;16
708193;202102;352590;C;2342702;1;3;-2
708194;202102;352590;Q;8800600;1;0;1
708195;202102;352590;G;4721102;0;1;-1
708196;202102;352590;P;8511200;0;2;-2
708204;202102;352590;G;4530703;1;0;1
708205;202102;352590;Q;8711502;7;5;2
708206;202102;352590;G;4744099;1;0;1
708209;202102;352590;H;4930202;0;1;-1
708212;202102;352590;G;4731800;0;1;-1
708213;202102;352590;G;4711302;6;7;-1
708214;202102;352590;G;4711302;2;6;-4
708215;202102;352590;G;4711302;3;5;-2
708216;202102;352590;G;4711302;1;3;-2
708218;202102;352590;G;4711302;4;1;3
708220;202102;352590;M;6920601;1;0;1
708222;202102;352590;I;5611201;1;0;1
708223;202102;352590;M;6920601;0;1;-1
708224;202102;352590;S;9420100;0;1;-1
708225;202102;352590;S;9420100;1;0;1
708235;202102;352590;S;9420100;2;0;2
708236;202102;352590;S;9420100;0;2;-2
708240;202102;352590;S;9491000;1;1;0
708241;202102;352590;S;9491000;1;1;0
708244;202102;352590;S;9491000;1;1;0
708247;202102;352590;G;4633801;4;3;1
708250;202102;352590;P;8531700;0;2;-2
708258;202102;352590;S;9491000;0;1;-1
708324;202102;352590;C;1053800;1;1;0
708545;202102;352590;N;8211300;0;4;-4
708609;202102;352590;M;6920601;1;0;1
708616;202102;352590;G;4789099;1;1;0
708617;202102;352590;P;8513900;9;0;9
708621;202102;352590;G;4541203;1;0;1
708642;202102;352590;C;2071100;1;2;-1
708939;202102;352590;C;1013901;5;8;-3
709285;202102;352590;G;4744099;3;1;2
709419;202102;352590;N;8299799;1;0;1
709420;202102;352590;Q;8640202;0;1;-1
709421;202102;352590;Q;8640202;0;2;-2
709422;202102;352590;Q;8640202;1;4;-3
709426;202102;352590;Q;8650004;16;4;12
709428;202102;352590;S;9601701;0;2;-2
709429;202102;352590;Q;8640202;1;1;0
709430;202102;352590;Q;8640202;0;1;-1
709431;202102;352590;Q;8640202;0;1;-1
709433;202102;352590;Q;8640202;0;1;-1
709434;202102;352590;Q;8640202;1;0;1
709435;202102;352590;H;4930202;0;2;-2
709437;202102;352590;Q;8650099;0;3;-3
709471;202102;352590;Q;8610101;4;11;-7
709502;202102;352590;P;8520100;4;0;4
709503;202102;352590;S;9430800;2;0;2
709504;202102;352590;S;9499500;1;0;1
709505;202102;352590;Q;8640202;0;1;-1
709517;202102;352590;G;4647801;2;1;1
709519;202102;352590;S;9499500;1;1;0
709604;202102;352590;C;1622699;3;1;2
709637;202102;352590;H;5112901;6;4;2
709778;202102;352590;C;3250707;3;4;-1
709883;202102;352590;C;2342702;1;1;0
709897;202102;352590;G;4661300;7;6;1
710050;202102;352590;E;3702900;0;1;-1
710053;202102;352590;N;8112500;1;0;1
710054;202102;352590;P;8512100;4;0;4
710072;202102;352590;P;8592999;1;0;1
710074;202102;352590;N;8112500;0;1;-1
710075;202102;352590;N;8112500;1;1;0
710076;202102;352590;N;7820500;3;9;-6
710138;202102;352590;G;4639701;4;0;4
710156;202102;352590;G;4744099;1;0;1
710180;202102;352590;H;4930202;0;2;-2
710200;202102;352590;G;4782201;0;1;-1
710201;202102;352590;G;4782201;1;5;-4
710369;202102;352590;H;4930202;1;3;-2
710382;202102;352590;G;4789099;2;0;2
710441;202102;352590;G;4771702;7;4;3
710442;202102;352590;N;8211300;3;2;1
710536;202102;352590;G;4755502;1;0;1
710540;202102;352590;I;5611201;1;1;0
710575;202102;352590;G;4744001;0;1;-1
710634;202102;352590;G;4530703;1;2;-1
710654;202102;352590;G;4530701;0;1;-1
710801;202102;352590;G;4721102;4;3;1
710829;202102;352590;C;1031700;6;2;4
710865;202102;352590;C;2512800;0;1;-1
711221;202102;352590;G;4789004;4;2;2
711480;202102;352590;G;4669999;4;2;2
711615;202102;352590;G;4530704;0;1;-1
712445;202102;352590;G;4520006;0;2;-2
712495;202102;352590;H;4930201;0;1;-1
712520;202102;352590;G;4781400;1;0;1
712656;202102;352590;G;4732600;0;1;-1
712855;202102;352590;C;3314704;0;1;-1
712862;202102;352590;H;4930202;0;1;-1
712866;202102;352590;L;6822600;1;0;1
712867;202102;352590;M;7112000;2;1;1
712869;202102;352590;S;9420100;1;1;0
712870;202102;352590;P;8513900;2;0;2
712946;202102;352590;I;5620101;0;1;-1
712961;202102;352590;G;4520001;0;1;-1
713012;202102;352590;G;4712100;0;1;-1
713033;202102;352590;F;4329103;1;1;0
713187;202102;352590;C;3101200;0;1;-1
713521;202102;352590;C;3101200;2;0;2
713686;202102;352590;G;4744002;2;0;2
713726;202102;352590;G;4712100;2;1;1
713727;202102;352590;G;4712100;1;1;0
713914;202102;352590;G;4744005;1;0;1
713993;202102;352590;G;4530703;0;1;-1
713994;202102;352590;N;7732201;1;0;1
713995;202102;352590;L;6821801;1;0;1
713997;202102;352590;R;9313100;1;0;1
713998;202102;352590;Q;8690999;1;2;-1
713999;202102;352590;Q;8630502;0;1;-1
714079;202102;352590;G;4511101;4;5;-1
714083;202102;352590;I;5620101;2;0;2
714234;202102;352590;F;4322301;2;1;1
714603;202102;352590;G;4789007;0;1;-1
714754;202102;352590;G;4721102;1;0;1
714758;202102;352590;F;4399199;1;0;1
714938;202102;352590;C;2821602;0;3;-3
715492;202102;352590;F;4313400;2;0;2
715497;202102;352590;C;2829199;0;2;-2
715558;202102;352590;B;810006;1;1;0
715665;202102;352590;G;4712100;0;1;-1
715680;202102;352590;G;4649499;0;2;-2
715686;202102;352590;C;2823200;4;1;3
715693;202102;352590;C;3101200;0;4;-4
715780;202102;352590;G;4661300;3;0;3
715877;202102;352590;C;2449199;3;0;3
716117;202102;352590;M;7210000;1;0;1
716260;202102;352590;G;4530703;0;1;-1
716305;202102;352590;G;4721102;0;2;-2
716308;202102;352590;I;5510803;1;1;0
716499;202102;352590;G;4649403;1;1;0
716732;202102;352590;G;4761003;1;0;1
716916;202102;352590;G;4753900;0;1;-1
717007;202102;352590;I;5510801;0;1;-1
717062;202102;352590;G;4511102;0;1;-1
717100;202102;352590;K;6550200;0;5;-5
717101;202102;352590;Q;8610102;1;2;-1
717102;202102;352590;Q;8610101;9;4;5
717553;202102;352590;F;4321500;0;1;-1
717877;202102;352590;C;3314708;1;0;1
717909;202102;352590;G;4541205;1;0;1
718153;202102;352590;G;4763602;1;1;0
718188;202102;352590;M;7119701;0;1;-1
718191;202102;352590;N;8112500;1;1;0
718514;202102;352590;H;4930202;5;1;4
718747;202102;352590;C;2099199;4;3;1
718842;202102;352590;C;2539002;2;0;2
718848;202102;352590;C;2592602;3;2;1
718887;202102;352590;G;4781400;2;0;2
718976;202102;352590;H;4930202;1;2;-1
719003;202102;352590;C;1094500;1;0;1
719183;202102;352590;K;6493000;2;2;0
719402;202102;352590;J;6204000;1;1;0
719447;202102;352590;N;8299706;1;0;1
719574;202102;352590;I;5611201;0;2;-2
719661;202102;352590;N;8219901;1;1;0
719682;202102;352590;I;5611201;0;1;-1
719689;202102;352590;G;4781400;0;1;-1
719754;202102;352590;C;2229302;1;2;-1
719760;202102;352590;I;5611203;0;1;-1
719782;202102;352590;P;8512100;2;0;2
719797;202102;352590;N;8121400;6;4;2
719799;202102;352590;Q;8630503;0;1;-1
719800;202102;352590;H;5223100;1;0;1
719801;202102;352590;H;5223100;0;1;-1
719802;202102;352590;H;5223100;2;0;2
719803;202102;352590;P;8512100;1;0;1
719991;202102;352590;G;4761003;2;1;1
720129;202102;352590;F;4221902;5;3;2
720183;202102;352590;H;4929902;2;18;-16
720210;202102;352590;I;5611201;2;0;2
720211;202102;352590;I;5611201;1;0;1
720230;202102;352590;G;4789099;0;1;-1
720501;202102;352590;G;4635402;7;9;-2
720614;202102;352590;C;2229399;13;7;6
720644;202102;352590;H;4930202;5;5;0
720692;202102;352590;Q;8640205;3;2;1
720736;202102;352590;J;6202300;0;1;-1
720738;202102;352590;M;6920601;1;0;1
720740;202102;352590;P;8512100;1;1;0
720749;202102;352590;N;8112500;1;0;1
720750;202102;352590;J;6202300;1;0;1
720751;202102;352590;L;6821802;0;1;-1
720752;202102;352590;Q;8640202;2;1;1
720753;202102;352590;S;9430800;0;1;-1
720897;202102;352590;C;2944100;39;63;-24
720932;202102;352590;C;1629301;4;2;2
721247;202102;352590;K;6422100;2;0;2
721320;202102;352590;G;4744099;1;0;1
721385;202102;352590;G;4520001;0;1;-1
721407;202102;352590;F;4292802;1;42;-41
721520;202102;352590;H;4930202;2;1;1
721527;202102;352590;G;4520001;0;1;-1
721564;202102;352590;G;4721102;2;1;1
721582;202102;352590;K;6550200;1;0;1
721829;202102;352590;G;4751201;1;0;1
721831;202102;352590;G;4755502;1;0;1
721850;202102;352590;H;4930202;1;1;0
721916;202102;352590;C;1091101;1;0;1
721926;202102;352590;N;7732201;2;1;1
722055;202102;352590;G;4789004;0;1;-1
722199;202102;352590;C;1314600;2;1;1
722445;202102;352590;G;4672900;0;1;-1
722851;202102;352590;G;4744002;0;1;-1
723083;202102;352590;C;2032100;0;1;-1
723214;202102;352590;M;7210000;0;1;-1
723229;202102;352590;G;4530701;1;1;0
723237;202102;352590;G;4789099;1;0;1
723356;202102;352590;C;2522500;7;2;5
723661;202102;352590;Q;8610101;1;2;-1
723719;202102;352590;C;2014200;1;1;0
723843;202102;352590;G;4530703;1;3;-2
723849;202102;352590;C;1412601;0;1;-1
723860;202102;352590;C;2599399;1;2;-1
723866;202102;352590;C;2812700;1;0;1
723918;202102;352590;K;6422100;0;3;-3
723922;202102;352590;K;6422100;1;0;1
724167;202102;352590;K;6422100;0;1;-1
724271;202102;352590;K;6422100;1;0;1
724493;202102;352590;K;6422100;0;1;-1
724760;202102;352590;K;6422100;1;1;0
725667;202102;352590;C;2222600;3;1;2
725679;202102;352590;G;4744005;1;0;1
725878;202102;352590;Q;8690999;1;0;1
725942;202102;352590;Q;8640202;0;1;-1
725981;202102;352590;G;4744005;1;0;1
725994;202102;352590;G;4511104;2;0;2
726030;202102;352590;C;2539002;2;0;2
726085;202102;352590;B;810099;1;1;0
726182;202102;352590;P;8513900;2;1;1
726436;202102;352590;C;1099603;0;1;-1
726695;202102;352590;C;3104700;2;1;1
726703;202102;352590;P;8513900;2;2;0
726706;202102;352590;Q;8711502;0;1;-1
726707;202102;352590;P;8511200;0;1;-1
726843;202102;352590;Q;8640212;0;4;-4
726901;202102;352590;S;9491000;0;3;-3
726945;202102;352590;C;2599399;4;0;4
727227;202102;352590;C;2949299;1;0;1
727228;202102;352590;C;2949299;1;0;1
727576;202102;352590;G;4713004;2;1;1
727626;202102;352590;G;4646001;1;1;0
727809;202102;352590;C;2591800;2;3;-1
727876;202102;352590;G;4635402;2;9;-7
727884;202102;352590;C;1122401;3;45;-42
727942;202102;352590;G;4781400;0;1;-1
727990;202102;352590;G;4781400;0;1;-1
728113;202102;352590;C;1721400;8;3;5
728117;202102;352590;G;4647801;4;2;2
728165;202102;352590;C;3299002;6;2;4
728244;202102;352590;G;4711302;6;11;-5
728840;202102;352590;G;4771701;1;1;0
728954;202102;352590;G;4771701;0;2;-2
729087;202102;352590;G;4771701;1;0;1
729265;202102;352590;C;2949299;37;4;33
729656;202102;352590;N;8211300;7;13;-6
729834;202102;352590;C;1411801;47;19;28
730046;202102;352590;G;4771701;3;1;2
730360;202102;352590;G;4771701;0;2;-2
730482;202102;352590;G;4771701;1;0;1
730526;202102;352590;G;4771701;1;1;0
730544;202102;352590;G;4771701;1;0;1
730614;202102;352590;G;4771701;0;2;-2
730638;202102;352590;G;4771701;0;1;-1
730871;202102;352590;G;4771701;2;0;2
730977;202102;352590;G;4771701;0;2;-2
731069;202102;352590;G;4771701;1;0;1
731089;202102;352590;G;4771701;1;0;1
731207;202102;352590;G;4771701;0;2;-2
731209;202102;352590;G;4771701;2;0;2
731387;202102;352590;Q;8800600;3;2;1
731718;202102;352590;M;6920601;0;1;-1
731719;202102;352590;J;6202300;0;1;-1
731725;202102;352590;N;8121400;24;21;3
731834;202102;352590;G;4743100;2;0;2
731873;202102;352590;G;4782202;2;1;1
732501;202102;352590;C;2441501;1;1;0
732956;202102;352590;C;2592601;1;0;1
733037;202102;352590;G;4637107;3;0;3
733096;202102;352590;F;4321500;0;1;-1
733363;202102;352590;G;4759899;1;0;1
733521;202102;352590;I;5611203;1;0;1
733734;202102;352590;F;4110700;0;1;-1
733848;202102;352590;P;8541400;1;0;1
733908;202102;352590;P;8532500;2;1;1
734095;202102;352590;G;4789002;5;11;-6
734111;202102;352590;C;2229301;2;3;-1
734319;202102;352590;G;4530701;0;1;-1
734370;202102;352590;G;4755503;1;1;0
735284;202102;352590;J;6202300;3;0;3
735406;202102;352590;J;6209100;4;4;0
735415;202102;352590;Q;8660700;11;9;2
735500;202102;352590;G;4649408;0;1;-1
735532;202102;352590;C;1112700;2;0;2
735595;202102;352590;G;4731800;1;1;0
735597;202102;352590;P;8513900;3;0;3
736194;202102;352590;H;4930202;2;2;0
736246;202102;352590;G;4789099;2;0;2
736360;202102;352590;C;3314710;1;0;1
736437;202102;352590;G;4782201;0;2;-2
736467;202102;352590;S;9529102;1;0;1
736630;202102;352590;N;8219999;0;1;-1
736687;202102;352590;I;5510803;2;2;0
737339;202102;352590;G;4530703;0;1;-1
737565;202102;352590;H;4930202;0;1;-1
737640;202102;352590;J;6202300;3;2;1
737712;202102;352590;G;4530703;1;0;1
737929;202102;352590;G;4711302;27;42;-15
737972;202102;352590;C;1099699;6;5;1
738081;202102;352590;F;4211101;2;2;0
738218;202102;352590;G;4771702;2;1;1
738860;202102;352590;G;4684201;3;1;2
738929;202102;352590;N;7739099;6;6;0
738945;202102;352590;I;5611203;0;2;-2
738946;202102;352590;I;5611203;8;7;1
739104;202102;352590;G;4789099;2;0;2
739145;202102;352590;G;4731800;0;1;-1
739691;202102;352590;N;8111700;21;57;-36
739708;202102;352590;H;5223100;1;1;0
739709;202102;352590;P;8512100;3;1;2
739711;202102;352590;N;8112500;0;1;-1
739712;202102;352590;Q;8690999;1;1;0
739723;202102;352590;P;8513900;0;2;-2
739724;202102;352590;Q;8630502;1;0;1
739725;202102;352590;N;8112500;1;1;0
739728;202102;352590;N;8121400;3;2;1
739729;202102;352590;Q;8640207;2;2;0
739815;202102;352590;G;4771701;0;2;-2
739816;202102;352590;G;4771701;1;1;0
739817;202102;352590;G;4771701;1;1;0
739852;202102;352590;J;6311900;1;0;1
739901;202102;352590;G;4744005;1;0;1
739950;202102;352590;G;4530703;1;0;1
740090;202102;352590;C;2014200;2;4;-2
740116;202102;352590;G;4711302;2;2;0
740117;202102;352590;C;1013901;2;0;2
740199;202102;352590;F;4120400;2;0;2
740200;202102;352590;F;4120400;9;7;2
740248;202102;352590;C;2222600;1;2;-1
740368;202102;352590;F;4120400;5;3;2
740483;202102;352590;G;4729699;1;1;0
740598;202102;352590;G;4520001;0;1;-1
740659;202102;352590;C;2229399;2;4;-2
740684;202102;352590;G;4637199;0;1;-1
740760;202102;352590;G;4741500;1;0;1
740887;202102;352590;I;5620101;0;1;-1
740943;202102;352590;I;5620101;2;4;-2
740962;202102;352590;I;5620101;0;1;-1
741146;202102;352590;M;6920601;1;1;0
741242;202102;352590;I;5611201;0;1;-1
741274;202102;352590;G;4744005;1;0;1
741283;202102;352590;S;9521500;1;1;0
741308;202102;352590;G;4744005;2;0;2
741320;202102;352590;G;4623199;2;0;2
741338;202102;352590;H;4930202;3;2;1
741356;202102;352590;C;2599399;2;1;1
741734;202102;352590;G;4763601;0;2;-2
741827;202102;352590;G;4785701;0;1;-1
741834;202102;352590;I;5611203;1;0;1
742585;202102;352590;G;4530703;2;0;2
742708;202102;352590;G;4771701;0;1;-1
742709;202102;352590;G;4781400;1;0;1
742722;202102;352590;J;6203100;5;4;1
742835;202102;352590;G;4789004;0;1;-1
742865;202102;352590;C;2543800;3;0;3
742885;202102;352590;C;2330302;0;1;-1
743075;202102;352590;G;4712100;1;0;1
743084;202102;352590;G;4722901;1;0;1
743188;202102;352590;G;4721102;1;1;0
743279;202102;352590;G;4771702;9;3;6
743314;202102;352590;G;4530703;0;1;-1
745274;202102;352590;C;2229301;57;20;37
745522;202102;352590;F;4110700;5;1;4
745523;202102;352590;F;4110700;0;1;-1
745602;202102;352590;N;7739099;0;1;-1
745618;202102;352590;C;3314710;1;2;-1
745721;202102;352590;G;4771701;1;1;0
745752;202102;352590;I;5611201;0;2;-2
745890;202102;352590;G;4744005;2;0;2
745973;202102;352590;G;4744005;0;1;-1
746013;202102;352590;G;4741500;3;1;2
746017;202102;352590;G;4741500;1;0;1
746018;202102;352590;G;4741500;1;1;0
746030;202102;352590;G;4741500;2;0;2
746110;202102;352590;G;4744001;1;1;0
747455;202102;352590;G;4744005;1;1;0
747462;202102;352590;G;4781400;1;0;1
747572;202102;352590;G;4789099;1;0;1
747606;202102;352590;I;5611201;0;2;-2
747618;202102;352590;H;5310502;1;0;1
747709;202102;352590;G;4761001;0;1;-1
747732;202102;352590;I;5611201;1;0;1
747760;202102;352590;G;4789099;0;1;-1
747793;202102;352590;C;2099199;1;0;1
747943;202102;352590;G;4520005;0;7;-7
748065;202102;352590;G;4744001;0;1;-1
748133;202102;352590;J;5813100;0;1;-1
748219;202102;352590;G;4743100;3;0;3
748676;202102;352590;G;4635402;4;0;4
750099;202102;352590;H;5310502;1;0;1
750104;202102;352590;H;5223100;1;0;1
750162;202102;352590;H;5310502;0;1;-1
750185;202102;352590;P;8512100;0;2;-2
750445;202102;352590;P;8599601;1;0;1
750684;202102;352590;C;1330800;4;5;-1
750705;202102;352590;G;4789002;1;1;0
750735;202102;352590;R;9313100;0;1;-1
750781;202102;352590;G;4744001;0;1;-1
750800;202102;352590;G;4744099;0;1;-1
750821;202102;352590;I;5611203;1;0;1
750898;202102;352590;G;4711302;1;3;-2
750899;202102;352590;G;4729699;1;0;1
750930;202102;352590;G;4771701;0;1;-1
750946;202102;352590;C;2869100;1;0;1
751022;202102;352590;I;5611201;0;2;-2
751989;202102;352590;G;4711301;2;8;-6
752746;202102;352590;C;2349401;24;14;10
752752;202102;352590;N;8211300;11;4;7
753360;202102;352590;H;4930202;3;2;1
754547;202102;352590;G;4672900;11;3;8
756238;202102;352590;H;4930203;0;1;-1
759820;202102;352590;G;4711301;3;4;-1
762479;202102;352590;I;5510801;1;1;0
766318;202102;352590;H;4930202;2;5;-3
767937;202102;352590;G;4679604;3;4;-1
769639;202102;352590;G;4541201;0;1;-1
773947;202102;352590;G;4661300;1;0;1
776219;202102;352590;H;4930202;0;9;-9
777718;202102;352590;C;1733800;36;2;34
777719;202102;352590;C;1733800;4;4;0
779149;202102;352590;K;6422100;0;1;-1
779180;202102;352590;K;6422100;0;1;-1
779182;202102;352590;K;6422100;0;1;-1
779183;202102;352590;K;6422100;0;1;-1
779396;202102;352590;K;6422100;0;1;-1
783229;202102;352590;G;4781400;2;5;-3
783336;202102;352590;G;4781400;0;2;-2
786245;202102;352590;I;5620101;3;3;0
788011;202102;352590;C;1733800;15;4;11
788251;202102;352590;N;8111700;1;0;1
788276;202102;352590;H;4930202;0;1;-1
788553;202102;352590;E;3832700;1;0;1
788554;202102;352590;I;5620104;2;2;0
788581;202102;352590;G;4771702;0;1;-1
788593;202102;352590;G;4722901;1;0;1
788700;202102;352590;Q;8630503;1;1;0
788780;202102;352590;C;2829199;1;0;1
788833;202102;352590;C;2599399;0;1;-1
788857;202102;352590;G;4642702;0;1;-1
790301;202102;352590;G;4752100;0;2;-2
790406;202102;352590;M;7112000;0;1;-1
790604;202102;352590;C;2813500;34;6;28
790605;202102;352590;C;2349401;43;23;20
807502;202102;352590;Q;8650003;1;0;1
809984;202102;352590;A;210107;2;0;2
812602;202102;352590;Q;8630503;1;0;1
97;202010;352590;K;6422100;0;1;-1
254;202010;352590;G;4789099;1;0;1
314;202010;352590;C;2821601;0;1;-1
474;202010;352590;G;4751201;1;0;1
545;202010;352590;F;4329103;0;1;-1
2638;202010;352590;C;2599399;21;9;12
2771;202010;352590;L;6810202;1;1;0
2837;202010;352590;G;4744005;1;1;0
2889;202010;352590;G;4789099;2;1;1
3383;202010;352590;C;2812700;2;6;-4
3489;202010;352590;C;1091101;0;1;-1
3544;202010;352590;G;4789099;1;0;1
3582;202010;352590;C;1340599;1;0;1
3873;202010;352590;C;2222600;0;1;-1
3966;202010;352590;Q;8630503;0;1;-1
3985;202010;352590;C;2949299;4;4;0
4764;202010;352590;N;8219901;0;1;-1
4974;202010;352590;C;2040100;4;5;-1
5100;202010;352590;N;7739099;2;1;1
5200;202010;352590;N;7810800;111;43;68
5386;202010;352590;K;6622300;3;1;2
5458;202010;352590;C;2539002;2;0;2
5862;202010;352590;C;2229399;1;2;-1
5972;202010;352590;G;4789099;0;3;-3
5973;202010;352590;C;2512800;2;1;1
6451;202010;352590;C;1732000;3;0;3
6988;202010;352590;G;4753900;5;10;-5
7029;202010;352590;G;4753900;0;1;-1
8518;202010;352590;Q;8711502;1;5;-4
8573;202010;352590;G;4721102;0;1;-1
9128;202010;352590;G;4672900;2;0;2
10275;202010;352590;G;4789007;0;1;-1
10277;202010;352590;G;4530703;1;0;1
10358;202010;352590;G;4712100;1;0;1
11013;202010;352590;N;8299706;1;1;0
11786;202010;352590;Q;8630504;0;1;-1
11800;202010;352590;H;5211799;9;9;0
12621;202010;352590;G;4530703;0;4;-4
12649;202010;352590;I;5611203;1;2;-1
12757;202010;352590;Q;8610101;6;2;4
13081;202010;352590;G;4633801;1;0;1
13307;202010;352590;C;1610201;2;0;2
13367;202010;352590;C;2342702;9;2;7
13885;202010;352590;C;1813001;1;0;1
13928;202010;352590;J;6203100;1;0;1
13949;202010;352590;G;4511102;2;0;2
14061;202010;352590;G;4771702;1;0;1
14066;202010;352590;H;4929902;0;9;-9
14236;202010;352590;S;9601703;3;1;2
14240;202010;352590;S;9601703;57;19;38
14541;202010;352590;C;1413401;0;3;-3
14576;202010;352590;G;4781400;0;1;-1
14698;202010;352590;N;8211300;0;1;-1
14707;202010;352590;G;4530705;2;1;1
14988;202010;352590;K;6629100;1;0;1
15035;202010;352590;C;2341900;0;1;-1
15334;202010;352590;G;4616800;2;0;2
15574;202010;352590;N;8112500;0;1;-1
15575;202010;352590;J;6319400;0;15;-15
17509;202010;352590;S;9601701;0;1;-1
17738;202010;352590;M;6920601;1;2;-1
17752;202010;352590;G;4753900;1;0;1
18293;202010;352590;G;4689399;0;1;-1
18477;202010;352590;G;4721102;0;1;-1
18492;202010;352590;C;2229303;0;1;-1
18840;202010;352590;C;2731700;2;0;2
18977;202010;352590;G;4693100;9;11;-2
19042;202010;352590;G;4511101;5;3;2
19229;202010;352590;N;8230001;0;1;-1
19612;202010;352590;H;5223100;0;1;-1
19671;202010;352590;I;5611201;0;1;-1
19699;202010;352590;E;3701100;1;0;1
19716;202010;352590;G;4742300;0;1;-1
19804;202010;352590;G;4644301;19;22;-3
19831;202010;352590;I;5620101;1;1;0
19883;202010;352590;M;7112000;4;5;-1
19958;202010;352590;I;5611201;1;0;1
20003;202010;352590;J;6202300;1;1;0
20156;202010;352590;K;6622300;1;0;1
20157;202010;352590;K;6622300;0;1;-1
20488;202010;352590;H;5250804;1;1;0
20664;202010;352590;G;4771701;1;0;1
20784;202010;352590;G;4752100;1;0;1
20800;202010;352590;I;5611201;2;1;1
21309;202010;352590;N;8299701;14;17;-3
21712;202010;352590;I;5611201;4;1;3
22220;202010;352590;C;2099199;0;1;-1
22375;202010;352590;I;5611203;0;1;-1
22648;202010;352590;G;4721102;1;2;-1
22795;202010;352590;J;6203100;0;1;-1
23081;202010;352590;C;2229302;12;2;10
23283;202010;352590;N;8299799;1;0;1
23292;202010;352590;G;4689399;3;1;2
23998;202010;352590;C;2822402;1;1;0
24037;202010;352590;G;4652400;3;1;2
24379;202010;352590;C;3102100;1;8;-7
24847;202010;352590;H;4930203;13;14;-1
24849;202010;352590;H;4930202;0;1;-1
25015;202010;352590;G;4772500;0;1;-1
25166;202010;352590;I;5510803;1;1;0
25212;202010;352590;G;4689301;1;1;0
25223;202010;352590;M;6920601;2;4;-2
25224;202010;352590;Q;8640299;4;1;3
25231;202010;352590;F;4329104;6;3;3
25990;202010;352590;C;2091600;0;1;-1
26724;202010;352590;C;2790299;0;1;-1
27477;202010;352590;F;4399199;1;0;1
27781;202010;352590;H;4930202;7;2;5
27916;202010;352590;G;4639701;0;2;-2
27984;202010;352590;C;1062700;7;4;3
28045;202010;352590;P;8593700;0;1;-1
28470;202010;352590;G;4781400;0;1;-1
28732;202010;352590;C;1081302;3;1;2
29280;202010;352590;M;6920601;3;0;3
29319;202010;352590;C;2539001;4;0;4
29838;202010;352590;C;3250705;3;0;3
30220;202010;352590;C;3101200;1;2;-1
30286;202010;352590;G;4789099;0;1;-1
31153;202010;352590;P;8512100;1;0;1
31226;202010;352590;N;8211300;14;9;5
31227;202010;352590;G;4634601;21;8;13
31945;202010;352590;C;2219600;1;1;0
32008;202010;352590;G;4712100;3;2;1
32114;202010;352590;P;8592903;0;1;-1
32137;202010;352590;C;2222600;3;0;3
32374;202010;352590;G;4763603;1;0;1
33047;202010;352590;I;5611201;0;1;-1
33551;202010;352590;G;4530701;0;2;-2
34343;202010;352590;G;4530701;1;1;0
34852;202010;352590;G;4530702;3;4;-1
34991;202010;352590;C;2539001;1;0;1
35122;202010;352590;G;4687703;2;1;1
35339;202010;352590;C;2599399;0;2;-2
35342;202010;352590;G;4759899;1;1;0
35700;202010;352590;C;1610202;0;2;-2
35828;202010;352590;Q;8650099;1;0;1
36437;202010;352590;G;4731800;0;1;-1
36472;202010;352590;H;4930202;2;1;1
36938;202010;352590;F;4313400;3;4;-1
37633;202010;352590;G;4731800;1;1;0
37977;202010;352590;M;6920601;0;1;-1
38341;202010;352590;G;4639701;8;6;2
38711;202010;352590;C;3314710;1;0;1
38882;202010;352590;C;2511000;2;0;2
38949;202010;352590;R;9312300;0;1;-1
39090;202010;352590;G;4771701;2;0;2
39148;202010;352590;C;1413402;0;2;-2
39917;202010;352590;C;1099699;2;0;2
40376;202010;352590;C;1081302;5;7;-2
40654;202010;352590;N;8011101;12;9;3
41003;202010;352590;N;7820500;1;1;0
41213;202010;352590;B;810007;0;1;-1
42113;202010;352590;J;6110801;4;3;1
42497;202010;352590;G;4789002;1;0;1
42543;202010;352590;C;1340501;3;2;1
42740;202010;352590;M;6920601;4;0;4
42752;202010;352590;G;4511101;1;1;0
42786;202010;352590;H;5221400;21;14;7
42918;202010;352590;C;2941700;13;3;10
42919;202010;352590;C;2941700;4;3;1
42928;202010;352590;R;9313100;0;1;-1
43745;202010;352590;G;4784900;0;1;-1
44283;202010;352590;C;2751100;0;2;-2
44677;202010;352590;C;2229302;1;0;1
44881;202010;352590;J;6120501;0;1;-1
45718;202010;352590;C;1099604;0;1;-1
46553;202010;352590;H;4930202;1;0;1
46573;202010;352590;I;5611203;1;0;1
47084;202010;352590;G;4774100;1;0;1
47311;202010;352590;M;6920601;1;0;1
48019;202010;352590;N;7820500;0;2;-2
48080;202010;352590;G;4511101;1;0;1
48327;202010;352590;I;5611201;1;1;0
48399;202010;352590;G;4511101;0;1;-1
48533;202010;352590;G;4511102;1;0;1
49442;202010;352590;C;2091600;6;3;3
49479;202010;352590;G;4520001;1;0;1
49657;202010;352590;G;4772500;0;1;-1
49895;202010;352590;F;4211101;0;1;-1
50197;202010;352590;G;4781400;1;2;-1
50299;202010;352590;H;4930202;7;5;2
50328;202010;352590;Q;8800600;0;1;-1
50390;202010;352590;G;4721102;0;1;-1
50765;202010;352590;H;5211799;2;8;-6
50884;202010;352590;C;3101200;1;0;1
50963;202010;352590;C;2949299;0;1;-1
50987;202010;352590;N;8211300;4;5;-1
51539;202010;352590;G;4686902;0;1;-1
51570;202010;352590;C;2532201;0;2;-2
52189;202010;352590;I;5620103;2;3;-1
52241;202010;352590;H;4930202;5;1;4
52560;202010;352590;C;1013901;16;23;-7
52623;202010;352590;G;4722901;1;0;1
53118;202010;352590;G;4754701;1;0;1
53137;202010;352590;J;6204000;4;0;4
53273;202010;352590;H;5223100;1;1;0
53339;202010;352590;P;8599602;0;1;-1
53533;202010;352590;L;6821802;1;0;1
53598;202010;352590;G;4781400;0;1;-1
53746;202010;352590;G;4789099;1;1;0
54074;202010;352590;C;3314702;1;0;1
54173;202010;352590;G;4754702;0;1;-1
54528;202010;352590;N;8112500;0;1;-1
54733;202010;352590;G;4713001;0;1;-1
54983;202010;352590;C;3312103;1;0;1
55083;202010;352590;F;4110700;0;1;-1
55844;202010;352590;N;8211300;1;0;1
55919;202010;352590;H;4930202;21;9;12
56224;202010;352590;G;4789001;1;1;0
56226;202010;352590;G;4789001;2;0;2
56332;202010;352590;G;4789099;1;0;1
56446;202010;352590;N;8121400;18;15;3
56757;202010;352590;G;4771702;2;2;0
56802;202010;352590;C;2222600;4;5;-1
57007;202010;352590;G;4731800;0;4;-4
57142;202010;352590;G;4771701;0;1;-1
57307;202010;352590;G;4752100;1;0;1
57308;202010;352590;G;4752100;2;3;-1
57309;202010;352590;G;4752100;1;3;-2
57725;202010;352590;G;4771701;1;0;1
57727;202010;352590;G;4689399;1;1;0
58243;202010;352590;G;4639701;3;0;3
58332;202010;352590;K;6622300;3;0;3
58606;202010;352590;G;4744002;1;0;1
58925;202010;352590;F;4330499;1;0;1
60110;202010;352590;H;5229002;1;0;1
60564;202010;352590;G;4646001;1;2;-1
61153;202010;352590;I;5620101;0;1;-1
61158;202010;352590;I;5620101;0;1;-1
61164;202010;352590;I;5620101;1;1;0
61179;202010;352590;Q;8720401;8;2;6
61415;202010;352590;G;4781400;1;0;1
61484;202010;352590;G;4789099;1;0;1
62138;202010;352590;I;5611201;1;0;1
62715;202010;352590;G;4759899;1;1;0
63069;202010;352590;G;4754701;1;1;0
63516;202010;352590;C;2599399;0;1;-1
63901;202010;352590;K;6622300;1;0;1
64129;202010;352590;G;4744099;1;1;0
65011;202010;352590;G;4711302;1;0;1
65206;202010;352590;G;4711302;1;2;-1
65620;202010;352590;G;4754701;1;0;1
65765;202010;352590;F;4391600;3;2;1
67751;202010;352590;E;3600601;7;1;6
67766;202010;352590;I;5611203;1;0;1
68074;202010;352590;C;1093702;2;5;-3
68465;202010;352590;N;7820500;330;396;-66
68531;202010;352590;F;4120400;5;0;5
69836;202010;352590;Q;8800600;0;1;-1
70047;202010;352590;G;4724500;1;0;1
70347;202010;352590;C;3292202;1;0;1
70431;202010;352590;H;4930202;3;0;3
70498;202010;352590;N;8299706;0;1;-1
70884;202010;352590;C;2829199;1;1;0
71121;202010;352590;N;7820500;671;402;269
71522;202010;352590;N;8299799;1;0;1
72236;202010;352590;P;8599699;0;2;-2
72566;202010;352590;P;8599699;0;1;-1
72577;202010;352590;P;8599699;0;1;-1
72845;202010;352590;F;4399199;3;0;3
73561;202010;352590;G;4633801;0;6;-6
73636;202010;352590;M;6920601;0;1;-1
73852;202010;352590;N;8129000;41;41;0
73913;202010;352590;G;4744005;5;1;4
73973;202010;352590;C;2222600;5;9;-4
74720;202010;352590;G;4789099;2;0;2
74762;202010;352590;H;4930202;8;2;6
74763;202010;352590;H;4930202;18;2;16
75038;202010;352590;H;5120000;1;0;1
75777;202010;352590;G;4744005;3;1;2
75840;202010;352590;I;5611203;1;2;-1
75841;202010;352590;G;4637106;10;3;7
75862;202010;352590;G;4774100;1;1;0
76380;202010;352590;G;4744005;1;0;1
77232;202010;352590;I;5510803;1;1;0
77489;202010;352590;Q;8630501;2;0;2
78113;202010;352590;I;5620103;1;0;1
78194;202010;352590;P;8599601;1;0;1
78195;202010;352590;P;8599601;0;1;-1
78267;202010;352590;G;4649499;2;2;0
78722;202010;352590;N;8211300;1;1;0
78797;202010;352590;J;6203100;0;1;-1
78919;202010;352590;Q;8630504;1;0;1
78978;202010;352590;N;8291100;1;1;0
79508;202010;352590;G;4781400;0;1;-1
79529;202010;352590;G;4530703;1;2;-1
79932;202010;352590;G;4672900;1;1;0
80025;202010;352590;I;5611201;9;9;0
80028;202010;352590;I;5611201;3;0;3
80280;202010;352590;N;8299799;11;8;3
80331;202010;352590;Q;8711502;2;2;0
80611;202010;352590;J;6203100;0;1;-1
80821;202010;352590;N;7820500;2;1;1
80841;202010;352590;G;4742300;0;2;-2
81207;202010;352590;F;4120400;0;1;-1
81253;202010;352590;F;4120400;1;5;-4
81501;202010;352590;H;4930202;3;0;3
81559;202010;352590;G;4639701;0;1;-1
81676;202010;352590;Q;8650004;0;1;-1
82555;202010;352590;H;4930202;5;0;5
82811;202010;352590;I;5611201;0;1;-1
82868;202010;352590;N;8121400;1;0;1
82937;202010;352590;H;4930201;4;3;1
83223;202010;352590;C;2029100;1;1;0
83547;202010;352590;H;5112901;0;1;-1
83584;202010;352590;F;4399104;0;1;-1
83928;202010;352590;G;4520001;1;1;0
84200;202010;352590;C;2945000;0;1;-1
84654;202010;352590;P;8532500;3;2;1
84755;202010;352590;P;8599699;0;1;-1
85258;202010;352590;G;4541202;1;1;0
86787;202010;352590;Q;8630501;1;0;1
86848;202010;352590;G;4782202;1;1;0
87058;202010;352590;C;3314721;43;41;2
87915;202010;352590;F;4299599;11;0;11
87918;202010;352590;F;4299599;4;14;-10
88383;202010;352590;Q;8640210;1;1;0
88384;202010;352590;Q;8640210;1;0;1
88385;202010;352590;N;8211300;1;1;0
88709;202010;352590;G;4753900;2;1;1
88862;202010;352590;M;7112000;2;0;2
88880;202010;352590;G;4731800;2;1;1
88929;202010;352590;C;2599399;2;0;2
88950;202010;352590;G;4639701;14;12;2
89641;202010;352590;F;4110700;1;0;1
89944;202010;352590;C;2869100;1;0;1
90193;202010;352590;H;5250804;2;2;0
90337;202010;352590;G;4751201;0;1;-1
90887;202010;352590;N;8299799;3;2;1
91615;202010;352590;G;4712100;0;1;-1
91830;202010;352590;E;3839499;0;1;-1
92082;202010;352590;F;4221905;0;3;-3
92914;202010;352590;P;8512100;1;1;0
93369;202010;352590;G;4789007;0;1;-1
93581;202010;352590;N;7732201;0;1;-1
93658;202010;352590;K;6622300;1;0;1
93660;202010;352590;M;6920601;1;0;1
93720;202010;352590;H;5250804;30;19;11
93802;202010;352590;G;4781400;0;1;-1
94118;202010;352590;C;3321000;0;2;-2
94550;202010;352590;C;3250706;0;1;-1
95583;202010;352590;P;8599603;0;5;-5
96879;202010;352590;G;4520001;2;0;2
97435;202010;352590;Q;8650099;10;7;3
97533;202010;352590;R;9313100;1;1;0
97647;202010;352590;G;4789007;1;2;-1
97672;202010;352590;C;2949299;1;2;-1
97754;202010;352590;G;4753900;0;1;-1
98285;202010;352590;G;4744005;0;1;-1
98296;202010;352590;F;4321500;0;1;-1
99331;202010;352590;G;4781400;0;1;-1
99958;202010;352590;H;4930201;3;5;-2
100978;202010;352590;C;2222600;4;5;-1
101071;202010;352590;G;4724500;26;11;15
101245;202010;352590;I;5611202;0;1;-1
101598;202010;352590;R;9313100;0;1;-1
101622;202010;352590;G;4743100;1;0;1
101761;202010;352590;G;4712100;1;0;1
102226;202010;352590;I;5510803;2;0;2
102518;202010;352590;G;4511101;2;0;2
103027;202010;352590;Q;8640210;1;0;1
103774;202010;352590;G;4672900;1;1;0
103959;202010;352590;C;1412601;1;0;1
104011;202010;352590;F;4299599;0;3;-3
104244;202010;352590;R;9313100;1;1;0
104447;202010;352590;G;4784900;0;1;-1
104718;202010;352590;G;4520002;0;1;-1
104805;202010;352590;S;9430800;5;2;3
106012;202010;352590;Q;8630504;2;0;2
107913;202010;352590;I;5611203;0;1;-1
107914;202010;352590;I;5611201;1;0;1
107928;202010;352590;G;4781400;1;0;1
108365;202010;352590;J;5914600;0;2;-2
108424;202010;352590;G;4744002;1;0;1
108440;202010;352590;G;4751201;1;0;1
108454;202010;352590;G;4530703;5;2;3
108470;202010;352590;I;5611201;1;1;0
108756;202010;352590;H;4930202;0;1;-1
108963;202010;352590;G;4731800;2;1;1
108968;202010;352590;G;4782201;4;4;0
108987;202010;352590;F;4313400;2;1;1
109283;202010;352590;M;6920601;0;1;-1
109402;202010;352590;G;4723700;2;0;2
109491;202010;352590;F;4313400;3;18;-15
109568;202010;352590;P;8512100;1;0;1
109663;202010;352590;G;4511101;3;2;1
110034;202010;352590;F;4330404;3;0;3
110486;202010;352590;R;9313100;0;1;-1
111552;202010;352590;P;8512100;0;1;-1
111642;202010;352590;J;6201501;1;2;-1
112012;202010;352590;M;6920601;0;1;-1
112252;202010;352590;G;4687703;1;0;1
112503;202010;352590;G;4712100;1;0;1
112524;202010;352590;G;4729699;0;1;-1
112997;202010;352590;G;4722901;1;0;1
113054;202010;352590;N;7820500;199;115;84
114127;202010;352590;Q;8712300;4;3;1
114595;202010;352590;H;5240199;0;1;-1
114709;202010;352590;F;4330404;0;1;-1
114797;202010;352590;J;6202300;1;2;-1
116049;202010;352590;M;7319099;0;1;-1
116390;202010;352590;G;4744002;0;1;-1
116429;202010;352590;G;4774100;1;1;0
116842;202010;352590;I;5620103;0;1;-1
117022;202010;352590;G;4541203;1;0;1
117243;202010;352590;G;4712100;0;1;-1
117915;202010;352590;R;9313100;1;0;1
118408;202010;352590;G;4774100;0;1;-1
118719;202010;352590;I;5611201;1;0;1
118721;202010;352590;N;8299799;1;3;-2
118868;202010;352590;G;4721102;0;1;-1
118964;202010;352590;C;2222600;2;2;0
119070;202010;352590;G;4744003;1;0;1
120250;202010;352590;G;4693100;0;2;-2
120425;202010;352590;G;4711302;9;10;-1
120455;202010;352590;G;4774100;0;1;-1
120600;202010;352590;G;4753900;1;0;1
120794;202010;352590;G;4771701;1;1;0
121117;202010;352590;G;4751201;2;0;2
122375;202010;352590;C;2823200;2;0;2
122594;202010;352590;C;2825900;0;1;-1
122649;202010;352590;G;4772500;1;3;-2
122656;202010;352590;G;4772500;3;4;-1
122815;202010;352590;H;4929902;1;1;0
124073;202010;352590;P;8512100;2;1;1
124273;202010;352590;G;4759899;4;3;1
124275;202010;352590;G;4759899;2;0;2
124276;202010;352590;G;4759899;0;2;-2
124285;202010;352590;G;4649499;0;5;-5
124376;202010;352590;G;4761001;1;1;0
124998;202010;352590;G;4753900;3;0;3
125027;202010;352590;G;4744002;0;1;-1
125205;202010;352590;H;4930203;1;2;-1
125238;202010;352590;N;8299799;1;1;0
125318;202010;352590;N;8299799;0;9;-9
125736;202010;352590;C;1099699;10;8;2
126436;202010;352590;C;1091102;2;0;2
126867;202010;352590;G;4711302;8;5;3
127008;202010;352590;G;4711301;21;26;-5
127226;202010;352590;G;4711302;0;1;-1
127290;202010;352590;F;4322302;1;0;1
127339;202010;352590;G;4689399;0;1;-1
127795;202010;352590;C;2829199;1;4;-3
127838;202010;352590;I;5611201;0;1;-1
127847;202010;352590;I;5611201;2;0;2
127949;202010;352590;N;8219999;1;1;0
128129;202010;352590;P;8531700;4;3;1
129319;202010;352590;G;4789002;0;1;-1
129475;202010;352590;C;2591800;3;0;3
130228;202010;352590;G;4761001;3;2;1
130959;202010;352590;G;4511102;0;1;-1
131684;202010;352590;F;4120400;2;0;2
132063;202010;352590;G;4530703;0;1;-1
132173;202010;352590;F;4313400;0;12;-12
132746;202010;352590;G;4744099;1;0;1
132953;202010;352590;C;1013902;17;1;16
133141;202010;352590;G;4669999;0;1;-1
133669;202010;352590;H;4930202;1;0;1
134198;202010;352590;G;4712100;1;6;-5
134375;202010;352590;G;4789002;3;2;1
134805;202010;352590;G;4763602;4;2;2
135191;202010;352590;H;4930202;10;4;6
136271;202010;352590;J;6209100;1;0;1
137002;202010;352590;I;5611203;0;1;-1
137084;202010;352590;I;5611201;0;1;-1
137294;202010;352590;J;5829800;0;1;-1
137745;202010;352590;G;4731800;0;10;-10
137789;202010;352590;N;8299799;8;8;0
138544;202010;352590;G;4781400;1;1;0
139396;202010;352590;F;4330401;3;0;3
139449;202010;352590;G;4687702;0;1;-1
139705;202010;352590;C;2710402;2;3;-1
139866;202010;352590;G;4520001;0;1;-1
139928;202010;352590;G;4711302;4;15;-11
140282;202010;352590;H;4930202;0;2;-2
141496;202010;352590;G;4763603;0;1;-1
141546;202010;352590;G;4731800;1;0;1
141685;202010;352590;I;5611201;1;0;1
141824;202010;352590;C;2599399;1;0;1
141998;202010;352590;N;8011101;36;9;27
142131;202010;352590;G;4754701;0;1;-1
142849;202010;352590;K;6424703;1;0;1
142851;202010;352590;K;6424703;0;1;-1
142909;202010;352590;N;8291100;0;1;-1
143319;202010;352590;H;4930202;1;0;1
143760;202010;352590;N;8211300;2;5;-3
143935;202010;352590;G;4729699;0;1;-1
144101;202010;352590;G;4530703;3;1;2
144538;202010;352590;G;4781400;10;5;5
145071;202010;352590;C;2790299;12;5;7
145081;202010;352590;G;4530703;2;2;0
145131;202010;352590;G;4754702;1;0;1
145760;202010;352590;H;4930202;1;1;0
145881;202010;352590;G;4530703;0;1;-1
146068;202010;352590;E;3701100;4;1;3
146100;202010;352590;H;4930201;2;0;2
146136;202010;352590;C;1053800;3;0;3
146306;202010;352590;Q;8630501;13;5;8
146311;202010;352590;G;4774100;0;1;-1
146613;202010;352590;P;8511200;0;1;-1
146701;202010;352590;G;4633801;25;24;1
147726;202010;352590;G;4744099;1;0;1
148038;202010;352590;P;8599605;0;1;-1
148154;202010;352590;M;7120100;0;1;-1
148420;202010;352590;C;2622100;0;7;-7
148980;202010;352590;N;8111700;5;0;5
149565;202010;352590;F;4299599;1;0;1
149577;202010;352590;F;4299599;3;3;0
149647;202010;352590;G;4685100;0;2;-2
149772;202010;352590;G;4713002;1;0;1
149773;202010;352590;G;4713002;0;1;-1
149849;202010;352590;C;2071100;1;0;1
150593;202010;352590;S;9430800;0;1;-1
150601;202010;352590;G;4530703;0;1;-1
150792;202010;352590;P;8599604;0;1;-1
150793;202010;352590;G;4761001;2;0;2
150965;202010;352590;I;5620101;1;0;1
151142;202010;352590;G;4741500;2;0;2
151245;202010;352590;G;4771701;0;1;-1
151249;202010;352590;G;4771701;0;2;-2
151250;202010;352590;G;4771701;0;1;-1
151381;202010;352590;H;5223100;2;0;2
151390;202010;352590;I;5620101;2;0;2
151466;202010;352590;I;5611201;2;0;2
151475;202010;352590;G;4744003;1;0;1
151659;202010;352590;M;6920601;0;1;-1
152560;202010;352590;I;5611201;0;1;-1
153169;202010;352590;H;4930202;1;0;1
153930;202010;352590;H;4930202;1;0;1
153931;202010;352590;H;4930202;0;1;-1
153969;202010;352590;G;4741500;0;1;-1
153970;202010;352590;G;4741500;0;1;-1
153971;202010;352590;G;4741500;1;0;1
153993;202010;352590;G;4731800;1;0;1
154248;202010;352590;C;2029100;4;6;-2
154273;202010;352590;G;4635402;0;4;-4
154805;202010;352590;H;4930202;1;0;1
155112;202010;352590;G;4520004;0;1;-1
155733;202010;352590;H;4930202;1;2;-1
155893;202010;352590;M;6920601;0;1;-1
156203;202010;352590;R;9313100;2;2;0
156237;202010;352590;R;9313100;1;1;0
156365;202010;352590;G;4754703;2;4;-2
157816;202010;352590;G;4721102;0;1;-1
157881;202010;352590;G;4731800;1;0;1
158407;202010;352590;G;4772500;1;0;1
158561;202010;352590;J;6201501;1;1;0
158724;202010;352590;I;5510801;0;1;-1
159399;202010;352590;J;6201500;2;0;2
159497;202010;352590;G;4771702;1;0;1
159653;202010;352590;H;4930202;0;1;-1
159883;202010;352590;G;4781400;1;0;1
160181;202010;352590;I;5620104;1;0;1
160339;202010;352590;G;4772500;2;0;2
160683;202010;352590;N;8112500;1;2;-1
160706;202010;352590;C;1053800;3;2;1
161124;202010;352590;H;4930201;0;1;-1
161224;202010;352590;G;4754702;3;0;3
162165;202010;352590;C;1032599;2;0;2
162262;202010;352590;C;1099601;1;2;-1
162351;202010;352590;I;5611201;0;1;-1
162387;202010;352590;G;4530703;0;1;-1
162395;202010;352590;P;8520100;1;0;1
162687;202010;352590;C;1042200;2;0;2
162829;202010;352590;P;8513900;1;1;0
162832;202010;352590;P;8513900;1;0;1
162978;202010;352590;A;210107;0;1;-1
163070;202010;352590;Q;8650004;1;0;1
163299;202010;352590;H;4930202;1;0;1
163304;202010;352590;I;5510801;0;1;-1
163505;202010;352590;G;4712100;1;0;1
163914;202010;352590;H;5212500;0;2;-2
164238;202010;352590;N;7911200;0;1;-1
164928;202010;352590;I;5611203;5;0;5
165067;202010;352590;J;6190699;1;1;0
165420;202010;352590;A;133499;1;0;1
165946;202010;352590;M;6920601;1;1;0
165983;202010;352590;G;4721102;0;1;-1
166045;202010;352590;M;7112000;0;1;-1
166372;202010;352590;N;7711000;3;0;3
166645;202010;352590;I;5611203;1;0;1
166674;202010;352590;I;5611203;2;1;1
166678;202010;352590;I;5611203;1;0;1
167488;202010;352590;N;8112500;1;0;1
167785;202010;352590;J;5813100;1;0;1
167800;202010;352590;G;4782201;1;0;1
168226;202010;352590;G;4729699;1;1;0
168735;202010;352590;K;6622300;0;1;-1
169348;202010;352590;G;4753900;7;2;5
169349;202010;352590;G;4753900;4;3;1
169803;202010;352590;N;8299799;1;0;1
169960;202010;352590;G;4781400;1;0;1
170214;202010;352590;G;4639701;0;1;-1
170812;202010;352590;G;4530703;2;3;-1
171109;202010;352590;G;4781400;3;1;2
171827;202010;352590;G;4744001;0;1;-1
172029;202010;352590;M;7490104;1;0;1
172225;202010;352590;G;4755502;1;0;1
172253;202010;352590;I;5611201;0;1;-1
172557;202010;352590;C;2621300;9;87;-78
172558;202010;352590;C;2632900;30;46;-16
172625;202010;352590;N;8299799;131;99;32
172648;202010;352590;G;4742300;1;0;1
173510;202010;352590;G;4729699;3;0;3
173813;202010;352590;Q;8630503;0;1;-1
173835;202010;352590;G;4724500;0;1;-1
174223;202010;352590;C;2229303;0;2;-2
174348;202010;352590;H;5212500;26;4;22
174515;202010;352590;G;4761001;1;1;0
174862;202010;352590;H;4930202;0;1;-1
175170;202010;352590;M;6920601;0;1;-1
175420;202010;352590;H;5112901;2;0;2
175622;202010;352590;P;8599604;0;1;-1
175802;202010;352590;I;5611201;0;1;-1
175956;202010;352590;G;4731800;1;2;-1
176056;202010;352590;H;4930202;0;1;-1
176362;202010;352590;F;4321500;3;0;3
176448;202010;352590;N;7732201;1;0;1
176755;202010;352590;G;4744099;0;1;-1
176868;202010;352590;N;7830200;1;1;0
177086;202010;352590;I;5611203;0;1;-1
177247;202010;352590;P;8513900;1;0;1
177348;202010;352590;C;3313999;3;0;3
177877;202010;352590;J;6201501;1;0;1
178587;202010;352590;H;4930202;4;3;1
178638;202010;352590;G;4530703;0;1;-1
178838;202010;352590;F;4399199;1;0;1
178891;202010;352590;G;4731800;0;2;-2
179827;202010;352590;Q;8630501;1;2;-1
180178;202010;352590;J;5829800;0;1;-1
180348;202010;352590;F;4120400;3;0;3
180463;202010;352590;G;4712100;0;2;-2
180807;202010;352590;G;4530703;1;1;0
181269;202010;352590;G;4744001;0;1;-1
182136;202010;352590;G;4789004;1;1;0
182635;202010;352590;F;4213800;2;4;-2
183472;202010;352590;C;2539001;1;0;1
183473;202010;352590;G;4663000;2;0;2
183661;202010;352590;H;5212500;25;16;9
183667;202010;352590;G;4729699;1;0;1
183755;202010;352590;N;8111700;11;10;1
183801;202010;352590;G;4721104;1;0;1
183982;202010;352590;G;4672900;1;0;1
184821;202010;352590;N;7820500;3;1;2
184890;202010;352590;G;4511101;1;2;-1
186111;202010;352590;Q;8640212;1;0;1
186522;202010;352590;H;4930202;0;1;-1
186593;202010;352590;Q;8630503;0;1;-1
187004;202010;352590;S;9420100;1;0;1
187005;202010;352590;S;9420100;0;1;-1
187139;202010;352590;G;4729699;2;5;-3
187672;202010;352590;F;4110700;2;1;1
188634;202010;352590;I;5611203;1;0;1
188828;202010;352590;H;4930202;2;2;0
189012;202010;352590;F;4222701;3;2;1
189258;202010;352590;G;4789099;2;1;1
189482;202010;352590;G;4686902;3;8;-5
189937;202010;352590;G;4530703;1;0;1
189981;202010;352590;Q;8711502;1;1;0
190324;202010;352590;I;5611201;0;1;-1
190345;202010;352590;I;5611201;1;3;-2
190352;202010;352590;I;5611201;0;1;-1
190380;202010;352590;G;4784900;0;1;-1
190517;202010;352590;G;4759899;1;0;1
190675;202010;352590;I;5611203;1;0;1
190748;202010;352590;C;2222600;5;2;3
191552;202010;352590;G;4511101;5;1;4
191846;202010;352590;G;4729699;0;1;-1
192413;202010;352590;G;4789099;2;0;2
192756;202010;352590;N;7740300;1;0;1
192910;202010;352590;G;4774100;1;0;1
193304;202010;352590;N;8111700;0;1;-1
193320;202010;352590;I;5611201;0;1;-1
193371;202010;352590;H;4930201;1;0;1
193743;202010;352590;G;4754701;4;7;-3
193745;202010;352590;G;4754701;0;1;-1
193748;202010;352590;G;4754701;0;2;-2
194218;202010;352590;H;4930201;1;1;0
194763;202010;352590;G;4724500;2;0;2
195213;202010;352590;I;5611201;0;2;-2
195608;202010;352590;P;8541400;0;1;-1
195619;202010;352590;I;5611201;1;0;1
196903;202010;352590;G;4731800;0;1;-1
197302;202010;352590;G;4789005;3;1;2
197518;202010;352590;F;4330404;1;0;1
197519;202010;352590;F;4330404;1;2;-1
197520;202010;352590;N;7830200;20;17;3
197770;202010;352590;G;4754701;1;2;-1
198721;202010;352590;M;7112000;6;4;2
198722;202010;352590;J;6204000;1;0;1
199417;202010;352590;H;5223100;0;1;-1
200125;202010;352590;K;6622300;0;1;-1
200406;202010;352590;G;4771701;0;1;-1
200897;202010;352590;F;4321500;2;0;2
201254;202010;352590;I;5611201;3;2;1
201989;202010;352590;N;8011101;2;1;1
202295;202010;352590;G;4713002;2;4;-2
202619;202010;352590;G;4711302;1;1;0
202649;202010;352590;G;4511101;1;1;0
203056;202010;352590;N;7739099;0;1;-1
203486;202010;352590;Q;8610101;8;6;2
204062;202010;352590;N;8219999;3;0;3
204063;202010;352590;N;8219999;0;2;-2
204069;202010;352590;G;4686902;1;0;1
204123;202010;352590;G;4724500;13;3;10
204124;202010;352590;G;4633801;2;1;1
204125;202010;352590;G;4724500;15;13;2
204312;202010;352590;G;4781400;1;0;1
205319;202010;352590;M;7500100;0;1;-1
205572;202010;352590;C;2222600;0;1;-1
205946;202010;352590;G;4789004;1;0;1
205986;202010;352590;G;4784900;1;0;1
206208;202010;352590;G;4721102;2;0;2
206300;202010;352590;J;5914600;0;1;-1
206444;202010;352590;C;1112700;1;0;1
206503;202010;352590;I;5611201;0;1;-1
206717;202010;352590;P;8599601;1;1;0
207246;202010;352590;I;5510801;0;2;-2
207250;202010;352590;I;5510801;4;0;4
207406;202010;352590;H;5250805;0;1;-1
207448;202010;352590;C;2621300;1;3;-2
207674;202010;352590;G;4772500;0;1;-1
207955;202010;352590;G;4691500;4;11;-7
208379;202010;352590;C;3291400;1;3;-2
208514;202010;352590;Q;8650003;2;0;2
208519;202010;352590;G;4751201;1;0;1
208521;202010;352590;J;6190601;3;0;3
208879;202010;352590;K;6462000;0;2;-2
209338;202010;352590;F;4399103;3;0;3
209357;202010;352590;G;4520006;0;1;-1
209378;202010;352590;C;2511000;4;1;3
209556;202010;352590;I;5611201;1;1;0
210413;202010;352590;N;7732201;0;1;-1
210564;202010;352590;I;5611201;4;0;4
210954;202010;352590;G;4731800;0;1;-1
211097;202010;352590;M;6920601;0;1;-1
211660;202010;352590;N;8299799;0;2;-2
211752;202010;352590;H;5211701;0;1;-1
211923;202010;352590;M;7111100;0;1;-1
211988;202010;352590;C;3329501;0;1;-1
212124;202010;352590;G;4618402;4;1;3
212548;202010;352590;G;4757100;2;0;2
212652;202010;352590;I;5611203;1;2;-1
212774;202010;352590;G;4771701;0;1;-1
212864;202010;352590;Q;8640205;0;1;-1
212870;202010;352590;R;9313100;0;1;-1
213054;202010;352590;G;4712100;0;1;-1
214376;202010;352590;G;4647801;1;1;0
214385;202010;352590;G;4511101;0;4;-4
214705;202010;352590;H;5211701;0;3;-3
215358;202010;352590;G;4731800;0;1;-1
215380;202010;352590;G;4782201;3;1;2
215573;202010;352590;N;8211300;0;1;-1
215675;202010;352590;G;4520004;2;0;2
216216;202010;352590;G;4754701;58;1;57
216607;202010;352590;N;8211300;10;2;8
217358;202010;352590;N;8220200;0;1;-1
217736;202010;352590;N;8299706;1;0;1
217796;202010;352590;G;4530703;0;1;-1
219787;202010;352590;G;4744099;1;0;1
219839;202010;352590;N;7739099;0;1;-1
219873;202010;352590;H;5250804;1;1;0
220403;202010;352590;G;4761003;0;1;-1
221371;202010;352590;G;4742300;1;0;1
221727;202010;352590;M;7500100;0;1;-1
221728;202010;352590;M;7500100;0;1;-1
221963;202010;352590;H;4930202;1;3;-2
222091;202010;352590;M;6920601;1;0;1
222202;202010;352590;J;6204000;1;0;1
223553;202010;352590;G;4759899;0;1;-1
223866;202010;352590;C;2222600;11;10;1
224020;202010;352590;F;4292802;9;0;9
224414;202010;352590;G;4771701;1;0;1
224429;202010;352590;C;3314707;3;1;2
225636;202010;352590;N;8020001;1;1;0
225638;202010;352590;K;6462000;2;0;2
225785;202010;352590;H;4930202;4;0;4
225984;202010;352590;G;4789004;1;0;1
226637;202010;352590;C;1629301;0;1;-1
226849;202010;352590;G;4731800;2;0;2
227755;202010;352590;S;9609299;2;0;2
227768;202010;352590;N;8299799;2;4;-2
228192;202010;352590;G;4511101;1;0;1
229665;202010;352590;Q;8630502;1;0;1
229849;202010;352590;F;4321500;3;4;-1
229995;202010;352590;M;7311400;0;1;-1
230400;202010;352590;M;6920601;2;2;0
230900;202010;352590;F;4330401;0;1;-1
231617;202010;352590;G;4729699;1;1;0
232596;202010;352590;G;4651601;1;0;1
232627;202010;352590;H;4930202;30;12;18
232814;202010;352590;F;4213800;1;1;0
232897;202010;352590;C;1099699;1;0;1
234212;202010;352590;C;1099699;1;1;0
234395;202010;352590;G;4646001;1;0;1
234599;202010;352590;G;4530703;0;1;-1
235175;202010;352590;C;3211602;3;0;3
235192;202010;352590;G;4712100;1;0;1
235238;202010;352590;G;4669999;0;2;-2
235401;202010;352590;G;4520001;1;0;1
236136;202010;352590;G;4623109;1;4;-3
236137;202010;352590;G;4623109;1;0;1
236160;202010;352590;G;4781400;19;46;-27
236172;202010;352590;G;4511104;0;2;-2
236201;202010;352590;P;8513900;1;0;1
236204;202010;352590;N;8130300;13;14;-1
236205;202010;352590;G;4789099;9;3;6
236286;202010;352590;S;9602501;1;0;1
236466;202010;352590;Q;8630501;1;0;1
236830;202010;352590;S;9601701;1;0;1
237174;202010;352590;C;2840200;2;0;2
237227;202010;352590;N;8219999;0;1;-1
237698;202010;352590;C;3250706;1;0;1
237699;202010;352590;C;3250706;0;1;-1
237879;202010;352590;G;4782201;2;2;0
237880;202010;352590;G;4781400;2;0;2
237882;202010;352590;G;4781400;1;0;1
238138;202010;352590;G;4633801;1;1;0
238140;202010;352590;A;132600;0;1;-1
238378;202010;352590;M;6920601;1;0;1
238478;202010;352590;N;8299799;1;0;1
238539;202010;352590;L;6821802;1;0;1
238920;202010;352590;N;8299799;1;3;-2
239254;202010;352590;C;2311700;0;1;-1
239255;202010;352590;G;4744002;0;1;-1
239963;202010;352590;G;4751201;1;1;0
239986;202010;352590;H;5212500;1;4;-3
240359;202010;352590;C;3314721;1;0;1
240406;202010;352590;C;2349401;6;2;4
240884;202010;352590;Q;8630501;1;2;-1
241219;202010;352590;M;7500100;1;1;0
242003;202010;352590;M;7490199;1;1;0
242357;202010;352590;G;4773300;0;1;-1
242739;202010;352590;N;8211300;1;3;-2
244226;202010;352590;F;4292801;1;0;1
244265;202010;352590;C;2072000;2;0;2
244279;202010;352590;N;8011101;3;4;-1
244775;202010;352590;R;9313100;0;2;-2
245078;202010;352590;G;4633801;1;1;0
245440;202010;352590;P;8599604;0;1;-1
245557;202010;352590;G;4649499;4;3;1
245996;202010;352590;I;5611201;0;1;-1
247177;202010;352590;C;2599399;1;0;1
247259;202010;352590;J;6209100;1;0;1
247317;202010;352590;G;4782201;1;0;1
247318;202010;352590;G;4782201;0;1;-1
247544;202010;352590;C;3101200;1;0;1
247765;202010;352590;M;7490199;1;0;1
248298;202010;352590;C;1091101;10;6;4
249405;202010;352590;J;6204000;0;1;-1
250191;202010;352590;C;1733800;3;3;0
250549;202010;352590;C;3314713;1;0;1
250766;202010;352590;G;4721102;1;1;0
250780;202010;352590;P;8599603;0;2;-2
251026;202010;352590;C;3314799;2;4;-2
251223;202010;352590;I;5611201;0;1;-1
251799;202010;352590;G;4520001;0;1;-1
253179;202010;352590;L;6822600;1;0;1
253293;202010;352590;F;4120400;4;3;1
253399;202010;352590;M;7420004;0;1;-1
253676;202010;352590;H;5250805;3;1;2
253849;202010;352590;C;2790299;2;1;1
254229;202010;352590;J;5811500;2;1;1
254299;202010;352590;M;6920601;1;0;1
254620;202010;352590;F;4322302;5;1;4
254825;202010;352590;L;6821802;5;0;5
255395;202010;352590;I;5611201;0;2;-2
255612;202010;352590;I;5611202;1;1;0
255713;202010;352590;H;4930202;1;0;1
255958;202010;352590;S;9609203;1;1;0
255959;202010;352590;G;4511102;2;0;2
256172;202010;352590;C;1733800;13;4;9
256426;202010;352590;F;4322301;0;1;-1
256534;202010;352590;G;4530703;0;1;-1
256696;202010;352590;S;9601701;4;1;3
256807;202010;352590;P;8593700;0;1;-1
257525;202010;352590;G;4689301;1;0;1
257558;202010;352590;M;6920601;0;1;-1
257657;202010;352590;G;4789005;0;1;-1
257786;202010;352590;G;4713002;0;1;-1
258538;202010;352590;G;4761001;0;1;-1
258912;202010;352590;F;4399103;5;0;5
259188;202010;352590;G;4781400;0;2;-2
259342;202010;352590;C;1066000;23;17;6
259761;202010;352590;G;4781400;4;4;0
259762;202010;352590;G;4781400;0;5;-5
259839;202010;352590;H;4930202;49;15;34
259868;202010;352590;S;9521500;3;2;1
260483;202010;352590;C;3250705;3;3;0
261073;202010;352590;M;7490199;5;2;3
261107;202010;352590;E;3821100;7;8;-1
261110;202010;352590;I;5611201;0;1;-1
261150;202010;352590;K;6462000;3;0;3
261200;202010;352590;N;8111700;16;19;-3
261366;202010;352590;G;4772500;2;2;0
261367;202010;352590;G;4757100;1;0;1
261404;202010;352590;F;4330499;4;2;2
261902;202010;352590;N;7911200;1;0;1
262480;202010;352590;F;4120400;0;8;-8
262596;202010;352590;G;4744001;2;0;2
262926;202010;352590;M;7112000;0;1;-1
263109;202010;352590;G;4783101;0;1;-1
263139;202010;352590;I;5510801;0;1;-1
263444;202010;352590;I;5611201;7;4;3
263597;202010;352590;G;4771704;1;0;1
263651;202010;352590;G;4755503;0;1;-1
263748;202010;352590;I;5611201;0;1;-1
263855;202010;352590;G;4712100;1;2;-1
264122;202010;352590;M;7490104;0;1;-1
264518;202010;352590;G;4744099;2;0;2
264928;202010;352590;N;8111700;1;1;0
265169;202010;352590;G;4759899;0;1;-1
265260;202010;352590;G;4755503;1;0;1
265836;202010;352590;J;6190601;1;0;1
265839;202010;352590;N;8121400;0;1;-1
265845;202010;352590;G;4520005;3;3;0
265953;202010;352590;C;2342702;6;1;5
265972;202010;352590;G;4744001;2;2;0
266274;202010;352590;M;6920601;1;0;1
266377;202010;352590;G;4782201;1;0;1
266402;202010;352590;Q;8630503;1;0;1
266479;202010;352590;F;4120400;0;1;-1
266849;202010;352590;G;4771701;0;1;-1
266861;202010;352590;F;4322302;2;0;2
267428;202010;352590;P;8511200;0;1;-1
267429;202010;352590;P;8511200;0;1;-1
267614;202010;352590;L;6821801;1;1;0
268032;202010;352590;R;9329804;4;1;3
268044;202010;352590;N;7732201;1;0;1
268885;202010;352590;P;8511200;0;2;-2
268886;202010;352590;P;8511200;0;2;-2
269931;202010;352590;G;4754701;1;0;1
270050;202010;352590;S;9602502;1;0;1
270309;202010;352590;P;8511200;0;1;-1
270863;202010;352590;G;4772500;2;0;2
270865;202010;352590;H;4930202;0;2;-2
272893;202010;352590;G;4772500;0;1;-1
272895;202010;352590;G;4772500;0;1;-1
273255;202010;352590;S;9511800;0;1;-1
273696;202010;352590;G;4530701;0;1;-1
273888;202010;352590;N;8111700;2;1;1
274501;202010;352590;N;8291100;0;3;-3
274658;202010;352590;G;4691500;2;21;-19
274716;202010;352590;I;5620104;1;0;1
275905;202010;352590;G;4637199;1;1;0
276030;202010;352590;M;7119701;0;1;-1
276160;202010;352590;M;7311400;2;0;2
276280;202010;352590;I;5611203;0;2;-2
276288;202010;352590;I;5611203;6;3;3
276772;202010;352590;I;5611203;4;2;2
276960;202010;352590;C;1091102;1;0;1
277256;202010;352590;G;4687702;1;0;1
277327;202010;352590;G;4520007;1;0;1
277443;202010;352590;C;3314704;2;0;2
277444;202010;352590;C;3314704;0;1;-1
277881;202010;352590;F;4330403;0;1;-1
277884;202010;352590;F;4330499;0;1;-1
277885;202010;352590;F;4330499;1;0;1
278288;202010;352590;G;4781400;1;0;1
278657;202010;352590;N;7733100;1;0;1
278883;202010;352590;L;6810201;0;8;-8
279121;202010;352590;F;4330404;0;1;-1
279271;202010;352590;N;8299706;2;0;2
279340;202010;352590;K;6612603;0;1;-1
279567;202010;352590;N;7733100;1;0;1
279570;202010;352590;N;7733100;0;1;-1
279616;202010;352590;G;4637199;0;4;-4
280320;202010;352590;I;5611201;5;1;4
280549;202010;352590;G;4619200;0;1;-1
280899;202010;352590;N;8299706;1;0;1
280902;202010;352590;Q;8630502;1;1;0
281095;202010;352590;G;4712100;1;0;1
281521;202010;352590;G;4689399;1;1;0
281635;202010;352590;P;8511200;0;1;-1
281730;202010;352590;G;4520002;0;2;-2
281780;202010;352590;H;4930201;3;2;1
281973;202010;352590;S;9511800;2;0;2
282303;202010;352590;F;4399101;1;1;0
282425;202010;352590;G;4669999;5;1;4
282515;202010;352590;N;7990200;0;1;-1
283083;202010;352590;R;9313100;0;1;-1
283294;202010;352590;G;4763601;1;2;-1
283398;202010;352590;G;4781400;1;0;1
284107;202010;352590;I;5611203;0;1;-1
284540;202010;352590;G;4752100;1;0;1
285453;202010;352590;D;3511502;1;1;0
286018;202010;352590;G;4756300;1;0;1
286558;202010;352590;G;4781400;0;1;-1
287151;202010;352590;G;4781400;1;1;0
287760;202010;352590;R;9313100;0;2;-2
287771;202010;352590;G;4772500;0;1;-1
287837;202010;352590;C;3314708;1;0;1
288189;202010;352590;G;4744005;0;1;-1
288592;202010;352590;C;2229399;1;0;1
288919;202010;352590;K;6619399;1;0;1
288920;202010;352590;K;6622300;0;1;-1
289060;202010;352590;G;4731800;1;0;1
289182;202010;352590;G;4763603;0;1;-1
289329;202010;352590;G;4646001;0;1;-1
289522;202010;352590;N;8230001;1;0;1
290113;202010;352590;M;6911701;0;1;-1
290187;202010;352590;C;2731700;1;2;-1
290247;202010;352590;J;6190601;0;1;-1
290687;202010;352590;G;4789099;1;0;1
290692;202010;352590;Q;8640205;2;1;1
290778;202010;352590;I;5611201;1;0;1
291369;202010;352590;N;8112500;2;3;-1
291379;202010;352590;N;7911200;1;0;1
291397;202010;352590;H;5211701;27;40;-13
291745;202010;352590;E;3812200;0;1;-1
291993;202010;352590;G;4744001;0;1;-1
292603;202010;352590;G;4530704;5;2;3
293156;202010;352590;C;2399101;6;0;6
293199;202010;352590;G;4530705;2;0;2
293807;202010;352590;M;7119704;1;1;0
294003;202010;352590;N;8111700;1;1;0
294364;202010;352590;I;5611203;1;0;1
294418;202010;352590;G;4754701;2;22;-20
295019;202010;352590;C;1091102;1;0;1
295157;202010;352590;G;4744099;2;2;0
295158;202010;352590;N;8299799;0;2;-2
295170;202010;352590;G;4771702;3;1;2
295173;202010;352590;C;1091101;3;5;-2
295177;202010;352590;C;2599399;0;3;-3
295226;202010;352590;G;4759899;0;1;-1
295349;202010;352590;C;3314708;6;2;4
295549;202010;352590;H;5223100;0;1;-1
296429;202010;352590;N;8211300;1;1;0
296531;202010;352590;C;1413401;0;2;-2
296606;202010;352590;H;4930202;0;1;-1
297310;202010;352590;G;4759899;0;4;-4
298135;202010;352590;G;4772500;2;0;2
299009;202010;352590;G;4721102;0;1;-1
299847;202010;352590;F;4120400;0;1;-1
300149;202010;352590;F;4399199;2;0;2
300716;202010;352590;G;4530703;0;1;-1
300839;202010;352590;G;4761001;2;1;1
301723;202010;352590;G;4751200;1;0;1
302092;202010;352590;G;4623109;1;1;0
302100;202010;352590;R;9313100;0;1;-1
302415;202010;352590;G;4763601;0;1;-1
302480;202010;352590;F;4322303;0;1;-1
302696;202010;352590;G;4713002;1;0;1
303234;202010;352590;G;4741500;1;0;1
303873;202010;352590;C;1052000;3;0;3
304004;202010;352590;G;4772500;1;1;0
304689;202010;352590;G;4741500;0;1;-1
304794;202010;352590;J;6209100;0;1;-1
304912;202010;352590;Q;8650003;1;0;1
305830;202010;352590;N;7810800;8;0;8
305838;202010;352590;G;4721104;12;5;7
305839;202010;352590;G;4637107;3;0;3
305872;202010;352590;H;4930202;2;2;0
305927;202010;352590;C;3101200;5;1;4
305928;202010;352590;G;4754701;3;1;2
306091;202010;352590;J;6209100;1;1;0
306328;202010;352590;C;3321000;1;0;1
306394;202010;352590;I;5611203;1;1;0
306493;202010;352590;G;4752100;2;2;0
306881;202010;352590;J;6190699;0;5;-5
306910;202010;352590;I;5611201;1;1;0
307293;202010;352590;C;1053800;6;3;3
307631;202010;352590;Q;8712300;3;1;2
307841;202010;352590;N;7911200;0;1;-1
307937;202010;352590;F;4120400;6;0;6
308147;202010;352590;G;4744099;2;7;-5
308317;202010;352590;G;4772500;1;0;1
308380;202010;352590;G;4781400;1;0;1
308490;202010;352590;N;8121400;0;2;-2
308525;202010;352590;N;7732201;0;1;-1
308927;202010;352590;M;6920601;0;1;-1
309031;202010;352590;I;5620104;0;1;-1
309214;202010;352590;P;8511200;0;5;-5
309217;202010;352590;I;5611201;1;1;0
309653;202010;352590;G;4783101;2;2;0
310158;202010;352590;G;4781400;1;0;1
310437;202010;352590;G;4789001;1;1;0
310645;202010;352590;M;7112000;3;0;3
311007;202010;352590;F;4120400;0;1;-1
311360;202010;352590;F;4399104;1;0;1
311635;202010;352590;C;2229303;1;0;1
311743;202010;352590;G;4782201;1;0;1
312397;202010;352590;I;5611203;3;2;1
312564;202010;352590;G;4781400;2;0;2
312721;202010;352590;F;4120400;0;1;-1
312823;202010;352590;M;7112000;17;2;15
312835;202010;352590;G;4712100;0;1;-1
313005;202010;352590;N;7711000;5;1;4
313171;202010;352590;S;9529105;1;0;1
313280;202010;352590;C;2823200;1;0;1
313370;202010;352590;Q;8630503;1;2;-1
313545;202010;352590;C;3101200;0;1;-1
314040;202010;352590;S;9521500;4;1;3
314460;202010;352590;P;8511200;0;1;-1
314862;202010;352590;I;5611201;0;1;-1
314889;202010;352590;N;8111700;0;1;-1
314898;202010;352590;I;5611201;2;1;1
315011;202010;352590;I;5611201;0;1;-1
315349;202010;352590;G;4782201;2;0;2
315852;202010;352590;I;5611203;0;2;-2
315957;202010;352590;G;4782201;1;0;1
316224;202010;352590;I;5611203;1;1;0
316282;202010;352590;I;5611201;0;1;-1
316316;202010;352590;N;8111700;10;0;10
316496;202010;352590;H;4930202;8;19;-11
316641;202010;352590;H;5211701;1;1;0
316955;202010;352590;I;5611201;0;1;-1
317272;202010;352590;G;4755502;0;1;-1
317557;202010;352590;H;4930201;0;1;-1
318307;202010;352590;G;4712100;0;1;-1
319123;202010;352590;N;8219999;1;0;1
319136;202010;352590;H;4930202;1;0;1
319687;202010;352590;I;5611203;0;1;-1
320020;202010;352590;C;2229302;1;1;0
320182;202010;352590;N;8112500;0;1;-1
320262;202010;352590;I;5611201;1;1;0
320265;202010;352590;R;9313100;1;0;1
320266;202010;352590;R;9313100;0;1;-1
320518;202010;352590;S;9603301;2;0;2
320679;202010;352590;H;4930202;0;1;-1
320863;202010;352590;K;6422100;1;2;-1
321130;202010;352590;Q;8630504;0;1;-1
321303;202010;352590;G;4721104;2;0;2
321368;202010;352590;H;5240199;4;1;3
322166;202010;352590;H;5112901;0;1;-1
322459;202010;352590;I;5611201;0;5;-5
323108;202010;352590;G;4754701;2;3;-1
323416;202010;352590;H;5229002;1;0;1
324081;202010;352590;I;5620103;0;1;-1
324597;202010;352590;Q;8630503;0;1;-1
325497;202010;352590;G;4742300;0;1;-1
325616;202010;352590;N;8121400;0;1;-1
326491;202010;352590;G;4774100;1;1;0
326628;202010;352590;G;4751201;2;1;1
327028;202010;352590;G;4763601;0;1;-1
327130;202010;352590;G;4520005;29;6;23
327494;202010;352590;M;7120100;2;0;2
327525;202010;352590;S;9602501;0;1;-1
327838;202010;352590;N;8219999;2;3;-1
327928;202010;352590;G;4721104;0;2;-2
328310;202010;352590;N;7911200;1;0;1
328904;202010;352590;F;4120400;7;11;-4
329157;202010;352590;H;4930202;0;1;-1
329301;202010;352590;G;4772500;0;1;-1
329590;202010;352590;G;4511102;1;0;1
329909;202010;352590;N;8112500;1;0;1
330128;202010;352590;G;4789004;1;0;1
330161;202010;352590;F;4120400;0;1;-1
330651;202010;352590;G;4541201;3;0;3
330721;202010;352590;Q;8711502;1;0;1
330876;202010;352590;G;4752100;5;1;4
331131;202010;352590;M;7312200;1;0;1
331616;202010;352590;F;4120400;3;1;2
331923;202010;352590;Q;8630503;1;1;0
331924;202010;352590;N;8111700;1;1;0
333269;202010;352590;G;4771702;3;3;0
333338;202010;352590;N;8299799;2;4;-2
333934;202010;352590;F;4222701;0;1;-1
333990;202010;352590;M;7020400;0;1;-1
334465;202010;352590;N;8211300;3;1;2
334513;202010;352590;M;7319002;0;1;-1
335349;202010;352590;S;9609299;0;1;-1
335514;202010;352590;M;6920601;0;1;-1
336416;202010;352590;S;9602501;1;1;0
336432;202010;352590;F;4120400;0;1;-1
336607;202010;352590;J;6209100;2;0;2
336674;202010;352590;H;4930201;0;5;-5
336676;202010;352590;H;4930201;9;4;5
337040;202010;352590;I;5611201;0;1;-1
337230;202010;352590;S;9602501;3;1;2
337527;202010;352590;G;4754701;1;0;1
337606;202010;352590;G;4634601;1;1;0
337639;202010;352590;G;4783102;0;1;-1
337993;202010;352590;I;5611201;0;1;-1
338116;202010;352590;G;4789004;2;0;2
338256;202010;352590;M;7319003;4;1;3
338323;202010;352590;F;4399199;6;4;2
338503;202010;352590;Q;8711502;0;1;-1
338906;202010;352590;Q;8712300;0;1;-1
339087;202010;352590;G;4687702;1;3;-2
339184;202010;352590;G;4713002;1;0;1
339590;202010;352590;G;4520005;0;1;-1
339878;202010;352590;H;4930201;1;1;0
340509;202010;352590;G;4744001;0;1;-1
340761;202010;352590;F;4292802;5;0;5
340923;202010;352590;G;4732600;5;0;5
340987;202010;352590;G;4782201;0;1;-1
341112;202010;352590;C;2862300;1;0;1
341424;202010;352590;G;4642701;0;1;-1
342168;202010;352590;G;4789004;1;0;1
342203;202010;352590;C;2823200;2;1;1
342281;202010;352590;N;8011101;3;5;-2
342831;202010;352590;I;5611201;0;2;-2
342894;202010;352590;J;6190699;1;0;1
342895;202010;352590;J;6190699;0;1;-1
343043;202010;352590;N;8211300;1;0;1
343133;202010;352590;G;4774100;1;0;1
343252;202010;352590;L;6822600;4;3;1
344181;202010;352590;G;4783101;1;0;1
344699;202010;352590;H;4930202;6;2;4
344831;202010;352590;H;5112901;0;1;-1
344991;202010;352590;N;8111700;5;1;4
345048;202010;352590;G;4781400;1;1;0
345318;202010;352590;P;8599603;2;0;2
345351;202010;352590;N;7912100;0;2;-2
345492;202010;352590;N;7911200;0;3;-3
346214;202010;352590;G;4724500;1;3;-2
347290;202010;352590;G;4771701;1;0;1
347795;202010;352590;C;1013901;18;3;15
347966;202010;352590;F;4321500;0;1;-1
348157;202010;352590;N;8219999;0;2;-2
348512;202010;352590;P;8599605;1;0;1
348764;202010;352590;G;4781400;1;0;1
349145;202010;352590;I;5611203;1;0;1
349346;202010;352590;P;8599604;2;0;2
351247;202010;352590;G;4754701;1;0;1
352041;202010;352590;C;2222600;0;4;-4
352492;202010;352590;G;4530703;1;0;1
352614;202010;352590;H;4930202;1;0;1
353128;202010;352590;G;4530703;1;0;1
353226;202010;352590;M;6911701;1;0;1
353299;202010;352590;G;4530704;0;1;-1
353852;202010;352590;M;6920601;1;0;1
353853;202010;352590;I;5620104;2;1;1
354266;202010;352590;I;5611201;0;1;-1
354294;202010;352590;G;4520001;5;0;5
354533;202010;352590;G;4789005;1;0;1
354707;202010;352590;N;8291100;1;0;1
355098;202010;352590;I;5611201;0;1;-1
355499;202010;352590;N;8220200;90;98;-8
355530;202010;352590;M;7490104;1;0;1
355762;202010;352590;G;4712100;0;1;-1
356251;202010;352590;F;4399103;2;6;-4
357043;202010;352590;G;4753900;1;0;1
358134;202010;352590;I;5611203;1;0;1
358184;202010;352590;H;4930202;2;0;2
358527;202010;352590;S;9430800;0;1;-1
358914;202010;352590;C;1091102;1;0;1
359602;202010;352590;F;4221902;0;1;-1
360736;202010;352590;G;4774100;1;1;0
360795;202010;352590;J;6204000;0;1;-1
361283;202010;352590;H;4930202;0;1;-1
361323;202010;352590;M;7119703;1;2;-1
361812;202010;352590;P;8599604;2;1;1
362149;202010;352590;G;4637199;1;0;1
362515;202010;352590;S;9602502;2;0;2
363228;202010;352590;G;4722901;1;2;-1
363320;202010;352590;I;5611201;1;0;1
363611;202010;352590;J;6201501;2;1;1
363995;202010;352590;P;8593700;2;3;-1
364282;202010;352590;G;4520002;0;1;-1
364337;202010;352590;N;8130300;8;1;7
364458;202010;352590;G;4652400;0;4;-4
364595;202010;352590;G;4744002;1;1;0
364675;202010;352590;F;4321500;5;2;3
364785;202010;352590;F;4120400;50;24;26
365079;202010;352590;C;2222600;3;0;3
365175;202010;352590;S;9602502;0;2;-2
365859;202010;352590;C;3314702;1;0;1
366499;202010;352590;F;4330405;6;5;1
366774;202010;352590;F;4313400;1;0;1
366874;202010;352590;G;4530703;0;1;-1
367278;202010;352590;G;4729699;1;1;0
367450;202010;352590;P;8511200;2;0;2
367524;202010;352590;M;7020400;2;2;0
367650;202010;352590;G;4530705;2;0;2
367653;202010;352590;H;4930201;3;1;2
367744;202010;352590;G;4721102;2;1;1
367823;202010;352590;M;7112000;5;0;5
367853;202010;352590;H;4930202;1;0;1
367875;202010;352590;G;4721102;2;0;2
368516;202010;352590;G;4774100;0;1;-1
368785;202010;352590;I;5620104;0;1;-1
371300;202010;352590;H;4930202;7;5;2
371488;202010;352590;Q;8712300;2;3;-1
371495;202010;352590;Q;8610101;2;0;2
372115;202010;352590;I;5611203;1;1;0
372311;202010;352590;H;5223100;0;1;-1
372443;202010;352590;C;2222600;2;1;1
374228;202010;352590;P;8550302;2;3;-1
375231;202010;352590;L;6810202;1;0;1
375540;202010;352590;N;8111700;0;7;-7
375590;202010;352590;H;4930201;1;1;0
375669;202010;352590;G;4781400;0;1;-1
375809;202010;352590;N;8211300;0;1;-1
375850;202010;352590;G;4752100;0;1;-1
376444;202010;352590;N;8211300;0;1;-1
376935;202010;352590;M;6920601;1;0;1
376987;202010;352590;C;3321000;1;0;1
377015;202010;352590;G;4781400;1;0;1
377456;202010;352590;P;8512100;2;0;2
377833;202010;352590;M;7312200;1;0;1
377858;202010;352590;C;3313902;1;0;1
378425;202010;352590;G;4712100;1;1;0
378864;202010;352590;I;5611203;0;4;-4
378884;202010;352590;G;4781400;1;0;1
379326;202010;352590;G;4731800;2;5;-3
379442;202010;352590;G;4723700;2;0;2
381552;202010;352590;F;4222701;1;0;1
382042;202010;352590;N;8111700;2;0;2
382072;202010;352590;J;6204000;3;0;3
382330;202010;352590;G;4669999;13;3;10
382344;202010;352590;M;6920601;1;0;1
383712;202010;352590;J;6311900;0;24;-24
384193;202010;352590;G;4754701;2;0;2
384201;202010;352590;G;4754701;2;1;1
384279;202010;352590;J;6209100;0;1;-1
384317;202010;352590;N;8220200;1;1;0
384985;202010;352590;S;9602501;0;1;-1
385481;202010;352590;G;4712100;0;1;-1
386895;202010;352590;G;4789099;0;1;-1
387626;202010;352590;H;4930202;20;10;10
387812;202010;352590;G;4721102;1;0;1
388644;202010;352590;G;4672900;1;0;1
388724;202010;352590;N;8121400;2;1;1
388758;202010;352590;S;9512600;3;4;-1
388925;202010;352590;P;8512100;0;1;-1
389130;202010;352590;G;4712100;1;0;1
389290;202010;352590;I;5620101;0;2;-2
389384;202010;352590;N;8130300;1;0;1
389495;202010;352590;F;4399199;0;1;-1
390702;202010;352590;H;4930202;1;0;1
391788;202010;352590;G;4781400;0;1;-1
392173;202010;352590;G;4530703;1;0;1
392503;202010;352590;I;5611203;0;1;-1
392551;202010;352590;G;4789002;1;1;0
393131;202010;352590;G;4645101;6;0;6
393821;202010;352590;Q;8630503;1;0;1
393897;202010;352590;G;4789004;1;0;1
393962;202010;352590;G;4511101;1;1;0
395774;202010;352590;L;6822600;2;2;0
396272;202010;352590;G;4729699;1;0;1
396322;202010;352590;I;5611201;0;1;-1
396458;202010;352590;S;9602502;1;0;1
396767;202010;352590;G;4744001;0;1;-1
397359;202010;352590;M;7112000;1;0;1
397773;202010;352590;H;5212500;18;10;8
397927;202010;352590;G;4731800;5;3;2
398024;202010;352590;C;1412601;5;2;3
398190;202010;352590;G;4713001;3;3;0
398370;202010;352590;P;8599603;2;3;-1
398546;202010;352590;G;4781400;1;0;1
398959;202010;352590;C;2950600;1;4;-3
399223;202010;352590;M;7119701;0;1;-1
399265;202010;352590;G;4774100;2;0;2
399546;202010;352590;F;4330403;2;3;-1
400408;202010;352590;G;4759899;2;0;2
400725;202010;352590;C;1042200;1;2;-1
400744;202010;352590;Q;8630504;1;2;-1
400775;202010;352590;C;3314719;1;1;0
400832;202010;352590;G;4754701;0;1;-1
401151;202010;352590;G;4731800;5;0;5
401443;202010;352590;G;4649499;0;2;-2
401793;202010;352590;P;8599604;1;1;0
402025;202010;352590;N;8211300;1;0;1
402418;202010;352590;G;4729699;52;17;35
403174;202010;352590;I;5611201;1;0;1
404348;202010;352590;F;4291000;3;1;2
404374;202010;352590;R;9321200;0;1;-1
404375;202010;352590;N;8230002;0;2;-2
405917;202010;352590;I;5620101;26;12;14
405919;202010;352590;I;5620101;2;1;1
405920;202010;352590;I;5620101;10;5;5
405921;202010;352590;I;5620101;2;1;1
406188;202010;352590;J;6190601;0;1;-1
407020;202010;352590;H;5229002;1;0;1
407101;202010;352590;C;3314708;1;0;1
407817;202010;352590;S;9493600;0;1;-1
407897;202010;352590;L;6821801;0;1;-1
408174;202010;352590;J;6209100;0;1;-1
408223;202010;352590;G;4646001;4;2;2
408447;202010;352590;H;5211701;2;0;2
408486;202010;352590;M;7112000;0;1;-1
409107;202010;352590;G;4712100;1;0;1
409190;202010;352590;M;7490104;0;1;-1
409210;202010;352590;G;4771701;1;1;0
409467;202010;352590;P;8512100;0;1;-1
409605;202010;352590;H;4930202;1;0;1
409805;202010;352590;I;5611203;0;2;-2
409975;202010;352590;N;8220200;70;146;-76
410286;202010;352590;G;4781400;2;0;2
410287;202010;352590;G;4781400;3;1;2
410507;202010;352590;J;6209100;1;1;0
411203;202010;352590;G;4783101;2;1;1
412411;202010;352590;G;4772500;0;1;-1
412757;202010;352590;G;4751201;1;1;0
412772;202010;352590;G;4633801;0;1;-1
413566;202010;352590;G;4511102;1;0;1
413603;202010;352590;F;4120400;0;1;-1
413987;202010;352590;F;4221904;7;17;-10
414166;202010;352590;P;8513900;6;0;6
414415;202010;352590;C;2330305;1;1;0
415087;202010;352590;I;5611203;1;1;0
415712;202010;352590;M;6920601;0;1;-1
415904;202010;352590;G;4679603;1;0;1
415916;202010;352590;C;1629301;0;1;-1
416212;202010;352590;N;8299799;19;8;11
416274;202010;352590;C;3321000;0;1;-1
416294;202010;352590;N;8111700;4;4;0
416596;202010;352590;G;4633801;1;0;1
416690;202010;352590;H;4930202;4;5;-1
416972;202010;352590;G;4530703;1;1;0
417173;202010;352590;F;4313400;0;1;-1
417435;202010;352590;G;4781400;1;0;1
417524;202010;352590;G;4520007;0;1;-1
417609;202010;352590;G;4774100;0;1;-1
418433;202010;352590;C;2391503;1;0;1
418829;202010;352590;P;8599604;19;5;14
419910;202010;352590;G;4639701;7;13;-6
420091;202010;352590;G;4520007;1;0;1
420181;202010;352590;H;5250804;0;1;-1
420388;202010;352590;N;8111700;7;2;5
420493;202010;352590;I;5620101;1;1;0
420750;202010;352590;F;4330499;1;0;1
421033;202010;352590;G;4520004;1;0;1
421043;202010;352590;C;1095300;12;18;-6
421685;202010;352590;G;4543900;1;0;1
422183;202010;352590;G;4753900;1;10;-9
422990;202010;352590;G;4781400;1;0;1
423074;202010;352590;H;4930202;2;0;2
423330;202010;352590;J;6319400;0;1;-1
423801;202010;352590;G;4759899;0;1;-1
424430;202010;352590;S;9430800;1;0;1
424494;202010;352590;N;8219999;0;1;-1
424983;202010;352590;C;2943300;1;0;1
425383;202010;352590;C;2941700;1;2;-1
425853;202010;352590;I;5611201;1;1;0
426323;202010;352590;F;4312600;1;0;1
426533;202010;352590;Q;8630503;4;1;3
426642;202010;352590;N;8121400;0;1;-1
426652;202010;352590;Q;8650004;0;1;-1
426759;202010;352590;I;5611203;4;2;2
426760;202010;352590;I;5611203;2;1;1
426762;202010;352590;I;5611203;0;3;-3
428036;202010;352590;M;6920601;1;0;1
428358;202010;352590;G;4757100;1;0;1
428409;202010;352590;C;3314707;12;1;11
428560;202010;352590;G;4721103;2;0;2
430050;202010;352590;G;4789099;0;1;-1
430726;202010;352590;G;4782201;1;0;1
430735;202010;352590;Q;8711502;1;2;-1
430861;202010;352590;G;4530703;1;1;0
431880;202010;352590;I;5611201;0;1;-1
432106;202010;352590;G;4789099;1;0;1
433098;202010;352590;G;4729699;1;0;1
433401;202010;352590;K;6462000;1;2;-1
433483;202010;352590;F;4292801;1;0;1
433671;202010;352590;C;2943300;0;1;-1
433963;202010;352590;H;5250801;1;0;1
434036;202010;352590;H;4930202;1;0;1
434181;202010;352590;G;4744099;1;0;1
434191;202010;352590;G;4781400;0;1;-1
434958;202010;352590;M;6920601;1;1;0
435032;202010;352590;F;4330404;0;3;-3
435747;202010;352590;C;2229302;1;0;1
435805;202010;352590;P;8599603;1;0;1
435821;202010;352590;G;4781400;0;1;-1
435944;202010;352590;G;4633801;1;0;1
436136;202010;352590;G;4781400;1;0;1
436655;202010;352590;I;5611201;5;2;3
437346;202010;352590;N;8111700;1;0;1
438131;202010;352590;G;4759899;1;2;-1
438297;202010;352590;G;4789099;2;0;2
438908;202010;352590;H;5212500;8;10;-2
438965;202010;352590;I;5611201;1;1;0
439051;202010;352590;G;4722901;0;1;-1
439210;202010;352590;G;4511102;0;1;-1
439941;202010;352590;C;2542000;0;6;-6
440030;202010;352590;I;5620104;1;0;1
441258;202010;352590;I;5590699;1;0;1
441504;202010;352590;F;4120400;2;1;1
441543;202010;352590;G;4646001;2;1;1
442596;202010;352590;C;1069400;3;3;0
443091;202010;352590;G;4530703;0;1;-1
443139;202010;352590;I;5611201;3;1;2
443251;202010;352590;G;4530703;2;0;2
443941;202010;352590;G;4755502;1;0;1
444188;202010;352590;F;4321500;2;0;2
444284;202010;352590;G;4774100;1;0;1
444396;202010;352590;F;4330404;2;0;2
444435;202010;352590;Q;8630503;0;2;-2
444904;202010;352590;I;5611203;1;1;0
445003;202010;352590;G;4729699;0;1;-1
445004;202010;352590;G;4729699;1;0;1
445059;202010;352590;Q;8640202;7;1;6
445171;202010;352590;M;7020400;1;1;0
445365;202010;352590;S;9603301;1;0;1
445414;202010;352590;H;5250804;0;3;-3
445678;202010;352590;G;4774100;0;2;-2
445812;202010;352590;N;7740300;0;1;-1
445884;202010;352590;N;8291100;1;0;1
446297;202010;352590;J;6202300;0;2;-2
446399;202010;352590;N;8112500;4;0;4
446429;202010;352590;I;5611201;0;3;-3
446439;202010;352590;H;5223100;5;1;4
446536;202010;352590;G;4759899;1;0;1
447238;202010;352590;G;4729699;1;0;1
447509;202010;352590;G;4713002;1;1;0
447692;202010;352590;I;5611201;1;0;1
447769;202010;352590;S;9511800;0;1;-1
448011;202010;352590;G;4781400;1;2;-1
448088;202010;352590;R;9313100;2;0;2
448225;202010;352590;N;8299799;1;0;1
449008;202010;352590;I;5611203;4;2;2
449087;202010;352590;G;4520006;1;0;1
449528;202010;352590;G;4721102;3;0;3
449858;202010;352590;H;4930201;1;0;1
449881;202010;352590;G;4752100;0;1;-1
450204;202010;352590;G;4773300;0;1;-1
450946;202010;352590;M;7319003;6;3;3
451002;202010;352590;G;4722901;0;1;-1
451035;202010;352590;F;4120400;0;1;-1
451454;202010;352590;F;4330404;0;1;-1
451684;202010;352590;G;4686902;0;1;-1
451943;202010;352590;C;3314713;2;2;0
452062;202010;352590;I;5611201;1;0;1
452063;202010;352590;I;5611201;0;1;-1
452223;202010;352590;H;4930202;1;0;1
452777;202010;352590;C;2071100;1;0;1
453047;202010;352590;G;4771701;0;1;-1
453123;202010;352590;C;2511000;1;0;1
453126;202010;352590;M;6920601;2;1;1
453182;202010;352590;R;9313100;1;0;1
453728;202010;352590;F;4330403;3;0;3
453732;202010;352590;F;4292801;2;0;2
454090;202010;352590;H;4930202;4;2;2
454746;202010;352590;I;5611201;1;2;-1
455235;202010;352590;I;5611201;0;1;-1
455683;202010;352590;G;4731800;1;0;1
455768;202010;352590;R;9321200;3;0;3
456290;202010;352590;F;4321500;1;0;1
456292;202010;352590;G;4781400;2;0;2
456293;202010;352590;G;4781400;2;0;2
456902;202010;352590;H;4930202;6;0;6
457098;202010;352590;K;6462000;0;5;-5
457210;202010;352590;G;4789004;1;3;-2
457607;202010;352590;G;4789004;2;1;1
457675;202010;352590;N;8122200;1;0;1
458175;202010;352590;M;7490104;3;0;3
458384;202010;352590;Q;8630504;1;1;0
458585;202010;352590;I;5611203;1;2;-1
458862;202010;352590;N;8121400;2;1;1
459110;202010;352590;M;7112000;0;3;-3
459426;202010;352590;R;9313100;1;0;1
459920;202010;352590;F;4120400;3;0;3
459972;202010;352590;G;4789099;0;1;-1
460370;202010;352590;F;4330404;6;0;6
460371;202010;352590;F;4330404;0;2;-2
461052;202010;352590;J;6202300;3;0;3
461293;202010;352590;G;4687702;2;2;0
461334;202010;352590;N;8111700;1;0;1
461368;202010;352590;G;4713001;2;0;2
461612;202010;352590;G;4783101;2;2;0
461758;202010;352590;I;5611201;1;2;-1
462120;202010;352590;G;4763602;2;0;2
462906;202010;352590;G;4729602;1;1;0
463071;202010;352590;Q;8640202;2;1;1
463201;202010;352590;N;8211300;0;1;-1
463405;202010;352590;G;4721102;1;0;1
463474;202010;352590;N;7820500;8;0;8
464634;202010;352590;N;7729299;1;1;0
464717;202010;352590;P;8599604;0;1;-1
464935;202010;352590;G;4789004;2;2;0
465706;202010;352590;C;3314713;0;1;-1
466313;202010;352590;F;4120400;0;3;-3
466438;202010;352590;F;4330404;2;2;0
467804;202010;352590;N;7739099;0;1;-1
468006;202010;352590;H;4930202;1;0;1
468472;202010;352590;C;1091102;1;0;1
468772;202010;352590;M;7112000;0;2;-2
469530;202010;352590;N;8121400;1;0;1
470039;202010;352590;H;5240101;0;1;-1
470047;202010;352590;K;6622300;2;0;2
471136;202010;352590;I;5611203;5;1;4
471144;202010;352590;G;4783101;1;0;1
471731;202010;352590;Q;8630504;0;2;-2
471888;202010;352590;I;5620104;0;1;-1
472000;202010;352590;G;4729699;1;0;1
472438;202010;352590;G;4722901;1;0;1
473402;202010;352590;H;4930202;0;1;-1
473801;202010;352590;G;4789099;0;1;-1
473884;202010;352590;L;6822600;1;0;1
473920;202010;352590;I;5611203;0;1;-1
474181;202010;352590;I;5620104;0;1;-1
474199;202010;352590;N;8111700;9;2;7
474606;202010;352590;J;6110803;4;3;1
474806;202010;352590;G;4729699;1;0;1
475051;202010;352590;I;5620104;1;0;1
475558;202010;352590;I;5620101;1;0;1
475560;202010;352590;I;5620101;1;1;0
475653;202010;352590;F;4120400;15;5;10
476290;202010;352590;N;8129000;0;2;-2
476401;202010;352590;G;4729602;1;0;1
476428;202010;352590;N;8112500;0;1;-1
476958;202010;352590;P;8512100;1;0;1
477115;202010;352590;F;4322302;1;0;1
477119;202010;352590;H;4930202;1;0;1
477166;202010;352590;H;5212500;20;10;10
477475;202010;352590;C;1053800;2;1;1
477688;202010;352590;G;4752100;0;2;-2
477692;202010;352590;G;4729699;1;0;1
477747;202010;352590;I;5611201;0;1;-1
478673;202010;352590;I;5611203;1;0;1
479053;202010;352590;I;5620101;1;0;1
479221;202010;352590;L;6821801;1;0;1
479472;202010;352590;R;9313100;1;0;1
479776;202010;352590;M;7112000;13;3;10
479812;202010;352590;I;5611203;1;0;1
479813;202010;352590;J;6311900;0;1;-1
480159;202010;352590;G;4712100;1;1;0
480272;202010;352590;I;5611201;1;0;1
480360;202010;352590;C;3321000;0;1;-1
480383;202010;352590;G;4712100;0;1;-1
480560;202010;352590;S;9603304;1;2;-1
480671;202010;352590;G;4789099;3;2;1
481403;202010;352590;F;4399103;0;1;-1
481533;202010;352590;N;8111700;1;2;-1
481618;202010;352590;G;4782201;1;0;1
482312;202010;352590;G;4772500;2;3;-1
482443;202010;352590;G;4781400;2;0;2
482626;202010;352590;I;5611203;3;0;3
483215;202010;352590;G;4712100;1;0;1
483437;202010;352590;I;5611203;1;0;1
483954;202010;352590;M;7112000;5;1;4
484209;202010;352590;G;4781400;1;0;1
484210;202010;352590;G;4781400;0;1;-1
484211;202010;352590;G;4781400;0;2;-2
484634;202010;352590;F;4399199;1;1;0
485121;202010;352590;Q;8650003;2;2;0
485332;202010;352590;I;5611203;1;0;1
485333;202010;352590;I;5611203;0;1;-1
485424;202010;352590;G;4789004;1;0;1
485658;202010;352590;S;9609208;5;0;5
485792;202010;352590;G;4721102;1;1;0
486352;202010;352590;N;8299799;0;1;-1
487065;202010;352590;I;5611201;1;1;0
487729;202010;352590;N;8291100;7;4;3
487873;202010;352590;N;8211300;0;2;-2
487895;202010;352590;I;5611201;1;2;-1
488087;202010;352590;K;6491300;1;0;1
488510;202010;352590;S;9602501;1;0;1
488713;202010;352590;C;2521700;0;4;-4
488831;202010;352590;I;5611201;0;2;-2
489087;202010;352590;G;4763601;2;1;1
489467;202010;352590;I;5611201;0;1;-1
489920;202010;352590;G;4744099;3;0;3
489945;202010;352590;G;4511101;0;1;-1
490645;202010;352590;I;5620102;0;1;-1
490697;202010;352590;G;4633801;1;0;1
490773;202010;352590;P;8599604;0;1;-1
490948;202010;352590;G;4789004;1;0;1
491352;202010;352590;G;4530705;1;1;0
491507;202010;352590;C;1091102;0;1;-1
491707;202010;352590;F;4321500;2;1;1
491963;202010;352590;G;4723700;2;1;1
492313;202010;352590;I;5611201;3;1;2
492763;202010;352590;S;9511800;1;0;1
492974;202010;352590;N;8291100;0;1;-1
493066;202010;352590;G;4520001;1;0;1
493891;202010;352590;C;2543800;0;1;-1
494118;202010;352590;S;9601703;15;3;12
494789;202010;352590;C;3314799;6;4;2
495694;202010;352590;C;2543800;2;0;2
497065;202010;352590;G;4511101;1;0;1
497139;202010;352590;G;4784900;0;1;-1
497592;202010;352590;S;9601701;0;1;-1
497810;202010;352590;H;4930202;1;0;1
498443;202010;352590;G;4712100;2;0;2
498909;202010;352590;I;5611201;1;0;1
498910;202010;352590;I;5611201;1;0;1
499030;202010;352590;M;7112000;0;1;-1
499459;202010;352590;G;4771701;1;0;1
499974;202010;352590;M;7112000;2;1;1
500526;202010;352590;I;5611201;2;1;1
500688;202010;352590;G;4520001;0;1;-1
500696;202010;352590;F;4299599;2;0;2
500912;202010;352590;G;4711301;6;10;-4
501311;202010;352590;F;4321500;0;1;-1
501330;202010;352590;Q;8630504;0;1;-1
501798;202010;352590;G;4511102;0;1;-1
501902;202010;352590;I;5611201;0;1;-1
502836;202010;352590;I;5620104;2;1;1
502883;202010;352590;G;4744099;1;0;1
502885;202010;352590;G;4783101;1;0;1
503679;202010;352590;M;7119701;2;0;2
503704;202010;352590;S;9529199;1;0;1
504175;202010;352590;G;4711302;1;1;0
504400;202010;352590;P;8599699;0;1;-1
504501;202010;352590;I;5611201;3;1;2
504544;202010;352590;G;4729699;0;1;-1
504825;202010;352590;R;9313100;4;2;2
505126;202010;352590;F;4322303;13;0;13
505327;202010;352590;Q;8640299;0;1;-1
505839;202010;352590;G;4731800;1;0;1
506192;202010;352590;G;4722901;0;1;-1
506304;202010;352590;G;4520005;5;2;3
506313;202010;352590;C;1099699;0;3;-3
507183;202010;352590;G;4781400;1;1;0
507266;202010;352590;G;4781400;1;1;0
508604;202010;352590;H;5320202;3;3;0
509196;202010;352590;F;4321500;0;1;-1
509528;202010;352590;L;6821802;1;1;0
509636;202010;352590;P;8593700;0;2;-2
509954;202010;352590;S;9602502;0;1;-1
509969;202010;352590;G;4782201;1;0;1
510204;202010;352590;G;4530703;1;0;1
511621;202010;352590;N;8111700;3;0;3
511743;202010;352590;N;7810800;3;3;0
512476;202010;352590;G;4774100;0;1;-1
512520;202010;352590;Q;8630504;1;0;1
512708;202010;352590;F;4299599;1;1;0
513450;202010;352590;P;8599699;2;1;1
513497;202010;352590;S;9602501;0;1;-1
513619;202010;352590;G;4713002;2;0;2
513718;202010;352590;N;7739099;6;6;0
514092;202010;352590;G;4637199;5;3;2
514884;202010;352590;G;4754701;1;0;1
515176;202010;352590;N;8211300;0;1;-1
515215;202010;352590;I;5620103;0;1;-1
515427;202010;352590;C;1113502;0;1;-1
515547;202010;352590;S;9602502;3;1;2
516170;202010;352590;P;8599604;1;1;0
516378;202010;352590;S;9602501;0;1;-1
517376;202010;352590;Q;8630503;1;0;1
518059;202010;352590;G;4744005;2;2;0
518168;202010;352590;G;4729699;2;0;2
519661;202010;352590;C;2222600;6;1;5
520278;202010;352590;G;4781400;1;0;1
520482;202010;352590;G;4774100;1;0;1
520626;202010;352590;G;4642701;1;1;0
520815;202010;352590;F;4399199;1;0;1
520874;202010;352590;G;4722902;0;1;-1
520989;202010;352590;H;4930201;2;1;1
521130;202010;352590;H;5223100;2;1;1
521371;202010;352590;S;9602501;0;1;-1
521877;202010;352590;M;7490104;2;0;2
522280;202010;352590;K;6619302;6;1;5
522358;202010;352590;I;5611203;1;0;1
522406;202010;352590;N;8111700;1;0;1
522605;202010;352590;C;1413401;0;2;-2
522708;202010;352590;Q;8630504;0;2;-2
522929;202010;352590;G;4781400;1;0;1
523225;202010;352590;H;5211701;0;1;-1
523886;202010;352590;C;2222600;1;0;1
524098;202010;352590;G;4713002;1;2;-1
524287;202010;352590;G;4784900;1;0;1
524381;202010;352590;G;4789002;2;1;1
524782;202010;352590;N;8211300;2;2;0
526232;202010;352590;G;4742300;1;1;0
526272;202010;352590;G;4763602;1;0;1
526494;202010;352590;G;4781400;0;2;-2
527322;202010;352590;G;4744005;2;0;2
527528;202010;352590;N;8219901;1;0;1
527843;202010;352590;G;4712100;1;0;1
528513;202010;352590;G;4771701;0;2;-2
528705;202010;352590;G;4742300;1;0;1
528792;202010;352590;C;2061400;2;0;2
528891;202010;352590;N;8219999;2;0;2
529040;202010;352590;P;8512100;1;0;1
529080;202010;352590;G;4711302;0;3;-3
529351;202010;352590;M;7112000;6;0;6
530132;202010;352590;G;4757100;1;0;1
530871;202010;352590;I;5611203;0;1;-1
532570;202010;352590;H;4930202;0;2;-2
532858;202010;352590;G;4789099;1;0;1
533085;202010;352590;N;8211300;1;1;0
533411;202010;352590;I;5611201;0;1;-1
534505;202010;352590;S;9601701;1;0;1
535576;202010;352590;H;4930202;4;0;4
535634;202010;352590;P;8599604;1;0;1
535635;202010;352590;P;8599604;0;1;-1
536226;202010;352590;N;8111700;8;2;6
536647;202010;352590;A;163600;97;54;43
536700;202010;352590;H;4930202;1;0;1
536797;202010;352590;G;4772500;0;1;-1
537151;202010;352590;N;8219999;2;2;0
537242;202010;352590;C;3314707;1;0;1
537600;202010;352590;G;4729699;0;1;-1
538400;202010;352590;H;4930201;2;1;1
538607;202010;352590;M;7119701;1;0;1
538623;202010;352590;G;4520006;2;0;2
538632;202010;352590;I;5611201;0;1;-1
539971;202010;352590;G;4711302;3;2;1
540383;202010;352590;G;4711302;1;0;1
541069;202010;352590;G;4752100;1;0;1
541070;202010;352590;G;4752100;0;1;-1
541294;202010;352590;G;4753900;4;0;4
541523;202010;352590;G;4753900;20;32;-12
541524;202010;352590;G;4753900;13;4;9
541525;202010;352590;G;4753900;8;5;3
541526;202010;352590;G;4753900;11;1;10
542029;202010;352590;G;4753900;3;9;-6
542060;202010;352590;G;4753900;2;0;2
542123;202010;352590;G;4753900;6;2;4
542517;202010;352590;K;6512000;0;1;-1
542779;202010;352590;G;4752100;1;0;1
542847;202010;352590;G;4712100;3;3;0
542849;202010;352590;G;4712100;1;6;-5
543178;202010;352590;I;5620104;0;1;-1
543392;202010;352590;G;4789099;0;1;-1
543561;202010;352590;C;1812100;0;3;-3
544518;202010;352590;H;4930202;8;16;-8
544987;202010;352590;G;4781400;2;0;2
545084;202010;352590;G;4781400;3;3;0
545755;202010;352590;G;4781400;2;1;1
546234;202010;352590;G;4752100;1;2;-1
546391;202010;352590;H;4930202;2;1;1
547116;202010;352590;F;4330404;2;7;-5
547163;202010;352590;N;8020001;1;1;0
548346;202010;352590;M;7112000;0;4;-4
550125;202010;352590;G;4541204;0;1;-1
550414;202010;352590;C;3321000;4;1;3
551039;202010;352590;C;2812700;0;1;-1
551254;202010;352590;C;2062200;2;0;2
551954;202010;352590;I;5620104;0;1;-1
552042;202010;352590;C;2099199;1;1;0
552440;202010;352590;I;5611203;0;1;-1
552985;202010;352590;M;6911701;1;0;1
553260;202010;352590;P;8513900;0;1;-1
553544;202010;352590;I;5611203;1;0;1
553810;202010;352590;I;5611203;1;0;1
554051;202010;352590;F;4110700;8;0;8
556451;202010;352590;Q;8630504;4;1;3
556590;202010;352590;G;4721104;0;1;-1
556891;202010;352590;G;4774100;0;1;-1
557427;202010;352590;G;4744001;5;0;5
557501;202010;352590;G;4520001;0;1;-1
559171;202010;352590;I;5611201;2;1;1
560366;202010;352590;G;4712100;1;0;1
561404;202010;352590;N;8020001;9;1;8
562021;202010;352590;G;4763602;1;0;1
562242;202010;352590;Q;8640202;1;0;1
562348;202010;352590;I;5611203;1;0;1
563283;202010;352590;G;4785799;1;3;-2
564462;202010;352590;H;5229099;8;17;-9
565450;202010;352590;Q;8630504;0;1;-1
565748;202010;352590;N;8121400;1;3;-2
565969;202010;352590;H;5211702;0;1;-1
566498;202010;352590;G;4789004;1;0;1
566803;202010;352590;F;4120400;1;0;1
567842;202010;352590;G;4669999;8;5;3
567844;202010;352590;G;4669999;4;0;4
567911;202010;352590;G;4729602;2;1;1
568041;202010;352590;I;5620104;7;0;7
568141;202010;352590;G;4754702;0;1;-1
568374;202010;352590;M;7112000;0;4;-4
568481;202010;352590;S;9602502;2;0;2
568590;202010;352590;I;5611201;2;1;1
569347;202010;352590;H;4930202;1;1;0
569404;202010;352590;I;5611203;0;2;-2
569460;202010;352590;I;5611203;2;0;2
570342;202010;352590;P;8513900;1;0;1
570368;202010;352590;C;2599302;0;5;-5
570425;202010;352590;N;8211300;8;0;8
570843;202010;352590;I;5611201;0;1;-1
571275;202010;352590;I;5620104;1;0;1
571429;202010;352590;I;5611201;2;0;2
571705;202010;352590;S;9602501;1;1;0
572057;202010;352590;G;4782201;1;1;0
572154;202010;352590;G;4771701;3;3;0
573291;202010;352590;G;4763602;1;1;0
573759;202010;352590;C;1091102;1;0;1
574488;202010;352590;G;4771701;0;2;-2
574510;202010;352590;N;8230001;9;16;-7
574857;202010;352590;N;8211300;0;2;-2
574973;202010;352590;G;4530703;1;0;1
575359;202010;352590;R;9313100;0;1;-1
575429;202010;352590;G;4713002;1;0;1
575673;202010;352590;C;3092000;0;1;-1
575685;202010;352590;G;4774100;2;0;2
575687;202010;352590;G;4774100;2;0;2
575751;202010;352590;G;4781400;1;3;-2
576066;202010;352590;I;5611203;0;1;-1
576133;202010;352590;G;4721102;0;1;-1
576762;202010;352590;I;5611203;1;0;1
576908;202010;352590;I;5611201;2;1;1
577434;202010;352590;I;5611201;0;1;-1
577579;202010;352590;R;9329899;5;0;5
577709;202010;352590;N;8211300;3;0;3
578061;202010;352590;F;4120400;4;0;4
578348;202010;352590;G;4731800;5;0;5
578374;202010;352590;R;9313100;12;2;10
579111;202010;352590;N;8211300;5;5;0
579212;202010;352590;R;9319199;1;5;-4
580340;202010;352590;P;8541400;2;0;2
581999;202010;352590;H;5320201;2;1;1
582111;202010;352590;I;5611201;1;0;1
583434;202010;352590;I;5611203;4;0;4
584461;202010;352590;G;4781400;1;0;1
584826;202010;352590;N;8291100;1;1;0
585057;202010;352590;N;7739002;3;1;2
585537;202010;352590;G;4744001;0;1;-1
586082;202010;352590;G;4712100;0;1;-1
586309;202010;352590;I;5611201;0;3;-3
586581;202010;352590;I;5611201;2;1;1
587104;202010;352590;G;4781400;0;1;-1
587241;202010;352590;N;8111700;6;1;5
587457;202010;352590;G;4713002;3;2;1
588039;202010;352590;Q;8630504;4;0;4
588176;202010;352590;N;8291100;10;5;5
589382;202010;352590;M;7490104;1;0;1
589707;202010;352590;G;4520007;2;0;2
589865;202010;352590;G;4723700;2;2;0
589943;202010;352590;G;4759899;2;0;2
589984;202010;352590;H;4930202;0;4;-4
590099;202010;352590;G;4744003;1;0;1
590320;202010;352590;G;4781400;4;2;2
590844;202010;352590;G;4520001;2;0;2
592288;202010;352590;G;4771701;1;0;1
592389;202010;352590;C;1091102;3;0;3
593233;202010;352590;H;4930202;1;0;1
593477;202010;352590;G;4721104;2;1;1
593562;202010;352590;I;5611201;1;0;1
593963;202010;352590;M;7319002;5;4;1
594338;202010;352590;I;5620104;0;1;-1
595618;202010;352590;S;9601701;1;0;1
595724;202010;352590;N;8111700;3;1;2
595809;202010;352590;G;4781400;2;0;2
595866;202010;352590;F;4120400;6;0;6
595874;202010;352590;M;7311400;1;0;1
596077;202010;352590;G;4723700;3;0;3
597557;202010;352590;S;9602502;3;0;3
597810;202010;352590;G;4744001;0;1;-1
598374;202010;352590;G;4781400;1;0;1
598567;202010;352590;G;4789099;3;0;3
599005;202010;352590;G;4789001;2;0;2
599013;202010;352590;I;5611203;2;3;-1
599274;202010;352590;H;5320201;0;3;-3
600235;202010;352590;R;9313100;4;2;2
601089;202010;352590;G;4729699;1;0;1
601142;202010;352590;N;8291100;2;0;2
601392;202010;352590;P;8599604;2;1;1
601592;202010;352590;H;5211799;2;0;2
601737;202010;352590;G;4763601;1;0;1
601958;202010;352590;G;4729602;0;1;-1
603970;202010;352590;J;6204000;1;0;1
603995;202010;352590;G;4781400;8;1;7
604643;202010;352590;G;4774100;1;0;1
606339;202010;352590;G;4729699;1;0;1
606562;202010;352590;H;4923002;1;0;1
606800;202010;352590;G;4686902;2;0;2
606896;202010;352590;S;9602502;3;0;3
606945;202010;352590;J;6209100;29;1;28
607335;202010;352590;I;5611201;2;0;2
607370;202010;352590;C;2539001;0;1;-1
607801;202010;352590;K;6622300;1;0;1
608024;202010;352590;G;4789001;1;0;1
608271;202010;352590;G;4530703;3;0;3
608294;202010;352590;S;9602502;2;0;2
608447;202010;352590;I;5611203;6;0;6
608448;202010;352590;I;5611203;0;1;-1
609610;202010;352590;I;5611203;2;0;2
609740;202010;352590;P;8599604;1;3;-2
610202;202010;352590;F;4222701;0;2;-2
610203;202010;352590;F;4222701;1;0;1
610349;202010;352590;G;4530703;1;0;1
610350;202010;352590;G;4713001;1;1;0
610368;202010;352590;I;5611201;0;1;-1
611236;202010;352590;G;4729699;1;0;1
613180;202010;352590;J;6120501;0;3;-3
616109;202010;352590;I;5611203;8;3;5
616205;202010;352590;C;1062700;1;1;0
616206;202010;352590;C;1062700;0;2;-2
616854;202010;352590;C;1813099;1;3;-2
617062;202010;352590;H;5222200;1;0;1
617254;202010;352590;G;4647801;0;1;-1
617665;202010;352590;G;4721104;0;1;-1
617972;202010;352590;G;4753900;2;2;0
617985;202010;352590;G;4753900;2;1;1
618044;202010;352590;H;4930202;2;2;0
618052;202010;352590;F;4120400;4;6;-2
618219;202010;352590;C;2019399;1;1;0
618286;202010;352590;C;2599399;2;4;-2
618287;202010;352590;C;2599399;6;4;2
618451;202010;352590;C;2710402;20;11;9
618494;202010;352590;G;4789099;1;1;0
618578;202010;352590;L;6822600;1;2;-1
619150;202010;352590;R;9312300;0;1;-1
619151;202010;352590;G;4744005;0;2;-2
619152;202010;352590;S;9430800;1;2;-1
619153;202010;352590;C;2592602;0;2;-2
619155;202010;352590;G;4721102;1;0;1
619156;202010;352590;S;9430800;1;2;-1
619160;202010;352590;K;6550200;11;10;1
619169;202010;352590;K;6550200;0;1;-1
619174;202010;352590;K;6550200;3;5;-2
619187;202010;352590;K;6550200;2;0;2
619225;202010;352590;K;6550200;3;1;2
619255;202010;352590;F;4399105;1;3;-2
619256;202010;352590;S;9430800;1;2;-1
619258;202010;352590;C;2342702;1;1;0
619415;202010;352590;C;2013402;10;4;6
619416;202010;352590;C;2013402;1;0;1
619962;202010;352590;G;4781400;1;1;0
620086;202010;352590;G;4781400;2;6;-4
620241;202010;352590;G;4781400;2;1;1
620349;202010;352590;G;4773300;1;1;0
620549;202010;352590;F;4120400;0;1;-1
620572;202010;352590;C;2862300;1;0;1
620689;202010;352590;G;4782201;1;0;1
620691;202010;352590;G;4782201;2;4;-2
620692;202010;352590;G;4782201;1;0;1
620730;202010;352590;G;4761003;1;0;1
620772;202010;352590;G;4711301;23;8;15
620887;202010;352590;G;4731800;0;3;-3
621164;202010;352590;G;4744005;1;1;0
621245;202010;352590;C;2821601;5;1;4
621258;202010;352590;O;8411600;5;1;4
621892;202010;352590;C;3250705;2;1;1
622026;202010;352590;C;2063100;11;6;5
622039;202010;352590;C;2651500;1;4;-3
622113;202010;352590;G;4781400;1;0;1
622440;202010;352590;P;8599601;0;1;-1
622456;202010;352590;G;4744002;1;1;0
622478;202010;352590;H;4930202;2;1;1
622479;202010;352590;G;4639701;4;7;-3
622491;202010;352590;G;4754701;1;0;1
622492;202010;352590;F;4313400;1;2;-1
622665;202010;352590;N;8111700;5;1;4
622712;202010;352590;M;6920601;1;1;0
622737;202010;352590;H;4930202;1;0;1
622936;202010;352590;G;4781400;3;3;0
623404;202010;352590;G;4711302;0;7;-7
623675;202010;352590;G;4771701;1;0;1
623883;202010;352590;G;4711302;0;7;-7
624042;202010;352590;I;5510801;0;1;-1
624199;202010;352590;Q;8640202;3;2;1
624202;202010;352590;Q;8690999;3;2;1
624215;202010;352590;Q;8640299;4;0;4
624220;202010;352590;Q;8640202;4;3;1
624500;202010;352590;G;4789007;0;1;-1
624501;202010;352590;G;4789002;1;0;1
624504;202010;352590;G;4711302;1;0;1
624812;202010;352590;G;4713001;1;1;0
626131;202010;352590;G;4774100;0;1;-1
626150;202010;352590;H;4921301;0;5;-5
626435;202010;352590;G;4731800;1;1;0
627008;202010;352590;H;5211799;0;1;-1
627092;202010;352590;Q;8640205;6;4;2
627141;202010;352590;C;2229399;6;4;2
627343;202010;352590;I;5611201;0;1;-1
627407;202010;352590;G;4781400;1;1;0
627436;202010;352590;G;4781400;1;0;1
627771;202010;352590;I;5620101;0;1;-1
627807;202010;352590;I;5620101;0;1;-1
627872;202010;352590;I;5620101;3;2;1
627933;202010;352590;I;5620101;2;1;1
627997;202010;352590;I;5620101;0;1;-1
628011;202010;352590;I;5620101;0;1;-1
628027;202010;352590;I;5620101;0;1;-1
628034;202010;352590;I;5620101;1;0;1
628042;202010;352590;I;5620101;0;3;-3
628122;202010;352590;I;5620101;0;1;-1
628145;202010;352590;I;5620101;0;1;-1
628187;202010;352590;I;5620101;1;0;1
628189;202010;352590;I;5620101;3;1;2
628279;202010;352590;I;5620101;2;0;2
628393;202010;352590;G;4772500;1;2;-1
628399;202010;352590;G;4772500;0;4;-4
628409;202010;352590;Q;8630503;0;1;-1
628412;202010;352590;P;8599601;0;1;-1
628413;202010;352590;P;8599601;0;1;-1
628414;202010;352590;G;4530703;1;2;-1
628492;202010;352590;P;8599699;10;16;-6
628502;202010;352590;R;9313100;1;1;0
628503;202010;352590;G;4722901;1;0;1
628519;202010;352590;G;4755503;0;1;-1
628846;202010;352590;C;1330800;27;52;-25
629181;202010;352590;K;6550200;7;2;5
629183;202010;352590;K;6550200;0;1;-1
629184;202010;352590;K;6550200;1;7;-6
629185;202010;352590;K;6550200;1;0;1
629380;202010;352590;F;4120400;0;1;-1
629409;202010;352590;H;4921301;1;4;-3
629415;202010;352590;C;1623400;4;0;4
629417;202010;352590;C;1122401;3;1;2
629418;202010;352590;G;4711302;1;1;0
629420;202010;352590;C;1081302;1;1;0
629421;202010;352590;G;4712100;1;0;1
629422;202010;352590;C;1112700;1;3;-2
629423;202010;352590;G;4731800;2;2;0
629424;202010;352590;G;4744099;1;0;1
629425;202010;352590;C;1112700;1;4;-3
629426;202010;352590;G;4530703;1;1;0
629428;202010;352590;P;8513900;8;2;6
629429;202010;352590;G;4511101;0;2;-2
629431;202010;352590;C;2229302;0;3;-3
629434;202010;352590;R;9312300;1;8;-7
629439;202010;352590;C;2219600;6;6;0
629441;202010;352590;G;4689399;2;2;0
629442;202010;352590;C;1099601;4;1;3
629443;202010;352590;C;1629301;6;8;-2
629446;202010;352590;K;6622300;3;2;1
629450;202010;352590;G;4511104;5;0;5
629451;202010;352590;C;2212900;1;0;1
629454;202010;352590;G;4672900;0;2;-2
629455;202010;352590;H;4929902;2;3;-1
629456;202010;352590;G;4712100;1;0;1
629458;202010;352590;Q;8610101;65;36;29
629459;202010;352590;G;4753900;1;0;1
629460;202010;352590;G;4771701;0;1;-1
629468;202010;352590;G;4731800;1;3;-2
629469;202010;352590;G;4711302;1;1;0
629470;202010;352590;G;4711302;1;6;-5
629472;202010;352590;G;4711302;1;5;-4
629475;202010;352590;G;4711302;1;1;0
629477;202010;352590;G;4711302;5;5;0
629479;202010;352590;G;4711302;3;2;1
629480;202010;352590;G;4711302;2;0;2
629481;202010;352590;G;4711302;12;11;1
629482;202010;352590;G;4711302;4;2;2
629484;202010;352590;G;4711302;8;7;1
629485;202010;352590;G;4639701;0;1;-1
629487;202010;352590;G;4711302;5;5;0
629489;202010;352590;G;4711302;1;1;0
629491;202010;352590;G;4711302;4;2;2
629492;202010;352590;G;4711302;4;2;2
629493;202010;352590;G;4711302;14;5;9
629494;202010;352590;H;4921301;0;6;-6
629495;202010;352590;C;1311100;2;2;0
629496;202010;352590;C;1311100;25;19;6
629497;202010;352590;C;2229301;37;77;-40
629498;202010;352590;C;2229301;23;4;19
629499;202010;352590;C;2229301;62;20;42
629500;202010;352590;C;2229301;2;1;1
629501;202010;352590;C;2229301;18;4;14
629503;202010;352590;P;8513900;2;1;1
629512;202010;352590;G;4511101;0;1;-1
629520;202010;352590;S;9430800;2;1;1
629521;202010;352590;M;7112000;2;0;2
629522;202010;352590;C;1813099;0;3;-3
629530;202010;352590;Q;8610101;1;1;0
629532;202010;352590;S;9430800;1;0;1
629533;202010;352590;P;8511200;0;1;-1
629534;202010;352590;M;6920601;1;0;1
629535;202010;352590;Q;8610101;7;17;-10
629536;202010;352590;P;8599601;1;1;0
629540;202010;352590;M;6920601;2;0;2
629541;202010;352590;C;2342702;0;2;-2
629548;202010;352590;J;5829800;0;1;-1
629551;202010;352590;Q;8711502;8;5;3
629552;202010;352590;G;4635499;0;1;-1
629560;202010;352590;G;4731800;1;0;1
629561;202010;352590;G;4711302;4;3;1
629562;202010;352590;G;4711302;2;3;-1
629563;202010;352590;G;4711302;2;5;-3
629564;202010;352590;G;4711302;0;5;-5
629566;202010;352590;G;4711302;3;7;-4
629568;202010;352590;M;6920601;1;0;1
629570;202010;352590;M;6920601;0;1;-1
629577;202010;352590;S;9420100;3;2;1
629578;202010;352590;S;9430800;0;1;-1
629579;202010;352590;S;9491000;0;1;-1
629580;202010;352590;S;9491000;1;1;0
629582;202010;352590;S;9491000;1;2;-1
629585;202010;352590;G;4633801;7;3;4
629588;202010;352590;H;4929902;1;1;0
629590;202010;352590;G;4761003;1;0;1
629591;202010;352590;P;8531700;0;1;-1
629598;202010;352590;S;9491000;0;1;-1
629599;202010;352590;M;6920601;1;0;1
629874;202010;352590;N;8211300;3;0;3
629925;202010;352590;N;8299706;0;1;-1
629926;202010;352590;M;6920601;1;4;-3
629950;202010;352590;C;2071100;1;1;0
630229;202010;352590;C;1013901;1;5;-4
630523;202010;352590;G;4744099;1;1;0
630653;202010;352590;Q;8640202;1;3;-2
630654;202010;352590;Q;8640202;1;1;0
630657;202010;352590;Q;8640202;0;1;-1
630659;202010;352590;Q;8640205;0;2;-2
630660;202010;352590;S;9601701;0;1;-1
630661;202010;352590;Q;8640202;0;1;-1
630664;202010;352590;Q;8640202;1;0;1
630665;202010;352590;Q;8640202;0;1;-1
630666;202010;352590;Q;8640202;0;1;-1
630667;202010;352590;H;4930202;0;1;-1
630690;202010;352590;S;9430800;1;3;-2
630691;202010;352590;Q;8610101;4;3;1
630726;202010;352590;S;9430800;0;2;-2
630727;202010;352590;S;9499500;0;2;-2
630728;202010;352590;M;6920601;0;1;-1
630729;202010;352590;Q;8640202;2;0;2
630738;202010;352590;G;4647801;3;3;0
630824;202010;352590;C;1622699;0;1;-1
630829;202010;352590;I;5611203;0;1;-1
630863;202010;352590;H;5112901;0;4;-4
630907;202010;352590;G;4771701;0;1;-1
630979;202010;352590;C;3250707;7;4;3
631056;202010;352590;C;2342702;2;2;0
631068;202010;352590;G;4661300;6;5;1
631213;202010;352590;N;8112500;1;1;0
631232;202010;352590;Q;8630502;0;2;-2
631233;202010;352590;N;7820500;6;1;5
631280;202010;352590;G;4639701;3;4;-1
631296;202010;352590;G;4744099;2;2;0
631302;202010;352590;G;4789008;0;1;-1
631320;202010;352590;H;4930202;4;8;-4
631341;202010;352590;G;4782201;1;1;0
631342;202010;352590;G;4782201;5;4;1
631504;202010;352590;H;4930202;8;3;5
631572;202010;352590;G;4771702;7;7;0
631654;202010;352590;I;5611201;1;0;1
631753;202010;352590;G;4530703;2;0;2
631774;202010;352590;G;4530701;1;0;1
631910;202010;352590;G;4721102;2;1;1
631937;202010;352590;C;1031700;7;5;2
631977;202010;352590;C;2512800;0;2;-2
632234;202010;352590;G;4771701;1;0;1
632306;202010;352590;G;4789004;3;3;0
632550;202010;352590;G;4669999;4;4;0
632662;202010;352590;G;4789004;1;0;1
632973;202010;352590;G;4771701;2;0;2
633065;202010;352590;N;8211300;1;0;1
633199;202010;352590;G;4712100;1;0;1
633321;202010;352590;C;2222600;1;1;0
633464;202010;352590;H;4930201;0;1;-1
633729;202010;352590;Q;8640203;4;1;3
633787;202010;352590;Q;8711501;1;3;-2
633790;202010;352590;L;6822600;1;0;1
633791;202010;352590;M;7112000;0;1;-1
633792;202010;352590;M;7112000;0;3;-3
633793;202010;352590;R;9313100;1;1;0
633795;202010;352590;P;8513900;5;1;4
633796;202010;352590;K;6622300;0;1;-1
633797;202010;352590;P;8512100;0;2;-2
633869;202010;352590;G;4520001;1;1;0
633907;202010;352590;G;4712100;3;1;2
634064;202010;352590;C;3101200;0;2;-2
634421;202010;352590;G;4744005;0;1;-1
634425;202010;352590;G;4520001;0;1;-1
634542;202010;352590;G;4712100;0;3;-3
634543;202010;352590;G;4712100;0;1;-1
634748;202010;352590;G;4744005;1;1;0
634824;202010;352590;G;4530703;1;0;1
634827;202010;352590;M;6920601;0;1;-1
634882;202010;352590;G;4511101;3;3;0
634887;202010;352590;I;5620101;0;1;-1
634911;202010;352590;G;4687702;1;0;1
635335;202010;352590;N;7732201;0;1;-1
635556;202010;352590;H;4923002;4;0;4
635620;202010;352590;C;2821602;1;0;1
636132;202010;352590;C;2829199;1;0;1
636189;202010;352590;B;810006;1;0;1
636397;202010;352590;G;4661300;3;1;2
636486;202010;352590;C;2449199;2;1;1
636679;202010;352590;M;7210000;0;3;-3
636857;202010;352590;G;4721102;0;1;-1
636859;202010;352590;G;4789005;1;0;1
636862;202010;352590;I;5510803;1;0;1
637015;202010;352590;G;4649403;0;1;-1
637432;202010;352590;G;4753900;1;1;0
637544;202010;352590;G;4511102;0;1;-1
637576;202010;352590;K;6550200;4;5;-1
637577;202010;352590;Q;8610102;2;2;0
637578;202010;352590;Q;8610101;4;3;1
637579;202010;352590;Q;8640210;0;1;-1
637580;202010;352590;Q;8610102;0;2;-2
637824;202010;352590;G;4761003;0;2;-2
638015;202010;352590;C;2591800;1;0;1
638016;202010;352590;F;4321500;2;0;2
638257;202010;352590;G;4731800;1;0;1
638287;202010;352590;C;3314708;2;0;2
638318;202010;352590;G;4541205;1;0;1
638385;202010;352590;C;2949299;2;0;2
638535;202010;352590;G;4774100;0;2;-2
638817;202010;352590;G;4721103;1;0;1
638818;202010;352590;G;4721103;0;1;-1
638872;202010;352590;H;4930202;5;2;3
638913;202010;352590;G;4530703;1;0;1
639102;202010;352590;C;2099199;3;2;1
639192;202010;352590;C;2539002;1;0;1
639199;202010;352590;C;2592602;0;1;-1
639312;202010;352590;H;4930202;2;1;1
639331;202010;352590;C;1094500;0;1;-1
639475;202010;352590;K;6493000;3;3;0
639646;202010;352590;K;6422100;1;1;0
639714;202010;352590;N;8299706;1;0;1
639750;202010;352590;G;4712100;1;0;1
639817;202010;352590;I;5611201;0;1;-1
639901;202010;352590;I;5611201;3;2;1
639970;202010;352590;C;2229302;2;0;2
640005;202010;352590;S;9420100;1;0;1
640018;202010;352590;N;8112500;0;1;-1
640019;202010;352590;N;8121400;2;1;1
640021;202010;352590;H;5223100;2;2;0
640022;202010;352590;N;8112500;2;0;2
640279;202010;352590;G;4763601;0;1;-1
640319;202010;352590;F;4221902;2;0;2
640374;202010;352590;G;4771702;1;0;1
640379;202010;352590;H;4929902;17;9;8
640408;202010;352590;I;5611201;0;2;-2
640409;202010;352590;I;5611201;0;1;-1
640466;202010;352590;G;4763601;11;11;0
640789;202010;352590;G;4635402;6;7;-1
640831;202010;352590;G;4731800;0;1;-1
640887;202010;352590;C;2229399;13;8;5
640916;202010;352590;H;4930202;3;0;3
640963;202010;352590;N;8112500;1;0;1
640964;202010;352590;Q;8640205;4;1;3
640965;202010;352590;M;6911701;0;1;-1
640996;202010;352590;P;8512100;0;5;-5
640997;202010;352590;P;8512100;1;0;1
641003;202010;352590;M;6920601;0;1;-1
641004;202010;352590;N;8112500;0;1;-1
641005;202010;352590;J;6202300;0;1;-1
641006;202010;352590;Q;8640202;0;1;-1
641007;202010;352590;S;9430800;0;1;-1
641141;202010;352590;C;2944100;37;9;28
641175;202010;352590;C;1629301;0;4;-4
641583;202010;352590;F;4292802;23;9;14
641689;202010;352590;H;4930202;1;1;0
641720;202010;352590;G;4721102;2;2;0
641952;202010;352590;G;4751201;1;0;1
641955;202010;352590;G;4755502;1;1;0
641971;202010;352590;H;4930202;0;1;-1
641975;202010;352590;G;4774100;1;0;1
642042;202010;352590;C;1091101;1;0;1
642043;202010;352590;H;4930202;0;1;-1
642049;202010;352590;G;4744001;1;0;1
642053;202010;352590;N;7732201;0;2;-2
642079;202010;352590;G;4741500;0;1;-1
642264;202010;352590;G;4731800;1;0;1
642270;202010;352590;G;4731800;1;1;0
642295;202010;352590;C;1314600;9;1;8
642709;202010;352590;G;4633801;0;1;-1
643053;202010;352590;C;2032100;0;4;-4
643179;202010;352590;M;7210000;1;6;-5
643316;202010;352590;C;2522500;29;4;25
643599;202010;352590;Q;8610101;4;11;-7
643636;202010;352590;C;2014200;1;2;-1
643755;202010;352590;G;4530703;1;0;1
643761;202010;352590;C;1412601;1;0;1
643775;202010;352590;C;2812700;2;2;0
643822;202010;352590;K;6422100;0;1;-1
644414;202010;352590;G;4631100;0;1;-1
644610;202010;352590;K;6422100;0;1;-1
644815;202010;352590;K;6422100;0;6;-6
645079;202010;352590;K;6422100;0;1;-1
645447;202010;352590;K;6422100;0;1;-1
645601;202010;352590;K;6422100;0;1;-1
645666;202010;352590;K;6422100;0;1;-1
645765;202010;352590;K;6422100;0;1;-1
646100;202010;352590;K;6422100;0;1;-1
646664;202010;352590;C;2222600;4;1;3
646671;202010;352590;G;4744005;2;0;2
646834;202010;352590;Q;8690999;1;0;1
646835;202010;352590;Q;8690999;0;1;-1
646888;202010;352590;Q;8640202;4;1;3
646931;202010;352590;G;4744005;2;1;1
646942;202010;352590;G;4511104;2;1;1
647029;202010;352590;B;810099;1;2;-1
647030;202010;352590;C;2330302;1;3;-2
647031;202010;352590;A;122900;0;1;-1
647132;202010;352590;P;8513900;0;1;-1
647213;202010;352590;G;4781400;0;1;-1
647291;202010;352590;G;4633802;2;0;2
647292;202010;352590;G;4633802;0;2;-2
647325;202010;352590;C;1099603;1;0;1
647476;202010;352590;Q;8800600;2;2;0
647548;202010;352590;Q;8711502;2;1;1
647589;202010;352590;I;5611201;1;1;0
647648;202010;352590;Q;8640212;2;0;2
647652;202010;352590;Q;8640212;0;1;-1
647653;202010;352590;Q;8640212;1;0;1
647700;202010;352590;S;9491000;2;2;0
647743;202010;352590;C;2599399;5;0;5
647983;202010;352590;H;4922102;2;0;2
648041;202010;352590;C;2949299;1;2;-1
648042;202010;352590;C;2949299;0;1;-1
648117;202010;352590;G;4713001;2;0;2
648378;202010;352590;G;4713004;3;7;-4
648413;202010;352590;G;4646001;2;1;1
648589;202010;352590;C;2591800;2;5;-3
648657;202010;352590;G;4635402;6;3;3
648663;202010;352590;C;1122401;16;9;7
648753;202010;352590;G;4781400;0;1;-1
648845;202010;352590;C;1721400;1;1;0
648961;202010;352590;G;4711302;4;9;-5
649578;202010;352590;G;4771701;3;1;2
649877;202010;352590;G;4771701;1;0;1
650205;202010;352590;G;4645101;1;0;1
650539;202010;352590;N;8211300;6;14;-8
650622;202010;352590;C;1412601;2;0;2
650678;202010;352590;C;1411801;10;10;0
650776;202010;352590;C;1111902;1;0;1
650889;202010;352590;G;4771701;1;0;1
650995;202010;352590;G;4771701;2;1;1
651146;202010;352590;G;4771701;0;1;-1
651292;202010;352590;G;4771701;1;1;0
651747;202010;352590;G;4771701;1;0;1
651767;202010;352590;G;4771701;1;0;1
651842;202010;352590;G;4771701;1;0;1
651971;202010;352590;Q;8800600;2;18;-16
652039;202010;352590;G;4635402;1;0;1
652295;202010;352590;N;8121400;41;28;13
652425;202010;352590;G;4782202;1;1;0
652426;202010;352590;G;4782202;0;1;-1
653248;202010;352590;G;4759899;1;1;0
653360;202010;352590;I;5612100;0;1;-1
653439;202010;352590;G;4637107;6;1;5
653488;202010;352590;F;4321500;1;0;1
653889;202010;352590;G;4633801;1;0;1
654266;202010;352590;G;4789002;2;7;-5
654430;202010;352590;G;4744099;2;3;-1
654458;202010;352590;G;4530701;1;0;1
655430;202010;352590;J;6209100;3;4;-1
655446;202010;352590;Q;8660700;7;4;3
656044;202010;352590;C;1412602;0;1;-1
656287;202010;352590;F;4120400;3;0;3
656292;202010;352590;C;3314710;7;8;-1
656313;202010;352590;C;1053800;0;1;-1
656504;202010;352590;G;4752100;1;0;1
657197;202010;352590;G;4530703;1;2;-1
657212;202010;352590;G;4530705;0;1;-1
657411;202010;352590;H;4930202;1;1;0
657527;202010;352590;G;4789099;2;1;1
657759;202010;352590;G;4711302;28;48;-20
657815;202010;352590;C;1099699;5;2;3
657904;202010;352590;R;9329803;0;1;-1
657925;202010;352590;F;4211101;2;3;-1
657988;202010;352590;G;4783101;2;1;1
658653;202010;352590;N;7739099;5;1;4
658672;202010;352590;I;5611203;2;1;1
658673;202010;352590;I;5611203;9;4;5
658808;202010;352590;G;4789099;1;1;0
659233;202010;352590;G;4530701;0;1;-1
659323;202010;352590;N;8111700;18;18;0
659324;202010;352590;H;5223100;0;1;-1
659343;202010;352590;P;8512100;0;1;-1
659344;202010;352590;N;8112500;0;1;-1
659345;202010;352590;Q;8690999;1;4;-3
659356;202010;352590;N;8112500;1;0;1
659358;202010;352590;N;8112500;0;1;-1
659359;202010;352590;N;8121400;1;1;0
659360;202010;352590;Q;8640207;1;1;0
659439;202010;352590;G;4771701;0;2;-2
659440;202010;352590;G;4771701;1;0;1
659441;202010;352590;G;4771701;0;1;-1
659449;202010;352590;G;4754701;0;1;-1
659476;202010;352590;C;2731700;1;0;1
659524;202010;352590;G;4744005;1;1;0
659708;202010;352590;C;2014200;4;3;1
659733;202010;352590;G;4722901;2;0;2
659815;202010;352590;F;4120400;14;8;6
659961;202010;352590;F;4120400;3;0;3
660064;202010;352590;G;4729699;2;1;1
660114;202010;352590;G;4713002;0;1;-1
660185;202010;352590;G;4789099;1;1;0
660240;202010;352590;C;2229399;0;1;-1
660290;202010;352590;G;4781400;0;1;-1
660358;202010;352590;I;5620101;0;1;-1
660452;202010;352590;I;5620101;0;1;-1
660494;202010;352590;I;5620101;0;3;-3
660667;202010;352590;N;8112500;0;1;-1
660668;202010;352590;N;8112500;1;0;1
660749;202010;352590;I;5611201;0;1;-1
660782;202010;352590;G;4744005;2;4;-2
660792;202010;352590;G;4781400;1;0;1
660815;202010;352590;G;4744005;1;0;1
660826;202010;352590;G;4623199;4;1;3
660837;202010;352590;H;4930202;1;2;-1
660852;202010;352590;C;2599399;0;2;-2
661203;202010;352590;G;4783101;1;0;1
661259;202010;352590;I;5611201;0;1;-1
662129;202010;352590;J;6203100;2;3;-1
662281;202010;352590;C;2543800;3;0;3
662306;202010;352590;C;2330302;1;1;0
662458;202010;352590;G;4712100;1;0;1
662462;202010;352590;G;4712100;1;0;1
662479;202010;352590;G;4712100;0;1;-1
662555;202010;352590;G;4721102;0;2;-2
662602;202010;352590;I;5611201;0;1;-1
662634;202010;352590;G;4771702;1;1;0
664331;202010;352590;G;4511101;2;1;1
664474;202010;352590;C;2229301;48;42;6
664689;202010;352590;F;4110700;1;0;1
664690;202010;352590;F;4110700;0;1;-1
664726;202010;352590;G;4712100;0;1;-1
664772;202010;352590;N;7739099;1;2;-1
664782;202010;352590;C;3314710;1;1;0
664851;202010;352590;G;4771701;1;1;0
664880;202010;352590;I;5611201;0;1;-1
665005;202010;352590;G;4744005;1;1;0
665121;202010;352590;G;4741500;1;1;0
665124;202010;352590;G;4741500;1;1;0
665127;202010;352590;G;4741500;0;3;-3
665157;202010;352590;G;4744005;0;1;-1
666142;202010;352590;C;3299099;4;1;3
666398;202010;352590;G;4781400;0;1;-1
666427;202010;352590;C;2822402;0;1;-1
666548;202010;352590;I;5611201;0;1;-1
666554;202010;352590;G;4663000;1;0;1
666599;202010;352590;G;4774100;0;1;-1
666683;202010;352590;G;4789099;0;1;-1
666697;202010;352590;G;4731800;2;1;1
666698;202010;352590;G;4731800;1;0;1
666713;202010;352590;C;2099199;3;0;3
666714;202010;352590;G;4692300;0;1;-1
666868;202010;352590;G;4520005;3;1;2
666887;202010;352590;G;4761002;0;1;-1
667047;202010;352590;J;5813100;0;1;-1
667122;202010;352590;G;4743100;0;1;-1
667593;202010;352590;G;4635402;10;1;9
669323;202010;352590;I;5611201;1;1;0
669335;202010;352590;C;1330800;9;3;6
669523;202010;352590;G;4711302;1;1;0
669524;202010;352590;G;4729699;0;2;-2
669597;202010;352590;C;2014200;1;0;1
669608;202010;352590;M;7490104;0;3;-3
670622;202010;352590;G;4711301;14;9;5
671006;202010;352590;I;5620101;0;4;-4
671265;202010;352590;C;2349401;53;5;48
671271;202010;352590;N;8211300;2;4;-2
671794;202010;352590;H;4930202;5;5;0
672914;202010;352590;G;4672900;2;2;0
673635;202010;352590;C;2812700;0;1;-1
674382;202010;352590;H;4930203;1;1;0
675374;202010;352590;G;4757100;2;0;2
677094;202010;352590;G;4530703;3;3;0
677616;202010;352590;G;4711301;12;6;6
679975;202010;352590;I;5510801;2;2;0
682834;202010;352590;K;6424703;1;1;0
683387;202010;352590;H;4930202;1;1;0
684842;202010;352590;G;4679604;11;7;4
685339;202010;352590;C;3314710;58;12;46
686370;202010;352590;G;4783101;2;0;2
690302;202010;352590;G;4661300;0;1;-1
692389;202010;352590;H;4930202;30;4;26
693802;202010;352590;C;1733800;13;3;10
693803;202010;352590;C;1733800;10;0;10
698293;202010;352590;G;4744001;3;1;2
698960;202010;352590;G;4781400;2;2;0
699059;202010;352590;G;4781400;0;1;-1
701716;202010;352590;I;5620101;2;1;1
703307;202010;352590;C;1733800;1;6;-5
703483;202010;352590;N;7732201;1;2;-1
703843;202010;352590;E;3832700;1;1;0
703844;202010;352590;I;5620101;3;4;-1
703872;202010;352590;G;4771702;0;1;-1
703885;202010;352590;G;4781400;0;1;-1
705096;202010;352590;F;4330401;0;8;-8
705386;202010;352590;G;4752100;0;1;-1
705707;202010;352590;C;2813500;20;22;-2
705708;202010;352590;C;2349401;108;30;78
714812;202010;352590;M;6912500;1;0;1
724065;202010;352590;M;6912500;1;0;1
2120;202006;352590;C;2599399;1;1;0
2241;202006;352590;J;6311900;0;2;-2
2293;202006;352590;G;4744005;2;1;1
2751;202006;352590;C;2812700;1;5;-4
3133;202006;352590;C;2222600;0;1;-1
3209;202006;352590;Q;8630503;1;1;0
3229;202006;352590;C;2949299;3;0;3
3309;202006;352590;G;4672900;0;2;-2
3356;202006;352590;I;5611203;1;0;1
3882;202006;352590;C;2040100;0;1;-1
3997;202006;352590;N;7739099;2;2;0
4041;202006;352590;H;4924800;0;40;-40
4065;202006;352590;N;7810800;22;2;20
4215;202006;352590;K;6622300;3;0;3
4762;202006;352590;C;2512800;1;0;1
5377;202006;352590;G;4757100;0;1;-1
5540;202006;352590;G;4753900;10;1;9
5917;202006;352590;C;2229303;1;3;-2
6892;202006;352590;G;4789099;1;0;1
6966;202006;352590;I;5611203;1;0;1
7648;202006;352590;I;5611203;0;1;-1
8018;202006;352590;G;4789007;0;1;-1
8277;202006;352590;G;4789099;0;1;-1
8555;202006;352590;N;8299706;1;0;1
8956;202006;352590;G;4530703;0;1;-1
9143;202006;352590;H;5211799;6;4;2
9309;202006;352590;F;4330499;0;1;-1
9573;202006;352590;G;4772500;0;1;-1
9775;202006;352590;I;5611203;1;2;-1
9838;202006;352590;Q;8610101;9;11;-2
10265;202006;352590;C;1610201;1;1;0
10839;202006;352590;H;4929902;7;6;1
10855;202006;352590;R;9313100;0;2;-2
10982;202006;352590;S;9601703;18;17;1
11549;202006;352590;C;2341900;1;1;0
11787;202006;352590;G;4616800;0;1;-1
11986;202006;352590;F;4120400;0;1;-1
11991;202006;352590;J;6319400;0;19;-19
12854;202006;352590;Q;8640299;1;2;-1
13041;202006;352590;H;5229002;0;1;-1
13524;202006;352590;S;9601701;0;1;-1
13710;202006;352590;M;6920601;0;1;-1
14035;202006;352590;G;4781400;0;4;-4
14487;202006;352590;C;2731700;2;1;1
14581;202006;352590;G;4693100;11;10;1
14627;202006;352590;G;4511101;6;8;-2
14761;202006;352590;N;8230001;0;1;-1
15095;202006;352590;I;5611201;0;2;-2
15184;202006;352590;G;4644301;24;9;15
15252;202006;352590;M;7112000;2;10;-8
15459;202006;352590;K;6622300;1;0;1
15460;202006;352590;K;6622300;0;1;-1
15669;202006;352590;M;7490104;1;0;1
15710;202006;352590;H;5250804;1;0;1
15841;202006;352590;G;4771701;1;0;1
15878;202006;352590;N;8292000;0;4;-4
16299;202006;352590;F;4330499;0;1;-1
16328;202006;352590;N;8299701;7;2;5
16682;202006;352590;I;5611201;1;0;1
17368;202006;352590;G;4721102;1;0;1
17923;202006;352590;G;4689399;0;7;-7
18394;202006;352590;M;6920601;1;0;1
18426;202006;352590;C;2822402;1;1;0
18647;202006;352590;I;5611203;0;3;-3
18732;202006;352590;C;3102100;0;1;-1
19057;202006;352590;H;4930203;1;11;-10
19061;202006;352590;H;4930202;0;7;-7
19309;202006;352590;G;4689301;1;0;1
19319;202006;352590;N;8112500;1;0;1
19320;202006;352590;Q;8640299;0;4;-4
19326;202006;352590;F;4329104;2;1;1
20018;202006;352590;H;5223100;0;1;-1
20453;202006;352590;M;6920601;0;1;-1
21058;202006;352590;F;4399199;0;1;-1
21295;202006;352590;H;4930202;4;2;2
21351;202006;352590;G;4530703;1;0;1
21437;202006;352590;C;1062700;0;7;-7
21495;202006;352590;M;7120100;1;1;0
22037;202006;352590;C;1081302;1;3;-2
22391;202006;352590;M;7112000;0;1;-1
22672;202006;352590;M;7020400;0;1;-1
22841;202006;352590;I;5611201;0;1;-1
23034;202006;352590;G;4721104;0;1;-1
23469;202006;352590;G;4687703;1;0;1
23851;202006;352590;P;8512100;1;4;-3
23921;202006;352590;N;8211300;16;9;7
23922;202006;352590;G;4634601;1;10;-9
24039;202006;352590;G;4712100;1;0;1
24462;202006;352590;C;2219600;2;0;2
24512;202006;352590;G;4712100;0;1;-1
24619;202006;352590;C;2222600;3;0;3
25475;202006;352590;G;4789099;1;0;1
25612;202006;352590;I;5611203;0;1;-1
26078;202006;352590;C;2949299;0;4;-4
26331;202006;352590;G;4752100;0;3;-3
26726;202006;352590;G;4530702;1;1;0
26851;202006;352590;C;2539001;0;1;-1
26944;202006;352590;G;4687703;0;1;-1
27087;202006;352590;C;2599399;1;0;1
27131;202006;352590;C;2599399;0;1;-1
27134;202006;352590;G;4759899;1;0;1
27419;202006;352590;C;1610202;2;0;2
27526;202006;352590;G;4744005;1;0;1
28025;202006;352590;H;4930202;2;0;2
28368;202006;352590;F;4313400;2;19;-17
28887;202006;352590;G;4731800;0;1;-1
29456;202006;352590;G;4639701;3;1;2
29469;202006;352590;C;2539001;0;5;-5
29593;202006;352590;S;9430800;0;1;-1
29876;202006;352590;C;2511000;0;4;-4
29999;202006;352590;G;4751201;4;2;2
30251;202006;352590;P;8511200;0;2;-2
30662;202006;352590;G;4763602;0;1;-1
30960;202006;352590;C;1081302;3;1;2
31159;202006;352590;N;8011101;5;4;1
31423;202006;352590;C;1721400;2;1;1
31759;202006;352590;G;4731800;0;1;-1
31887;202006;352590;N;8112500;0;1;-1
32687;202006;352590;F;4120400;7;0;7
32744;202006;352590;G;4511101;0;2;-2
32769;202006;352590;H;5221400;2;12;-10
32866;202006;352590;C;2941700;0;1;-1
33483;202006;352590;G;4784900;1;1;0
33561;202006;352590;G;4754701;1;0;1
33885;202006;352590;C;2751100;1;1;0
34057;202006;352590;G;4686902;0;7;-7
34318;202006;352590;I;5611203;0;1;-1
35631;202006;352590;G;4773300;0;1;-1
35662;202006;352590;H;4930202;0;2;-2
36779;202006;352590;N;7820500;2;3;-1
36831;202006;352590;G;4511101;0;1;-1
37045;202006;352590;I;5611203;0;4;-4
37094;202006;352590;G;4511101;0;2;-2
37864;202006;352590;C;2091600;6;0;6
37991;202006;352590;P;8512100;0;6;-6
38114;202006;352590;G;4520001;0;1;-1
38200;202006;352590;F;4211101;0;2;-2
38521;202006;352590;H;4930202;8;11;-3
38595;202006;352590;G;4721102;0;2;-2
38775;202006;352590;C;2391503;0;1;-1
38871;202006;352590;H;5211799;40;4;36
39041;202006;352590;N;8211300;2;8;-6
39881;202006;352590;H;5223100;0;1;-1
39992;202006;352590;I;5620103;0;1;-1
40316;202006;352590;C;1013901;7;6;1
40791;202006;352590;J;6204000;0;1;-1
40914;202006;352590;H;5223100;4;0;4
40977;202006;352590;P;8599602;0;1;-1
41759;202006;352590;G;4753900;0;1;-1
42497;202006;352590;H;4930202;1;1;0
42882;202006;352590;H;4930202;9;7;2
43090;202006;352590;G;4789001;0;1;-1
43262;202006;352590;N;8121400;12;4;8
43323;202006;352590;N;8291100;0;1;-1
43525;202006;352590;C;2222600;9;8;1
43741;202006;352590;M;7112000;0;1;-1
43796;202006;352590;G;4771701;1;1;0
44717;202006;352590;K;6622300;0;2;-2
44906;202006;352590;G;4744002;0;1;-1
45141;202006;352590;F;4330499;0;5;-5
45142;202006;352590;F;4330499;2;0;2
45143;202006;352590;F;4330499;0;4;-4
46464;202006;352590;G;4789007;0;1;-1
46781;202006;352590;I;5620101;1;0;1
46795;202006;352590;Q;8720401;2;0;2
46884;202006;352590;G;4754703;0;1;-1
47803;202006;352590;G;4789099;0;1;-1
48016;202006;352590;G;4759899;0;1;-1
48156;202006;352590;F;4120400;0;1;-1
48288;202006;352590;G;4754701;0;1;-1
48414;202006;352590;P;8513900;0;13;-13
48885;202006;352590;J;5819100;0;1;-1
48949;202006;352590;K;6622300;0;1;-1
49118;202006;352590;G;4744099;1;0;1
49136;202006;352590;G;4771702;1;0;1
49149;202006;352590;G;4781400;0;1;-1
49958;202006;352590;G;4711302;8;1;7
50032;202006;352590;G;4711302;5;0;5
50397;202006;352590;F;4391600;2;1;1
51139;202006;352590;G;4729699;0;1;-1
51267;202006;352590;C;2539002;1;0;1
51910;202006;352590;E;3600601;0;1;-1
51927;202006;352590;I;5611203;0;7;-7
52197;202006;352590;C;1093702;0;1;-1
52505;202006;352590;N;7820500;235;159;76
52973;202006;352590;C;1733800;0;1;-1
53284;202006;352590;N;8112500;0;1;-1
53687;202006;352590;G;4751201;2;3;-1
53739;202006;352590;G;4724500;0;1;-1
53951;202006;352590;C;3292202;1;0;1
54025;202006;352590;H;4930202;0;1;-1
54243;202006;352590;N;8112500;0;1;-1
54275;202006;352590;P;8599699;0;1;-1
54547;202006;352590;N;7820500;540;341;199
54917;202006;352590;J;6204000;0;1;-1
55677;202006;352590;P;8599699;0;5;-5
55727;202006;352590;P;8599699;0;2;-2
55962;202006;352590;F;4399199;1;0;1
56519;202006;352590;G;4633801;0;2;-2
56654;202006;352590;G;4713002;0;1;-1
56743;202006;352590;G;4774100;0;1;-1
56759;202006;352590;N;8129000;27;43;-16
56784;202006;352590;G;4771701;0;1;-1
56833;202006;352590;C;2222600;0;2;-2
56936;202006;352590;K;6622300;0;1;-1
57455;202006;352590;H;4930202;0;8;-8
57456;202006;352590;H;4930202;6;6;0
57474;202006;352590;G;4783101;0;1;-1
57664;202006;352590;H;5211701;1;0;1
57832;202006;352590;G;4789005;1;0;1
58079;202006;352590;G;4731800;0;1;-1
58258;202006;352590;G;4744005;2;0;2
58307;202006;352590;G;4637106;5;3;2
58965;202006;352590;Q;8630503;0;1;-1
59049;202006;352590;I;5611203;0;1;-1
59370;202006;352590;I;5510803;0;1;-1
60462;202006;352590;N;8211300;0;1;-1
60607;202006;352590;Q;8630504;0;1;-1
60650;202006;352590;N;8291100;0;3;-3
61067;202006;352590;G;4689399;0;1;-1
61380;202006;352590;G;4672900;0;1;-1
61447;202006;352590;I;5611201;7;10;-3
61449;202006;352590;I;5611201;0;2;-2
61649;202006;352590;N;8299799;1;12;-11
61650;202006;352590;N;8299799;0;6;-6
61688;202006;352590;Q;8711502;3;0;3
61892;202006;352590;J;6203100;1;2;-1
62075;202006;352590;G;4742300;0;2;-2
62478;202006;352590;H;5211701;0;2;-2
62580;202006;352590;D;3514000;2;1;1
63650;202006;352590;H;4930201;4;0;4
63875;202006;352590;C;2029100;0;4;-4
64114;202006;352590;H;5112901;0;3;-3
64421;202006;352590;G;4520001;1;1;0
64791;202006;352590;N;7820500;0;1;-1
64810;202006;352590;P;8593700;0;2;-2
64991;202006;352590;P;8532500;0;16;-16
65059;202006;352590;G;4789002;2;0;2
65074;202006;352590;P;8599699;8;4;4
65230;202006;352590;M;6911701;0;1;-1
65470;202006;352590;G;4541202;1;1;0
66028;202006;352590;G;4712100;0;1;-1
66410;202006;352590;Q;8630503;0;2;-2
66818;202006;352590;C;3314721;0;1;-1
67111;202006;352590;G;4511101;0;1;-1
67302;202006;352590;N;7711000;1;1;0
67474;202006;352590;F;4299599;12;8;4
67817;202006;352590;Q;8640210;0;1;-1
67818;202006;352590;N;8211300;1;0;1
68238;202006;352590;G;4731800;0;6;-6
68290;202006;352590;G;4639701;14;9;5
68730;202006;352590;G;4731800;0;1;-1
69738;202006;352590;N;8299799;3;2;1
70017;202006;352590;G;4771701;1;1;0
70257;202006;352590;G;4712100;0;1;-1
70839;202006;352590;H;4930202;0;3;-3
71224;202006;352590;P;8512100;0;1;-1
71875;202006;352590;H;5250804;5;15;-10
72026;202006;352590;G;4530705;0;1;-1
72058;202006;352590;G;4789002;1;1;0
72163;202006;352590;C;3321000;0;1;-1
72248;202006;352590;C;3299004;0;1;-1
72408;202006;352590;G;4781400;0;4;-4
73128;202006;352590;N;8299706;0;1;-1
73241;202006;352590;P;8599603;0;1;-1
73295;202006;352590;I;5611201;0;1;-1
73482;202006;352590;G;4755501;0;1;-1
73641;202006;352590;C;3314713;0;1;-1
74194;202006;352590;G;4520001;3;0;3
74300;202006;352590;E;3600602;1;1;0
74606;202006;352590;Q;8650099;5;4;1
74787;202006;352590;G;4789007;1;2;-1
74821;202006;352590;G;4686902;0;1;-1
74848;202006;352590;G;4753900;0;1;-1
75103;202006;352590;N;8299706;1;0;1
75243;202006;352590;F;4321500;0;1;-1
75495;202006;352590;J;6202300;0;1;-1
76049;202006;352590;G;4639701;0;1;-1
76227;202006;352590;K;6612603;0;1;-1
76532;202006;352590;H;4930201;0;5;-5
77277;202006;352590;C;2222600;4;1;3
77842;202006;352590;G;4712100;0;1;-1
78113;202006;352590;I;5611201;0;1;-1
78552;202006;352590;G;4789002;0;2;-2
78759;202006;352590;I;5611201;0;1;-1
78760;202006;352590;Q;8640210;0;1;-1
78856;202006;352590;C;2424501;0;1;-1
79494;202006;352590;F;4299599;7;4;3
80031;202006;352590;G;4520002;0;1;-1
80100;202006;352590;S;9430800;0;3;-3
80985;202006;352590;N;8299706;1;0;1
80992;202006;352590;N;8299706;0;1;-1
81928;202006;352590;G;4761002;0;1;-1
82744;202006;352590;J;5914600;1;0;1
82817;202006;352590;I;5611201;3;0;3
82822;202006;352590;C;2950600;0;1;-1
82926;202006;352590;Q;8640205;2;1;1
83193;202006;352590;N;7911200;0;2;-2
83218;202006;352590;G;4731800;0;1;-1
83222;202006;352590;G;4782201;0;1;-1
83238;202006;352590;F;4313400;0;9;-9
83488;202006;352590;I;5611203;0;1;-1
83647;202006;352590;F;4313400;2;13;-11
83772;202006;352590;G;4511101;5;1;4
84359;202006;352590;I;5611201;2;1;1
85201;202006;352590;P;8512100;0;1;-1
85591;202006;352590;M;6920601;0;1;-1
86380;202006;352590;N;7820500;130;105;25
86633;202006;352590;I;5620101;1;0;1
87149;202006;352590;Q;8712300;4;1;3
87202;202006;352590;N;8299799;2;0;2
87908;202006;352590;M;6920601;0;1;-1
88123;202006;352590;G;4755502;1;0;1
88124;202006;352590;G;4783101;0;1;-1
88698;202006;352590;G;4789008;0;1;-1
90674;202006;352590;I;5611201;0;1;-1
90773;202006;352590;G;4721102;1;1;0
90829;202006;352590;C;2222600;0;1;-1
91036;202006;352590;G;4744099;0;1;-1
91808;202006;352590;G;4693100;2;0;2
91956;202006;352590;G;4711302;4;11;-7
91986;202006;352590;G;4774100;0;1;-1
92174;202006;352590;G;4649499;2;2;0
92226;202006;352590;G;4771701;1;0;1
92230;202006;352590;M;6920601;1;0;1
93308;202006;352590;N;8219999;0;1;-1
93435;202006;352590;C;2823200;0;1;-1
93584;202006;352590;C;2825900;1;3;-2
94409;202006;352590;G;4741500;0;1;-1
94871;202006;352590;G;4759899;0;1;-1
94874;202006;352590;G;4649499;1;3;-2
94941;202006;352590;G;4761001;1;0;1
95076;202006;352590;G;4520001;0;1;-1
95320;202006;352590;G;4772500;0;1;-1
95577;202006;352590;H;4930203;1;1;0
95610;202006;352590;G;4712100;1;0;1
95652;202006;352590;N;8299799;0;2;-2
95789;202006;352590;G;4633801;0;1;-1
95852;202006;352590;G;4789099;0;1;-1
95965;202006;352590;C;1099699;1;1;0
96844;202006;352590;G;4711302;10;3;7
96977;202006;352590;G;4711301;48;2;46
97134;202006;352590;G;4711302;0;1;-1
97172;202006;352590;G;4511102;2;0;2
97192;202006;352590;F;4322302;1;1;0
97268;202006;352590;G;4754702;1;0;1
97595;202006;352590;C;2829199;1;1;0
97641;202006;352590;I;5611201;0;1;-1
97880;202006;352590;P;8531700;0;64;-64
97897;202006;352590;C;2941700;1;0;1
99433;202006;352590;G;4761001;0;1;-1
100372;202006;352590;G;4781400;0;1;-1
100551;202006;352590;F;4120400;1;0;1
100911;202006;352590;F;4313400;13;18;-5
100922;202006;352590;G;4721102;0;1;-1
100953;202006;352590;G;4759899;0;1;-1
101534;202006;352590;C;1013902;0;2;-2
102511;202006;352590;G;4712100;4;2;2
102654;202006;352590;G;4789002;1;0;1
102917;202006;352590;G;4763602;2;0;2
103156;202006;352590;H;4930202;0;13;-13
103786;202006;352590;J;6209100;1;0;1
104886;202006;352590;G;4731800;0;1;-1
105586;202006;352590;G;4652400;0;22;-22
106492;202006;352590;G;4711302;11;14;-3
107715;202006;352590;G;4763603;1;0;1
107716;202006;352590;G;4763603;2;1;1
107758;202006;352590;G;4731800;0;1;-1
108127;202006;352590;N;8011101;16;10;6
108349;202006;352590;G;4649410;0;2;-2
108737;202006;352590;K;6424703;0;1;-1
109118;202006;352590;H;4930202;2;1;1
109462;202006;352590;N;8211300;4;4;0
109726;202006;352590;G;4530703;0;1;-1
110040;202006;352590;G;4781400;0;1;-1
110467;202006;352590;C;2790299;0;1;-1
110494;202006;352590;G;4754702;1;0;1
110503;202006;352590;N;7820500;0;1;-1
111216;202006;352590;E;3701100;2;1;1
111257;202006;352590;C;1053800;1;0;1
111389;202006;352590;Q;8630501;4;3;1
111706;202006;352590;G;4633801;11;9;2
111979;202006;352590;G;4645103;0;4;-4
112660;202006;352590;P;8599605;0;1;-1
112910;202006;352590;C;2622100;0;1;-1
113215;202006;352590;F;4321500;1;0;1
113327;202006;352590;N;8111700;1;2;-1
113774;202006;352590;F;4299599;6;1;5
114166;202006;352590;G;4731800;0;1;-1
114251;202006;352590;G;4731800;0;1;-1
114350;202006;352590;C;2790299;0;1;-1
114507;202006;352590;S;9430800;0;2;-2
114932;202006;352590;P;8520100;0;1;-1
115011;202006;352590;G;4771701;2;0;2
115097;202006;352590;C;2543800;1;1;0
115360;202006;352590;M;7490104;0;1;-1
116466;202006;352590;H;4930202;0;1;-1
117048;202006;352590;G;4741500;1;1;0
117263;202006;352590;C;2029100;0;6;-6
117274;202006;352590;G;4635402;0;1;-1
117648;202006;352590;H;4930202;0;1;-1
118389;202006;352590;H;4930202;0;1;-1
118505;202006;352590;G;4789005;0;1;-1
118515;202006;352590;M;6920601;1;0;1
118775;202006;352590;R;9313100;0;2;-2
118948;202006;352590;Q;8650004;0;1;-1
118950;202006;352590;G;4754703;0;1;-1
119425;202006;352590;G;4617600;0;2;-2
119723;202006;352590;I;5611203;0;1;-1
120148;202006;352590;G;4722901;0;1;-1
120591;202006;352590;J;6201501;0;3;-3
121181;202006;352590;P;8520100;2;0;2
121568;202006;352590;C;2543800;0;1;-1
122176;202006;352590;C;1053800;4;0;4
122198;202006;352590;S;9499500;1;0;1
122462;202006;352590;H;4930202;1;1;0
122463;202006;352590;H;4930201;1;0;1
122567;202006;352590;N;8112500;0;1;-1
123159;202006;352590;G;4761003;0;1;-1
123253;202006;352590;G;4712100;1;0;1
123330;202006;352590;C;1099601;1;2;-1
123417;202006;352590;P;8512100;0;4;-4
123424;202006;352590;L;6810202;0;1;-1
123646;202006;352590;C;1042200;0;3;-3
124094;202006;352590;H;4930202;0;1;-1
124304;202006;352590;G;4789001;0;1;-1
124551;202006;352590;H;5212500;2;4;-2
126064;202006;352590;G;4721102;0;1;-1
126735;202006;352590;H;4930201;0;1;-1
127056;202006;352590;N;8130300;0;1;-1
127156;202006;352590;I;5611201;0;1;-1
127419;202006;352590;J;5813100;1;0;1
128634;202006;352590;G;4753900;2;1;1
128635;202006;352590;G;4753900;0;1;-1
128973;202006;352590;G;4744002;0;1;-1
129054;202006;352590;G;4789002;0;1;-1
129288;202006;352590;G;4639701;1;0;1
130122;202006;352590;G;4614100;1;2;-1
130144;202006;352590;G;4731800;0;1;-1
130803;202006;352590;G;4729699;0;1;-1
131029;202006;352590;C;2621300;58;0;58
131030;202006;352590;C;2632900;6;30;-24
131074;202006;352590;N;8299799;51;101;-50
131093;202006;352590;G;4742300;1;0;1
131270;202006;352590;I;5611201;0;1;-1
131551;202006;352590;P;8512100;0;2;-2
131939;202006;352590;Q;8630503;2;1;1
132227;202006;352590;C;2229303;6;0;6
132315;202006;352590;H;5212500;6;0;6
133464;202006;352590;G;4731800;0;1;-1
133844;202006;352590;N;7732201;4;1;3
134220;202006;352590;N;7733100;0;1;-1
134277;202006;352590;G;4773300;0;1;-1
134390;202006;352590;P;8513900;1;0;1
134468;202006;352590;C;3313999;2;0;2
134503;202006;352590;G;4781400;0;4;-4
134885;202006;352590;J;6201501;2;0;2
135404;202006;352590;H;4930202;2;0;2
135653;202006;352590;G;4731800;0;2;-2
136384;202006;352590;Q;8630501;0;1;-1
136780;202006;352590;F;4120400;2;0;2
136863;202006;352590;G;4712100;1;2;-1
137125;202006;352590;G;4530703;0;1;-1
137492;202006;352590;G;4744001;1;0;1
138037;202006;352590;P;8512100;0;1;-1
138266;202006;352590;N;8112500;0;2;-2
138463;202006;352590;F;4213800;1;1;0
138843;202006;352590;I;5611201;0;1;-1
138850;202006;352590;C;2840200;0;2;-2
139223;202006;352590;H;5212500;2;1;1
139280;202006;352590;G;4520001;0;1;-1
139288;202006;352590;N;8111700;1;4;-3
140106;202006;352590;N;7820500;2;2;0
140159;202006;352590;G;4511101;0;2;-2
140354;202006;352590;I;5611201;0;1;-1
140782;202006;352590;C;2093200;1;0;1
141773;202006;352590;G;4530703;0;1;-1
141830;202006;352590;G;4729699;0;1;-1
142661;202006;352590;S;9601701;0;2;-2
143190;202006;352590;F;4222701;4;4;0
143383;202006;352590;G;4789099;1;1;0
143540;202006;352590;G;4686902;4;7;-3
143696;202006;352590;N;8299799;0;1;-1
143916;202006;352590;G;4530703;1;0;1
144414;202006;352590;I;5611203;0;1;-1
144471;202006;352590;C;2222600;0;4;-4
145098;202006;352590;G;4511101;3;1;2
145438;202006;352590;G;4669901;0;1;-1
145523;202006;352590;G;4781400;0;1;-1
145752;202006;352590;G;4789099;0;2;-2
146378;202006;352590;N;8111700;0;1;-1
146713;202006;352590;G;4754701;8;3;5
146714;202006;352590;G;4754701;0;1;-1
147722;202006;352590;I;5611201;0;5;-5
148022;202006;352590;P;8541400;0;2;-2
148354;202006;352590;I;5611201;0;1;-1
148864;202006;352590;P;8511200;1;0;1
148865;202006;352590;P;8511200;2;0;2
149030;202006;352590;G;4731800;0;1;-1
149136;202006;352590;G;4530703;0;1;-1
149459;202006;352590;F;4330404;4;1;3
149461;202006;352590;N;7830200;12;15;-3
149787;202006;352590;M;6920601;0;1;-1
149790;202006;352590;C;3321000;0;1;-1
150023;202006;352590;S;9521500;8;3;5
150313;202006;352590;M;7112000;6;0;6
150314;202006;352590;J;6204000;0;2;-2
150665;202006;352590;P;8593700;0;1;-1
150668;202006;352590;J;6311900;0;1;-1
151629;202006;352590;G;4789002;0;1;-1
151954;202006;352590;F;4321500;1;0;1
152240;202006;352590;I;5611201;0;1;-1
153050;202006;352590;G;4713002;0;1;-1
153101;202006;352590;I;5611201;0;1;-1
153318;202006;352590;G;4511102;0;1;-1
153323;202006;352590;G;4511101;1;0;1
153972;202006;352590;Q;8610101;5;4;1
154337;202006;352590;N;8219999;1;0;1
154403;202006;352590;G;4724500;6;8;-2
154404;202006;352590;G;4633801;1;2;-1
154405;202006;352590;G;4724500;6;5;1
155438;202006;352590;C;2599302;0;1;-1
155523;202006;352590;C;2222600;0;1;-1
155797;202006;352590;C;2812700;1;1;0
155834;202006;352590;G;4784900;0;1;-1
155921;202006;352590;F;4120400;0;1;-1
156755;202006;352590;S;9602501;0;4;-4
156925;202006;352590;H;5250805;1;2;-1
156953;202006;352590;C;2621300;0;16;-16
157126;202006;352590;G;4772500;0;1;-1
157322;202006;352590;G;4691500;3;5;-2
157669;202006;352590;C;3291400;1;0;1
157764;202006;352590;J;6190601;2;0;2
157915;202006;352590;G;4721103;0;1;-1
158025;202006;352590;F;4330401;0;3;-3
158410;202006;352590;C;2511000;4;6;-2
158552;202006;352590;I;5611201;0;1;-1
159102;202006;352590;N;7732201;3;0;3
159585;202006;352590;P;8511200;0;2;-2
159586;202006;352590;M;6920601;1;1;0
159696;202006;352590;I;5611201;1;1;0
159958;202006;352590;N;8299799;2;2;0
160087;202006;352590;G;4520005;0;1;-1
160311;202006;352590;G;4781400;0;1;-1
160735;202006;352590;G;4771701;0;2;-2
160942;202006;352590;G;4712100;0;1;-1
161081;202006;352590;G;4633801;2;0;2
161887;202006;352590;G;4511101;1;2;-1
162419;202006;352590;F;4321500;0;1;-1
162594;202006;352590;Q;8711502;1;2;-1
162595;202006;352590;Q;8711502;1;0;1
162654;202006;352590;I;5611201;0;1;-1
163554;202006;352590;N;8211300;0;1;-1
164105;202006;352590;N;8220200;2;1;1
165522;202006;352590;I;5611201;0;1;-1
166048;202006;352590;N;7739099;1;0;1
166078;202006;352590;H;5250804;1;0;1
166472;202006;352590;G;4761003;0;1;-1
167193;202006;352590;G;4742300;0;1;-1
167468;202006;352590;M;7500100;0;1;-1
168909;202006;352590;G;4732600;1;0;1
169097;202006;352590;C;2222600;0;1;-1
170356;202006;352590;M;6920601;1;0;1
171333;202006;352590;G;4731800;1;1;0
172007;202006;352590;S;9609299;0;2;-2
172015;202006;352590;G;4712100;0;1;-1
172016;202006;352590;N;8299799;6;5;1
172314;202006;352590;G;4511101;1;1;0
173521;202006;352590;F;4321500;3;0;3
173646;202006;352590;M;6920601;1;2;-1
173818;202006;352590;H;4930202;1;1;0
174673;202006;352590;I;5611203;0;1;-1
175323;202006;352590;P;8511200;0;6;-6
175564;202006;352590;H;4930202;18;9;9
175713;202006;352590;F;4213800;0;1;-1
175777;202006;352590;C;1099699;0;1;-1
176012;202006;352590;K;6622300;0;1;-1
176762;202006;352590;C;1099699;1;3;-2
177508;202006;352590;P;8599604;0;2;-2
177538;202006;352590;G;4712100;3;0;3
177685;202006;352590;G;4520001;0;1;-1
178221;202006;352590;G;4623109;0;4;-4
178222;202006;352590;G;4623109;0;1;-1
178236;202006;352590;G;4781400;5;87;-82
178246;202006;352590;G;4511104;0;1;-1
178271;202006;352590;N;8130300;4;4;0
178272;202006;352590;G;4789099;5;0;5
178342;202006;352590;S;9602501;0;4;-4
179295;202006;352590;I;5611201;0;2;-2
179407;202006;352590;C;3250706;1;0;1
179729;202006;352590;G;4633801;0;1;-1
179896;202006;352590;M;6920601;0;1;-1
180289;202006;352590;P;8593700;1;0;1
180567;202006;352590;G;4744002;1;0;1
180754;202006;352590;I;5611203;0;1;-1
181077;202006;352590;G;4751201;1;0;1
181547;202006;352590;C;2599399;0;1;-1
181721;202006;352590;I;5611201;0;1;-1
181806;202006;352590;G;4789005;0;1;-1
181988;202006;352590;M;7500100;0;1;-1
182520;202006;352590;N;8292000;0;1;-1
183107;202006;352590;N;8211300;5;0;5
184301;202006;352590;G;4789002;0;1;-1
184711;202006;352590;N;8219999;0;1;-1
184758;202006;352590;G;4729601;0;2;-2
185124;202006;352590;Q;8711502;0;1;-1
185627;202006;352590;G;4772500;0;4;-4
185719;202006;352590;M;7410202;1;0;1
185995;202006;352590;G;4789002;0;1;-1
186252;202006;352590;N;8211300;0;1;-1
186355;202006;352590;C;2599399;0;1;-1
186397;202006;352590;C;1830003;0;1;-1
187045;202006;352590;G;4633801;0;1;-1
187159;202006;352590;C;1091101;1;0;1
187332;202006;352590;M;6920601;0;4;-4
187428;202006;352590;I;5611201;1;0;1
188317;202006;352590;R;9313100;0;1;-1
188410;202006;352590;P;8591100;0;1;-1
189042;202006;352590;H;4930202;0;4;-4
189215;202006;352590;C;3314799;0;2;-2
189379;202006;352590;I;5611201;0;5;-5
189382;202006;352590;H;4930202;0;1;-1
189494;202006;352590;H;4930202;1;0;1
189613;202006;352590;G;4744002;0;1;-1
190376;202006;352590;Q;8650004;0;1;-1
190751;202006;352590;G;4751201;0;1;-1
190822;202006;352590;G;4781400;0;1;-1
190902;202006;352590;F;4120400;0;1;-1
191021;202006;352590;C;2229302;0;1;-1
191133;202006;352590;H;5250805;1;0;1
191216;202006;352590;J;6311900;1;0;1
191258;202006;352590;C;2790299;1;0;1
191455;202006;352590;G;4722901;0;1;-1
191574;202006;352590;J;5811500;1;0;1
191625;202006;352590;M;6920601;1;1;0
191845;202006;352590;F;4322302;0;2;-2
192014;202006;352590;L;6821802;1;0;1
192041;202006;352590;G;4744001;0;1;-1
193056;202006;352590;C;1733800;1;0;1
193239;202006;352590;P;8520100;1;0;1
193450;202006;352590;S;9601701;1;0;1
193487;202006;352590;G;4530703;0;1;-1
194050;202006;352590;G;4689301;0;1;-1
194072;202006;352590;M;6920601;1;1;0
194377;202006;352590;N;8112500;0;1;-1
194432;202006;352590;F;4330404;0;1;-1
194783;202006;352590;G;4761001;0;2;-2
195172;202006;352590;Q;8650004;0;1;-1
195197;202006;352590;I;5611201;0;1;-1
195358;202006;352590;C;1066000;15;5;10
195687;202006;352590;G;4781400;0;1;-1
195735;202006;352590;H;4930202;0;6;-6
195754;202006;352590;S;9521500;2;0;2
196248;202006;352590;C;3250705;1;1;0
196698;202006;352590;M;7490199;0;2;-2
196724;202006;352590;P;8512100;0;5;-5
196728;202006;352590;E;3821100;20;13;7
196757;202006;352590;K;6462000;0;3;-3
196799;202006;352590;N;8111700;14;22;-8
197769;202006;352590;F;4120400;5;2;3
197819;202006;352590;H;5223100;0;1;-1
197820;202006;352590;H;5223100;2;1;1
198101;202006;352590;F;4399103;0;1;-1
198202;202006;352590;C;2229399;0;1;-1
198242;202006;352590;G;4783101;2;1;1
198292;202006;352590;G;4711302;1;0;1
198471;202006;352590;I;5611201;0;1;-1
198695;202006;352590;L;6822600;0;1;-1
198696;202006;352590;I;5611201;1;0;1
200242;202006;352590;J;6190601;0;1;-1
200244;202006;352590;N;8121400;3;0;3
200346;202006;352590;G;4744001;1;0;1
200356;202006;352590;G;4520002;0;1;-1
200687;202006;352590;G;4782201;0;1;-1
201050;202006;352590;G;4771701;1;0;1
201190;202006;352590;P;8512100;0;1;-1
201658;202006;352590;L;6821801;2;0;2
201688;202006;352590;C;3314704;1;0;1
202180;202006;352590;F;4120400;2;0;2
203376;202006;352590;G;4754701;2;0;2
203760;202006;352590;I;5611203;0;1;-1
204062;202006;352590;H;4930202;4;2;2
205595;202006;352590;G;4772500;0;1;-1
205597;202006;352590;G;4772500;0;1;-1
205855;202006;352590;S;9511800;0;1;-1
206140;202006;352590;Q;8711501;1;0;1
206804;202006;352590;N;8111700;0;1;-1
206904;202006;352590;G;4691500;8;9;-1
207102;202006;352590;G;4689399;1;0;1
207786;202006;352590;G;4637199;1;0;1
208051;202006;352590;I;5611203;0;1;-1
208054;202006;352590;I;5611203;0;1;-1
208258;202006;352590;I;5611203;4;0;4
208390;202006;352590;C;1091102;0;1;-1
208462;202006;352590;G;4781400;0;2;-2
208850;202006;352590;J;6399200;0;1;-1
209056;202006;352590;F;4330499;3;1;2
209057;202006;352590;F;4330499;0;1;-1
209058;202006;352590;F;4330499;0;1;-1
209163;202006;352590;C;1340599;0;1;-1
211192;202006;352590;N;8299706;1;1;0
211194;202006;352590;Q;8630502;2;3;-1
211695;202006;352590;P;8511200;0;1;-1
211696;202006;352590;P;8511200;0;1;-1
211821;202006;352590;H;4930201;0;2;-2
212171;202006;352590;F;4399101;3;2;1
212344;202006;352590;I;5510801;0;1;-1
212831;202006;352590;G;4520005;0;1;-1
212899;202006;352590;G;4774100;1;0;1
212912;202006;352590;G;4763601;2;4;-2
212927;202006;352590;F;4399103;1;1;0
213341;202006;352590;I;5611201;0;2;-2
213414;202006;352590;N;8211300;1;0;1
213493;202006;352590;I;5611203;0;3;-3
213929;202006;352590;G;4632003;0;1;-1
214011;202006;352590;G;4744001;0;1;-1
214324;202006;352590;P;8512100;0;5;-5
214750;202006;352590;G;4744005;0;1;-1
214863;202006;352590;G;4756300;0;1;-1
215492;202006;352590;J;6110803;1;0;1
216281;202006;352590;G;4530703;0;1;-1
216379;202006;352590;F;4330499;1;0;1
216820;202006;352590;M;7020400;0;1;-1
217238;202006;352590;G;4646001;0;1;-1
217368;202006;352590;N;8230001;2;1;1
217451;202006;352590;P;8512100;0;1;-1
217851;202006;352590;C;2731700;0;4;-4
218214;202006;352590;G;4789099;1;0;1
218269;202006;352590;I;5611201;1;0;1
218715;202006;352590;N;8112500;2;0;2
218735;202006;352590;H;5211701;14;22;-8
219445;202006;352590;G;4672900;1;1;0
219595;202006;352590;G;4530704;0;1;-1
219626;202006;352590;F;4120400;0;5;-5
219814;202006;352590;G;4789099;0;1;-1
220463;202006;352590;M;7119704;0;1;-1
220610;202006;352590;N;8111700;1;0;1
220765;202006;352590;C;3314702;7;0;7
220934;202006;352590;G;4754701;42;10;32
221099;202006;352590;F;4120400;0;1;-1
221340;202006;352590;C;1091102;0;1;-1
221463;202006;352590;G;4744099;0;1;-1
221464;202006;352590;N;8299799;1;0;1
221471;202006;352590;C;1091101;9;3;6
221474;202006;352590;C;2599399;15;5;10
221598;202006;352590;C;3314708;3;1;2
221746;202006;352590;H;5223100;0;1;-1
221802;202006;352590;C;1091100;1;0;1
222403;202006;352590;G;4789099;0;1;-1
222485;202006;352590;C;1413401;0;1;-1
223101;202006;352590;G;4759899;0;2;-2
223171;202006;352590;I;5611201;0;1;-1
223701;202006;352590;F;4313400;1;0;1
224830;202006;352590;P;8599604;0;1;-1
225109;202006;352590;G;4511102;0;1;-1
225309;202006;352590;F;4330402;0;2;-2
225531;202006;352590;F;4399103;0;3;-3
225717;202006;352590;G;4761001;2;3;-1
226086;202006;352590;M;6920601;1;1;0
226184;202006;352590;G;4789004;0;1;-1
226829;202006;352590;G;4763601;0;1;-1
228076;202006;352590;F;4120400;0;3;-3
228462;202006;352590;L;6810202;2;0;2
229159;202006;352590;G;4774100;0;1;-1
229214;202006;352590;S;9602501;0;2;-2
229378;202006;352590;N;7810800;1;0;1
229384;202006;352590;G;4721104;2;3;-1
229385;202006;352590;G;4637107;0;1;-1
229434;202006;352590;C;3101200;1;2;-1
230138;202006;352590;J;6190699;1;1;0
230166;202006;352590;I;5611201;0;2;-2
230300;202006;352590;P;8511200;1;0;1
230940;202006;352590;F;4120400;0;2;-2
231086;202006;352590;G;4744099;3;2;1
231267;202006;352590;G;4721104;0;1;-1
231355;202006;352590;G;4663000;1;1;0
231500;202006;352590;H;4930201;1;0;1
231602;202006;352590;G;4782201;0;2;-2
231607;202006;352590;C;2542000;0;2;-2
231737;202006;352590;I;5620104;0;1;-1
231868;202006;352590;I;5611201;0;1;-1
232882;202006;352590;G;4729699;0;2;-2
233439;202006;352590;F;4399104;0;1;-1
233551;202006;352590;C;2621300;0;1;-1
234184;202006;352590;H;4922102;0;1;-1
234455;202006;352590;F;4120400;0;1;-1
234754;202006;352590;C;2823200;0;2;-2
235347;202006;352590;S;9521500;3;1;2
235389;202006;352590;G;4712100;1;0;1
235951;202006;352590;N;8111700;1;2;-1
236483;202006;352590;N;7911200;0;5;-5
236631;202006;352590;M;6920601;0;1;-1
236956;202006;352590;I;5611201;0;1;-1
237013;202006;352590;G;4772500;0;1;-1
237111;202006;352590;H;4930202;17;5;12
237236;202006;352590;H;5211701;1;0;1
237687;202006;352590;G;4755502;0;1;-1
237891;202006;352590;H;4930201;1;0;1
237892;202006;352590;Q;8650004;0;1;-1
238027;202006;352590;K;6612604;3;0;3
238253;202006;352590;P;8511200;0;1;-1
238473;202006;352590;G;4712100;0;1;-1
238562;202006;352590;S;9602501;0;1;-1
238802;202006;352590;G;4752100;1;0;1
239060;202006;352590;N;8219999;2;0;2
239061;202006;352590;N;8219999;2;1;1
239360;202006;352590;G;4729699;0;1;-1
239943;202006;352590;N;8299799;0;1;-1
240146;202006;352590;S;9603301;0;1;-1
240406;202006;352590;K;6422100;0;1;-1
240643;202006;352590;L;6821802;0;1;-1
241407;202006;352590;H;5112901;0;5;-5
241672;202006;352590;I;5611201;0;1;-1
242252;202006;352590;G;4781400;0;1;-1
242948;202006;352590;G;4712100;0;1;-1
243573;202006;352590;M;7112000;1;0;1
245207;202006;352590;G;4520005;23;1;22
245459;202006;352590;G;4729699;1;0;1
245697;202006;352590;N;8219999;1;2;-1
246492;202006;352590;F;4120400;4;6;-2
247806;202006;352590;G;4541201;0;4;-4
247844;202006;352590;Q;8711502;0;1;-1
248198;202006;352590;M;7312200;0;1;-1
248399;202006;352590;G;4782201;0;1;-1
248589;202006;352590;F;4120400;0;1;-1
248811;202006;352590;N;8111700;0;1;-1
249811;202006;352590;G;4771702;3;2;1
249861;202006;352590;N;8299799;0;6;-6
250531;202006;352590;G;4789099;0;1;-1
250679;202006;352590;N;8211300;0;1;-1
251159;202006;352590;C;3321000;1;0;1
251265;202006;352590;Q;8630501;1;0;1
251710;202006;352590;G;4744001;0;1;-1
251839;202006;352590;G;4752100;0;1;-1
252112;202006;352590;F;4120400;1;0;1
252245;202006;352590;J;6209100;1;0;1
252293;202006;352590;H;4930201;0;3;-3
252303;202006;352590;H;4930202;2;0;2
252465;202006;352590;H;4930202;1;0;1
252696;202006;352590;M;7500100;0;1;-1
252909;202006;352590;G;4754701;0;1;-1
252955;202006;352590;G;4634601;3;1;2
253256;202006;352590;I;5611201;0;2;-2
253352;202006;352590;G;4789004;0;2;-2
253491;202006;352590;F;4399199;7;0;7
253492;202006;352590;F;4399199;1;0;1
253672;202006;352590;G;4781400;0;1;-1
254650;202006;352590;H;4930201;0;1;-1
254679;202006;352590;H;4923002;1;1;0
255302;202006;352590;F;4292802;0;1;-1
256076;202006;352590;G;4789001;0;2;-2
256324;202006;352590;M;6920601;1;0;1
256360;202006;352590;C;2823200;0;1;-1
256438;202006;352590;N;8011101;4;0;4
256955;202006;352590;N;8211300;0;1;-1
256995;202006;352590;K;6491300;0;1;-1
257122;202006;352590;L;6822600;4;1;3
257757;202006;352590;F;4399199;0;1;-1
258163;202006;352590;G;4663000;0;1;-1
258237;202006;352590;H;4930202;0;3;-3
258444;202006;352590;N;8111700;3;0;3
258718;202006;352590;N;7912100;0;4;-4
258832;202006;352590;N;7911200;0;6;-6
259473;202006;352590;G;4772500;0;1;-1
260604;202006;352590;S;9601701;0;2;-2
260664;202006;352590;F;4321500;2;0;2
260790;202006;352590;N;8219999;0;1;-1
261049;202006;352590;P;8599605;0;2;-2
261454;202006;352590;I;5611203;2;1;1
263756;202006;352590;G;4789004;0;1;-1
263830;202006;352590;G;4530703;0;1;-1
263912;202006;352590;H;4930202;0;2;-2
264366;202006;352590;G;4712100;0;1;-1
264475;202006;352590;G;4771701;0;1;-1
264981;202006;352590;C;3101200;0;1;-1
265019;202006;352590;F;4321500;0;1;-1
265143;202006;352590;I;5611201;0;1;-1
265164;202006;352590;G;4520001;0;1;-1
266089;202006;352590;N;8220200;117;45;72
266636;202006;352590;F;4399103;3;2;1
266737;202006;352590;M;6920601;1;0;1
267598;202006;352590;N;8230001;0;2;-2
267877;202006;352590;N;8230001;0;1;-1
267968;202006;352590;I;5611201;0;2;-2
268015;202006;352590;H;4930202;0;2;-2
268214;202006;352590;F;4313400;2;1;1
268257;202006;352590;S;9430800;1;0;1
268278;202006;352590;Q;8630503;0;1;-1
268423;202006;352590;G;4789001;1;1;0
268804;202006;352590;S;9602502;0;1;-1
270241;202006;352590;M;7119703;0;1;-1
271132;202006;352590;S;9602502;1;0;1
271263;202006;352590;G;4761001;1;2;-1
271669;202006;352590;G;4722901;2;0;2
272044;202006;352590;G;4722901;0;1;-1
272241;202006;352590;P;8593700;3;2;1
272499;202006;352590;N;8130300;3;6;-3
272580;202006;352590;G;4652400;2;0;2
272762;202006;352590;F;4120400;6;12;-6
273057;202006;352590;S;9602502;1;1;0
274029;202006;352590;F;4330405;8;2;6
274113;202006;352590;G;4774100;1;0;1
274238;202006;352590;F;4313400;1;0;1
274296;202006;352590;G;4530703;0;2;-2
274330;202006;352590;G;4530703;1;0;1
274619;202006;352590;G;4729699;0;1;-1
274877;202006;352590;G;4530705;1;1;0
274880;202006;352590;H;4930201;0;1;-1
274943;202006;352590;G;4721102;1;0;1
275018;202006;352590;G;4721102;0;3;-3
275547;202006;352590;G;4721102;1;0;1
275786;202006;352590;C;3321000;0;1;-1
276170;202006;352590;N;8299799;0;1;-1
277101;202006;352590;H;4930202;1;3;-2
277242;202006;352590;I;5611201;0;1;-1
277562;202006;352590;H;4930202;9;7;2
277677;202006;352590;Q;8712300;9;3;6
278120;202006;352590;I;5611203;0;1;-1
278250;202006;352590;H;5223100;0;2;-2
278350;202006;352590;C;2222600;7;0;7
279101;202006;352590;I;5611203;1;0;1
279222;202006;352590;R;9001906;0;1;-1
279352;202006;352590;Q;8630504;0;1;-1
279583;202006;352590;H;4930201;1;0;1
279645;202006;352590;P;8550302;0;2;-2
280596;202006;352590;N;8111700;13;3;10
280807;202006;352590;N;8211300;0;1;-1
281977;202006;352590;P;8512100;0;1;-1
282358;202006;352590;G;4781400;0;1;-1
282433;202006;352590;G;4752100;1;0;1
282440;202006;352590;S;9601701;0;1;-1
283010;202006;352590;I;5611203;0;2;-2
283380;202006;352590;G;4731800;1;0;1
283405;202006;352590;I;5611201;0;1;-1
284062;202006;352590;C;2949299;0;1;-1
285329;202006;352590;N;8111700;1;1;0
285347;202006;352590;J;6204000;0;1;-1
285543;202006;352590;G;4669999;6;1;5
285754;202006;352590;G;4712100;1;1;0
287004;202006;352590;N;8220200;2;0;2
287874;202006;352590;G;4712100;0;1;-1
288212;202006;352590;N;8211300;1;1;0
288886;202006;352590;G;4789099;0;1;-1
289030;202006;352590;G;4530703;0;1;-1
289141;202006;352590;G;4721102;0;1;-1
289436;202006;352590;H;4930202;0;4;-4
290277;202006;352590;S;9512600;0;1;-1
290613;202006;352590;I;5620101;0;1;-1
290670;202006;352590;N;8130300;1;0;1
292479;202006;352590;N;8299799;0;2;-2
293063;202006;352590;Q;8630504;1;1;0
293370;202006;352590;G;4754701;1;0;1
293428;202006;352590;G;4645101;18;2;16
294617;202006;352590;N;8211300;0;1;-1
296307;202006;352590;M;7112000;1;0;1
296478;202006;352590;M;7112000;6;3;3
296762;202006;352590;H;5212500;14;2;12
296926;202006;352590;C;1412601;10;1;9
297170;202006;352590;P;8599603;2;0;2
297791;202006;352590;G;4744001;0;3;-3
298013;202006;352590;F;4330403;1;1;0
298392;202006;352590;F;4120400;2;0;2
298897;202006;352590;Q;8630504;2;1;1
298916;202006;352590;G;4520001;1;1;0
299181;202006;352590;G;4731800;0;4;-4
299335;202006;352590;R;9313100;0;4;-4
299665;202006;352590;P;8599604;0;1;-1
300091;202006;352590;G;4729699;21;1;20
300594;202006;352590;M;7319002;0;2;-2
300636;202006;352590;I;5611201;2;0;2
300911;202006;352590;Q;8630502;0;1;-1
301383;202006;352590;H;4930202;1;0;1
302536;202006;352590;N;8112500;0;3;-3
302571;202006;352590;F;4330402;0;3;-3
302645;202006;352590;I;5620101;8;4;4
302647;202006;352590;I;5620101;3;0;3
302648;202006;352590;I;5620101;3;4;-1
302649;202006;352590;I;5620101;0;1;-1
302890;202006;352590;G;4742300;6;2;4
303473;202006;352590;C;3314708;1;0;1
303617;202006;352590;G;4729699;0;1;-1
303991;202006;352590;S;9493600;0;2;-2
304301;202006;352590;G;4646001;0;3;-3
304458;202006;352590;H;5211701;3;2;1
304491;202006;352590;M;7112000;1;0;1
305530;202006;352590;N;8220200;280;56;224
305569;202006;352590;F;4330401;0;1;-1
305718;202006;352590;N;8299799;1;0;1
305746;202006;352590;G;4781400;0;1;-1
305892;202006;352590;J;6209100;1;1;0
306028;202006;352590;G;4520001;0;1;-1
306708;202006;352590;G;4774100;0;1;-1
307269;202006;352590;G;4772500;2;0;2
307499;202006;352590;G;4633801;2;0;2
308132;202006;352590;C;2542000;0;1;-1
308312;202006;352590;L;6822600;0;1;-1
308359;202006;352590;F;4221904;14;8;6
308670;202006;352590;C;2330305;1;0;1
310005;202006;352590;G;4721102;1;0;1
310007;202006;352590;N;8299799;6;9;-3
310050;202006;352590;C;3321000;2;0;2
310064;202006;352590;N;8111700;7;7;0
310279;202006;352590;G;4633801;0;1;-1
310344;202006;352590;H;4930202;4;2;2
310528;202006;352590;G;4530703;1;1;0
310673;202006;352590;Q;8711502;1;1;0
311544;202006;352590;C;2391503;1;0;1
311807;202006;352590;P;8599604;1;6;-5
311907;202006;352590;G;4789099;0;1;-1
312605;202006;352590;G;4639701;5;4;1
312728;202006;352590;G;4520007;1;1;0
312945;202006;352590;N;8111700;1;7;-6
313215;202006;352590;G;4722901;1;0;1
313229;202006;352590;F;4330499;1;4;-3
313467;202006;352590;C;1095300;38;7;31
314287;202006;352590;G;4753900;33;5;28
314315;202006;352590;G;4530704;0;2;-2
314440;202006;352590;C;3321000;0;1;-1
314571;202006;352590;N;8291100;3;0;3
314668;202006;352590;H;5250804;0;1;-1
315470;202006;352590;G;4759899;1;0;1
315941;202006;352590;N;8219999;1;0;1
316330;202006;352590;C;2943300;4;2;2
316549;202006;352590;J;6209100;2;2;0
317119;202006;352590;G;4761003;1;0;1
317120;202006;352590;G;4761003;0;1;-1
317285;202006;352590;G;4731800;0;1;-1
317462;202006;352590;Q;8630503;0;2;-2
317541;202006;352590;Q;8650004;0;1;-1
317596;202006;352590;I;5611203;0;1;-1
317599;202006;352590;I;5611203;0;4;-4
317600;202006;352590;I;5611203;0;5;-5
317602;202006;352590;I;5611203;0;6;-6
317780;202006;352590;M;7112000;0;3;-3
318747;202006;352590;G;4723700;1;0;1
318957;202006;352590;H;4930202;2;0;2
319037;202006;352590;J;6204000;0;3;-3
319400;202006;352590;L;6821801;1;0;1
320397;202006;352590;Q;8711502;0;1;-1
320488;202006;352590;G;4530703;0;1;-1
320680;202006;352590;G;4744099;0;1;-1
321514;202006;352590;G;4781400;0;1;-1
322665;202006;352590;H;5250801;1;0;1
322666;202006;352590;H;5250801;0;1;-1
322726;202006;352590;H;4930202;1;0;1
323427;202006;352590;F;4330404;3;2;1
323430;202006;352590;S;9602502;0;1;-1
323962;202006;352590;C;2229302;0;1;-1
324006;202006;352590;P;8599603;0;2;-2
324085;202006;352590;G;4633801;1;0;1
324229;202006;352590;G;4781400;1;0;1
324793;202006;352590;C;1412601;0;1;-1
324862;202006;352590;G;4614100;0;1;-1
325841;202006;352590;G;4772500;0;3;-3
326268;202006;352590;H;5212500;15;9;6
326305;202006;352590;I;5611201;0;1;-1
326806;202006;352590;N;8112500;0;1;-1
326998;202006;352590;C;2542000;4;3;1
327320;202006;352590;G;4781400;0;1;-1
328247;202006;352590;G;4771701;0;3;-3
328266;202006;352590;G;4773300;0;1;-1
328845;202006;352590;C;1069400;5;3;2
329101;202006;352590;F;4211102;0;2;-2
329634;202006;352590;H;5223100;1;0;1
330035;202006;352590;G;4761001;0;1;-1
330091;202006;352590;G;4744005;1;0;1
330104;202006;352590;Q;8630503;0;5;-5
330565;202006;352590;M;7020400;1;1;0
330715;202006;352590;S;9603301;0;1;-1
330753;202006;352590;H;5250804;10;4;6
331137;202006;352590;S;9529199;0;1;-1
331460;202006;352590;I;5611201;0;2;-2
332509;202006;352590;P;8511200;1;1;0
332545;202006;352590;M;7319002;1;0;1
333231;202006;352590;I;5611203;0;2;-2
333291;202006;352590;G;4520006;3;1;2
333616;202006;352590;G;4721102;1;1;0
334509;202006;352590;P;8599605;0;1;-1
334592;202006;352590;M;7319003;8;2;6
335223;202006;352590;H;4930201;0;1;-1
335341;202006;352590;C;3314713;1;1;0
335523;202006;352590;A;121101;0;1;-1
336160;202006;352590;G;4771701;1;0;1
336221;202006;352590;M;6920601;1;1;0
336679;202006;352590;F;4330403;11;1;10
336681;202006;352590;F;4292801;1;0;1
336923;202006;352590;H;4930202;1;0;1
337210;202006;352590;G;4729699;1;0;1
337438;202006;352590;Q;8630503;1;0;1
337774;202006;352590;I;5611201;0;1;-1
338947;202006;352590;H;4930202;10;3;7
339092;202006;352590;K;6462000;0;1;-1
339408;202006;352590;G;4789004;0;2;-2
340005;202006;352590;Q;8630504;0;1;-1
340172;202006;352590;G;4782201;1;0;1
340229;202006;352590;G;4781400;0;1;-1
340490;202006;352590;M;7112000;0;2;-2
341066;202006;352590;M;6911701;0;1;-1
341124;202006;352590;G;4755501;2;0;2
341667;202006;352590;G;4722901;1;0;1
341731;202006;352590;P;8593700;0;1;-1
342113;202006;352590;G;4687702;0;2;-2
342178;202006;352590;G;4713001;1;1;0
342431;202006;352590;I;5611201;0;1;-1
343249;202006;352590;F;4110700;0;1;-1
343371;202006;352590;Q;8640202;2;0;2
343382;202006;352590;G;4711302;1;2;-1
343652;202006;352590;N;7820500;0;3;-3
343698;202006;352590;F;4399101;0;1;-1
344102;202006;352590;I;5611201;1;0;1
344492;202006;352590;P;8599604;0;2;-2
344627;202006;352590;I;5611203;0;1;-1
345109;202006;352590;G;4771701;1;0;1
345629;202006;352590;G;4789099;0;1;-1
346254;202006;352590;G;4639701;1;0;1
346300;202006;352590;I;5611201;0;1;-1
346821;202006;352590;H;4930202;1;5;-4
347105;202006;352590;I;5611203;0;1;-1
347180;202006;352590;C;1091102;0;1;-1
347405;202006;352590;M;7112000;4;1;3
347928;202006;352590;N;8121400;1;0;1
348260;202006;352590;H;4930203;0;1;-1
348428;202006;352590;S;9602502;0;1;-1
349238;202006;352590;G;4757100;0;1;-1
349407;202006;352590;Q;8640202;0;1;-1
349457;202006;352590;Q;8630504;0;1;-1
350870;202006;352590;G;4789099;3;0;3
351056;202006;352590;G;4741500;0;1;-1
351115;202006;352590;I;5620104;0;1;-1
351127;202006;352590;N;8111700;6;3;3
351404;202006;352590;J;6110803;1;0;1
352144;202006;352590;F;4120400;1;4;-3
352578;202006;352590;N;8129000;1;0;1
353041;202006;352590;P;8512100;0;2;-2
353149;202006;352590;H;4930202;0;1;-1
353178;202006;352590;H;5212500;18;4;14
353413;202006;352590;C;1053800;7;3;4
353606;202006;352590;I;5611201;1;1;0
354271;202006;352590;I;5611203;0;1;-1
354322;202006;352590;F;4391600;10;0;10
354323;202006;352590;G;4721102;0;1;-1
354809;202006;352590;G;4753900;0;1;-1
355007;202006;352590;M;7112000;2;1;1
355037;202006;352590;I;5611203;1;0;1
355249;202006;352590;R;9329899;0;1;-1
355447;202006;352590;G;4712100;2;2;0
355676;202006;352590;G;4789099;1;1;0
356790;202006;352590;G;4772500;3;0;3
357325;202006;352590;G;4721104;0;2;-2
357326;202006;352590;G;4729699;0;1;-1
357418;202006;352590;M;7490104;1;0;1
357891;202006;352590;M;7112000;1;0;1
358057;202006;352590;G;4781400;1;0;1
358058;202006;352590;G;4781400;0;3;-3
358345;202006;352590;F;4399199;0;1;-1
358624;202006;352590;I;5611203;0;1;-1
358845;202006;352590;J;6209100;0;1;-1
359410;202006;352590;H;5112901;1;0;1
359517;202006;352590;N;8299799;0;2;-2
359529;202006;352590;G;4744001;1;0;1
360187;202006;352590;H;5211799;0;2;-2
360509;202006;352590;N;8291100;6;0;6
361094;202006;352590;F;4120400;0;1;-1
361220;202006;352590;C;2521700;0;1;-1
361296;202006;352590;I;5611201;0;1;-1
361298;202006;352590;M;7112000;1;1;0
361512;202006;352590;P;8512100;0;2;-2
362072;202006;352590;J;6204000;0;1;-1
362088;202006;352590;G;4744099;0;1;-1
362095;202006;352590;G;4511101;1;1;0
362904;202006;352590;N;8299799;1;2;-1
363380;202006;352590;F;4321500;5;1;4
363419;202006;352590;I;5611203;1;0;1
363552;202006;352590;G;4723700;1;1;0
363605;202006;352590;G;4784900;2;0;2
363883;202006;352590;J;6110803;1;0;1
364205;202006;352590;Q;8630502;3;0;3
364206;202006;352590;Q;8630502;0;2;-2
364764;202006;352590;N;8211300;0;1;-1
365013;202006;352590;S;9601703;5;2;3
365039;202006;352590;S;9602501;0;1;-1
365130;202006;352590;G;4520002;1;0;1
365540;202006;352590;I;5611203;0;2;-2
366440;202006;352590;N;8111700;0;1;-1
366523;202006;352590;N;8211300;1;0;1
367238;202006;352590;G;4781400;0;1;-1
367594;202006;352590;H;4930202;1;0;1
367879;202006;352590;G;4781400;0;1;-1
368267;202006;352590;P;8512100;0;1;-1
368402;202006;352590;I;5611201;0;1;-1
368491;202006;352590;M;7112000;1;0;1
369767;202006;352590;F;4299599;4;0;4
369933;202006;352590;G;4711301;5;8;-3
370192;202006;352590;F;4321500;1;0;1
371832;202006;352590;S;9529199;1;1;0
372165;202006;352590;G;4711302;2;0;2
372555;202006;352590;N;7911200;0;2;-2
372643;202006;352590;M;7120100;0;1;-1
373001;202006;352590;Q;8640299;1;0;1
373702;202006;352590;G;4789099;0;1;-1
373721;202006;352590;C;1099699;0;1;-1
373892;202006;352590;G;4781400;1;0;1
374302;202006;352590;G;4781400;0;2;-2
374472;202006;352590;I;5611201;1;0;1
374643;202006;352590;P;8513900;1;1;0
374862;202006;352590;G;4729699;1;0;1
375275;202006;352590;H;5320202;4;1;3
375600;202006;352590;K;6622300;5;0;5
375690;202006;352590;F;4321500;0;3;-3
375697;202006;352590;N;7740300;0;1;-1
376035;202006;352590;P;8593700;0;1;-1
376387;202006;352590;M;7490104;0;1;-1
376958;202006;352590;G;4781400;0;1;-1
377426;202006;352590;P;8599604;1;1;0
378808;202006;352590;N;7739099;3;1;2
378953;202006;352590;G;4713002;0;1;-1
379053;202006;352590;G;4637199;1;0;1
380059;202006;352590;S;9602502;1;0;1
380606;202006;352590;S;9602501;0;1;-1
380947;202006;352590;M;7119701;0;2;-2
381253;202006;352590;Q;8630503;0;1;-1
381389;202006;352590;S;9609208;1;0;1
381745;202006;352590;G;4729699;0;1;-1
382258;202006;352590;N;7732201;3;0;3
382875;202006;352590;C;2222600;0;1;-1
382916;202006;352590;M;7319002;2;0;2
383466;202006;352590;G;4774100;1;0;1
383748;202006;352590;G;4722902;0;1;-1
383934;202006;352590;H;5223100;3;1;2
384416;202006;352590;P;8593700;0;3;-3
384552;202006;352590;I;5620104;1;0;1
384760;202006;352590;K;6619302;2;0;2
385087;202006;352590;M;7490104;0;7;-7
385583;202006;352590;M;7112000;1;0;1
385981;202006;352590;G;4713002;1;0;1
386195;202006;352590;G;4789002;1;1;0
386455;202006;352590;N;8211300;0;1;-1
387478;202006;352590;G;4742300;2;0;2
387896;202006;352590;F;4313400;1;0;1
387897;202006;352590;F;4313400;0;1;-1
387940;202006;352590;M;7319002;0;1;-1
388020;202006;352590;I;5611203;1;0;1
389208;202006;352590;G;4742300;2;1;1
389470;202006;352590;G;4711302;1;0;1
389921;202006;352590;H;5320202;1;1;0
390337;202006;352590;R;9313100;0;1;-1
391491;202006;352590;P;8520100;0;4;-4
391622;202006;352590;G;4530703;1;0;1
391791;202006;352590;G;4752100;2;1;1
391883;202006;352590;H;4930202;4;0;4
392084;202006;352590;G;4789099;1;0;1
393980;202006;352590;H;4930202;31;0;31
394424;202006;352590;N;8111700;12;0;12
394700;202006;352590;A;163600;0;1;-1
394730;202006;352590;H;4930202;0;2;-2
395041;202006;352590;N;8219999;5;1;4
395902;202006;352590;H;4930201;2;0;2
396037;202006;352590;M;7119701;1;0;1
396054;202006;352590;G;4520006;1;1;0
396512;202006;352590;N;8211300;2;0;2
396980;202006;352590;N;8230001;0;21;-21
397328;202006;352590;N;8211300;0;1;-1
397382;202006;352590;I;5611201;0;1;-1
397705;202006;352590;G;4753900;0;1;-1
397788;202006;352590;G;4753900;18;19;-1
397789;202006;352590;G;4753900;0;2;-2
397790;202006;352590;G;4753900;0;3;-3
397953;202006;352590;G;4753900;0;9;-9
399508;202006;352590;H;4930202;24;10;14
399834;202006;352590;G;4781400;0;1;-1
399877;202006;352590;G;4781400;0;3;-3
400071;202006;352590;H;4930202;8;0;8
400304;202006;352590;A;210107;1;0;1
400356;202006;352590;L;6810201;1;0;1
401636;202006;352590;G;4530703;1;0;1
401766;202006;352590;F;4330404;1;0;1
401832;202006;352590;G;4684299;0;1;-1
404572;202006;352590;I;5611203;0;2;-2
404936;202006;352590;R;9313100;0;1;-1
405720;202006;352590;S;9602502;0;3;-3
406921;202006;352590;P;8512100;2;0;2
407541;202006;352590;G;4724500;1;0;1
407621;202006;352590;Q;8630504;2;0;2
408334;202006;352590;G;4744001;0;1;-1
409093;202006;352590;M;7112000;2;0;2
409913;202006;352590;I;5611201;0;1;-1
410962;202006;352590;N;8020001;2;1;1
411454;202006;352590;Q;8640202;3;0;3
411538;202006;352590;I;5611203;1;1;0
411769;202006;352590;S;9602502;0;1;-1
411833;202006;352590;G;4759899;0;1;-1
412146;202006;352590;G;4785799;1;0;1
413174;202006;352590;G;4759899;0;1;-1
413822;202006;352590;M;7020400;0;2;-2
414416;202006;352590;F;4120400;1;0;1
414879;202006;352590;I;5620103;1;0;1
415097;202006;352590;G;4669999;5;1;4
415099;202006;352590;G;4669999;0;1;-1
416110;202006;352590;H;4930202;1;0;1
416167;202006;352590;F;4321500;4;0;4
416169;202006;352590;Q;8650003;1;0;1
416794;202006;352590;C;2599302;6;0;6
418274;202006;352590;G;4511101;1;0;1
418865;202006;352590;C;1091102;4;0;4
418884;202006;352590;I;5620101;1;3;-2
419341;202006;352590;G;4771701;2;1;1
419354;202006;352590;N;8230001;0;44;-44
420067;202006;352590;C;3092000;1;0;1
420340;202006;352590;G;4721102;2;0;2
420853;202006;352590;I;5611201;1;1;0
421208;202006;352590;I;5620104;1;0;1
422189;202006;352590;N;8211300;6;2;4
422252;202006;352590;R;9319199;3;1;2
422675;202006;352590;N;7810800;0;2;-2
423457;202006;352590;G;4744099;3;0;3
424103;202006;352590;I;5611201;2;1;1
425381;202006;352590;Q;8630504;1;0;1
425714;202006;352590;H;4930201;2;0;2
425908;202006;352590;N;7739002;0;3;-3
426242;202006;352590;G;4789002;1;0;1
426593;202006;352590;G;4712100;3;0;3
427119;202006;352590;N;8292000;4;0;4
427305;202006;352590;C;1091102;1;0;1
428720;202006;352590;I;5611203;2;0;2
428888;202006;352590;G;4723700;4;1;3
431381;202006;352590;Q;8650003;1;0;1
431547;202006;352590;M;7319002;12;0;12
431548;202006;352590;M;7319002;0;1;-1
431852;202006;352590;G;4771701;1;0;1
433191;202006;352590;C;1091102;1;0;1
433448;202006;352590;I;5611201;2;0;2
434521;202006;352590;G;4781400;0;3;-3
435840;202006;352590;J;6141800;0;2;-2
436561;202006;352590;H;4930202;0;1;-1
438103;202006;352590;C;1062700;0;7;-7
438104;202006;352590;C;1062700;0;3;-3
438607;202006;352590;C;1813099;4;2;2
438780;202006;352590;H;5222200;0;4;-4
438937;202006;352590;G;4774100;1;0;1
439002;202006;352590;C;2091600;0;4;-4
439440;202006;352590;G;4753900;0;2;-2
439446;202006;352590;G;4753900;0;1;-1
439488;202006;352590;H;4930202;0;1;-1
439491;202006;352590;F;4120400;3;3;0
439617;202006;352590;C;2019399;0;2;-2
439667;202006;352590;C;2599399;3;1;2
439801;202006;352590;C;2710402;1;11;-10
440375;202006;352590;G;4744005;1;0;1
440376;202006;352590;S;9430800;0;13;-13
440378;202006;352590;S;9430800;1;0;1
440380;202006;352590;K;6550200;10;10;0
440392;202006;352590;K;6550200;0;1;-1
440434;202006;352590;K;6550200;2;0;2
440447;202006;352590;F;4399105;3;4;-1
440448;202006;352590;S;9430800;1;0;1
440449;202006;352590;C;1013901;1;0;1
440450;202006;352590;G;4530703;1;1;0
440451;202006;352590;G;4789099;0;1;-1
440452;202006;352590;S;9420100;0;2;-2
440480;202006;352590;S;9412099;0;1;-1
440573;202006;352590;C;2013402;5;4;1
441114;202006;352590;G;4781400;0;6;-6
441252;202006;352590;G;4781400;0;1;-1
441607;202006;352590;G;4782201;0;18;-18
441608;202006;352590;G;4782201;0;5;-5
441609;202006;352590;G;4782201;0;5;-5
441610;202006;352590;G;4782201;0;3;-3
441611;202006;352590;G;4782201;0;5;-5
441613;202006;352590;G;4782201;0;6;-6
441614;202006;352590;G;4782201;0;21;-21
441615;202006;352590;G;4782201;0;3;-3
441684;202006;352590;G;4711301;24;7;17
441862;202006;352590;G;4771701;1;0;1
441989;202006;352590;G;4744005;0;1;-1
442064;202006;352590;C;2821601;0;4;-4
442076;202006;352590;G;4672900;0;1;-1
442079;202006;352590;O;8411600;9;2;7
442480;202006;352590;N;8299706;1;1;0
442571;202006;352590;C;3250705;1;1;0
442701;202006;352590;C;3101200;0;1;-1
442703;202006;352590;C;2063100;6;1;5
442715;202006;352590;C;2651500;0;1;-1
442773;202006;352590;G;4781400;0;2;-2
442836;202006;352590;G;4646001;1;0;1
443061;202006;352590;I;5510801;1;0;1
443075;202006;352590;G;4744002;2;0;2
443098;202006;352590;J;6010100;0;2;-2
443099;202006;352590;H;4930202;0;1;-1
443100;202006;352590;G;4639701;1;0;1
443120;202006;352590;F;4313400;1;5;-4
443121;202006;352590;G;4731800;0;1;-1
443283;202006;352590;C;2342702;1;1;0
443308;202006;352590;M;6920601;1;1;0
443901;202006;352590;G;4711302;3;14;-11
444401;202006;352590;G;4711302;0;3;-3
444569;202006;352590;I;5510801;2;0;2
444715;202006;352590;Q;8640202;3;0;3
444717;202006;352590;Q;8690999;0;1;-1
444726;202006;352590;Q;8640299;0;1;-1
444730;202006;352590;Q;8690999;0;1;-1
444732;202006;352590;Q;8640202;0;1;-1
444939;202006;352590;G;4721102;0;1;-1
444940;202006;352590;G;4637107;0;1;-1
445134;202006;352590;G;4713001;0;1;-1
445729;202006;352590;H;4921301;0;55;-55
445896;202006;352590;G;4731800;0;4;-4
446413;202006;352590;C;1412602;0;1;-1
446414;202006;352590;S;9430800;0;1;-1
446449;202006;352590;C;2229399;2;1;1
446595;202006;352590;G;4784900;0;1;-1
446597;202006;352590;G;4731800;0;1;-1
447174;202006;352590;I;5620101;0;1;-1
447321;202006;352590;G;4772500;3;0;3
447330;202006;352590;G;4744005;0;1;-1
447335;202006;352590;P;8599601;1;2;-1
447337;202006;352590;M;6920601;1;4;-3
447338;202006;352590;G;4530703;3;1;2
447411;202006;352590;G;4755503;0;1;-1
447460;202006;352590;G;4761003;0;1;-1
447665;202006;352590;C;1330800;9;9;0
447670;202006;352590;F;4313400;0;2;-2
447828;202006;352590;I;5510801;0;1;-1
447943;202006;352590;K;6550200;3;2;1
447944;202006;352590;K;6550200;6;7;-1
448091;202006;352590;F;4120400;0;1;-1
448115;202006;352590;H;4921301;0;43;-43
448118;202006;352590;C;1122401;0;1;-1
448119;202006;352590;G;4711302;1;0;1
448120;202006;352590;C;1112700;3;0;3
448122;202006;352590;G;4783101;0;1;-1
448123;202006;352590;C;1112700;3;0;3
448125;202006;352590;G;4731800;0;1;-1
448128;202006;352590;P;8513900;0;18;-18
448130;202006;352590;G;4511101;0;2;-2
448131;202006;352590;C;2229302;0;6;-6
448134;202006;352590;R;9312300;0;1;-1
448135;202006;352590;R;9312300;0;1;-1
448139;202006;352590;C;1033301;0;1;-1
448140;202006;352590;C;2219600;2;9;-7
448142;202006;352590;G;4689399;5;0;5
448144;202006;352590;C;1099601;1;2;-1
448145;202006;352590;C;1629301;1;2;-1
448149;202006;352590;K;6622300;0;1;-1
448152;202006;352590;G;4530703;0;1;-1
448154;202006;352590;H;4929902;12;0;12
448155;202006;352590;Q;8610101;97;29;68
448156;202006;352590;G;4744005;1;0;1
448157;202006;352590;G;4541203;1;0;1
448161;202006;352590;G;4721102;0;1;-1
448163;202006;352590;R;9312300;1;0;1
448164;202006;352590;G;4711302;0;2;-2
448168;202006;352590;G;4711302;0;2;-2
448170;202006;352590;G;4711302;0;1;-1
448172;202006;352590;G;4711302;4;8;-4
448173;202006;352590;G;4711302;18;13;5
448174;202006;352590;G;4711302;2;6;-4
448176;202006;352590;G;4711302;11;17;-6
448177;202006;352590;G;4639701;0;6;-6
448179;202006;352590;G;4711302;2;8;-6
448181;202006;352590;G;4711302;2;4;-2
448183;202006;352590;G;4711302;2;4;-2
448184;202006;352590;G;4711302;4;8;-4
448185;202006;352590;G;4711302;10;19;-9
448186;202006;352590;H;4921301;0;38;-38
448187;202006;352590;C;1311100;0;3;-3
448188;202006;352590;C;1311100;29;12;17
448189;202006;352590;C;2229301;123;14;109
448190;202006;352590;C;2229301;0;4;-4
448191;202006;352590;C;2229301;0;2;-2
448194;202006;352590;P;8513900;1;0;1
448199;202006;352590;G;4721102;1;2;-1
448200;202006;352590;G;4511101;0;3;-3
448201;202006;352590;R;9329899;0;1;-1
448208;202006;352590;S;9430800;3;1;2
448209;202006;352590;M;7112000;0;1;-1
448213;202006;352590;Q;8610101;4;1;3
448215;202006;352590;P;8511200;1;0;1
448216;202006;352590;Q;8610101;15;12;3
448217;202006;352590;C;2342702;0;1;-1
448219;202006;352590;C;2342702;1;0;1
448221;202006;352590;Q;8800600;0;1;-1
448222;202006;352590;G;4721102;0;1;-1
448228;202006;352590;Q;8711502;1;0;1
448236;202006;352590;G;4731800;0;1;-1
448237;202006;352590;G;4711302;4;4;0
448238;202006;352590;G;4711302;5;5;0
448239;202006;352590;G;4711302;3;1;2
448240;202006;352590;G;4711302;3;3;0
448242;202006;352590;G;4711302;4;1;3
448244;202006;352590;S;9420100;0;1;-1
448247;202006;352590;P;8511200;0;1;-1
448248;202006;352590;S;9491000;0;1;-1
448252;202006;352590;G;4633801;3;3;0
448255;202006;352590;H;4929902;1;1;0
448262;202006;352590;S;9491000;0;1;-1
448512;202006;352590;C;2071100;0;2;-2
448739;202006;352590;C;1013901;6;7;-1
449096;202006;352590;Q;8640202;1;1;0
449097;202006;352590;Q;8640202;0;1;-1
449099;202006;352590;Q;8640202;1;0;1
449101;202006;352590;Q;8650004;0;2;-2
449103;202006;352590;S;9601701;0;1;-1
449104;202006;352590;Q;8640202;1;0;1
449105;202006;352590;Q;8640202;2;2;0
449107;202006;352590;Q;8640202;1;0;1
449108;202006;352590;H;4930202;0;1;-1
449134;202006;352590;S;9430800;1;2;-1
449135;202006;352590;Q;8610101;5;3;2
449159;202006;352590;S;9499500;0;2;-2
449165;202006;352590;G;4647801;0;1;-1
449166;202006;352590;P;8511200;0;4;-4
449360;202006;352590;C;3250707;1;2;-1
449450;202006;352590;G;4661300;3;2;1
449567;202006;352590;N;8112500;0;1;-1
449568;202006;352590;P;8512100;0;1;-1
449570;202006;352590;S;9430800;0;1;-1
449580;202006;352590;Q;8630502;0;3;-3
449581;202006;352590;N;8112500;0;1;-1
449627;202006;352590;G;4639701;1;0;1
449629;202006;352590;G;4771702;1;0;1
449638;202006;352590;G;4744099;0;1;-1
449642;202006;352590;G;4789008;0;1;-1
449655;202006;352590;H;4930202;0;4;-4
449804;202006;352590;H;4930202;1;1;0
449850;202006;352590;G;4771702;2;2;0
449932;202006;352590;G;4755502;1;0;1
450004;202006;352590;G;4530703;1;2;-1
450017;202006;352590;G;4530701;0;1;-1
450132;202006;352590;G;4721102;0;2;-2
450153;202006;352590;C;1031700;2;1;1
450185;202006;352590;C;2512800;0;1;-1
450211;202006;352590;C;2592601;0;4;-4
450414;202006;352590;G;4789004;0;1;-1
450576;202006;352590;G;4669999;1;1;0
450981;202006;352590;G;4771703;0;1;-1
451376;202006;352590;G;4781400;0;1;-1
451414;202006;352590;G;4781400;0;1;-1
451537;202006;352590;I;5611203;0;1;-1
451619;202006;352590;Q;8640203;1;0;1
451664;202006;352590;N;8112500;0;1;-1
451666;202006;352590;M;7112000;0;1;-1
451667;202006;352590;P;8513900;0;13;-13
451734;202006;352590;G;4520001;2;0;2
451887;202006;352590;C;3101200;2;3;-1
452105;202006;352590;C;3101200;0;1;-1
452412;202006;352590;G;4744005;0;1;-1
452461;202006;352590;N;8112500;0;1;-1
452462;202006;352590;N;8112500;1;0;1
452512;202006;352590;G;4511101;3;6;-3
452517;202006;352590;I;5620101;1;2;-1
452905;202006;352590;G;4789007;0;1;-1
453013;202006;352590;F;4399199;1;1;0
453104;202006;352590;H;4923002;0;1;-1
453155;202006;352590;C;2821602;1;2;-1
453240;202006;352590;G;4723700;0;1;-1
453460;202006;352590;G;4781400;0;3;-3
453576;202006;352590;F;4313400;2;0;2
453698;202006;352590;G;4649499;1;5;-4
453703;202006;352590;C;2823200;1;0;1
453782;202006;352590;G;4661300;4;2;2
453905;202006;352590;G;4789099;0;1;-1
453983;202006;352590;C;3314708;0;1;-1
454083;202006;352590;G;4530703;0;1;-1
454116;202006;352590;G;4789005;1;0;1
454119;202006;352590;I;5510803;5;1;4
454253;202006;352590;G;4649403;1;0;1
454491;202006;352590;G;4753900;0;2;-2
454500;202006;352590;G;4753900;0;1;-1
454591;202006;352590;K;6550200;2;3;-1
454592;202006;352590;Q;8630502;2;0;2
454593;202006;352590;Q;8610102;1;3;-2
454594;202006;352590;Q;8610101;10;7;3
454602;202006;352590;G;4673700;0;1;-1
454954;202006;352590;F;4321500;2;3;-1
455113;202006;352590;G;4530703;0;1;-1
455656;202006;352590;H;4930202;1;1;0
455816;202006;352590;C;2099199;4;3;1
455970;202006;352590;H;4930202;2;2;0
456005;202006;352590;G;4649408;0;1;-1
456113;202006;352590;K;6493000;0;1;-1
456410;202006;352590;N;8219901;0;1;-1
456479;202006;352590;I;5611203;0;3;-3
456511;202006;352590;N;8121400;5;1;4
456513;202006;352590;H;5223100;0;1;-1
456514;202006;352590;H;5223100;0;1;-1
456700;202006;352590;G;4789099;0;1;-1
456741;202006;352590;F;4221902;0;3;-3
456777;202006;352590;H;4929902;5;11;-6
456788;202006;352590;I;5611201;0;1;-1
456832;202006;352590;G;4763601;0;3;-3
457065;202006;352590;G;4530703;0;1;-1
457125;202006;352590;G;4635402;3;4;-1
457196;202006;352590;C;2229399;3;3;0
457212;202006;352590;H;4930202;0;1;-1
457241;202006;352590;Q;8640205;0;9;-9
457242;202006;352590;N;8112500;2;0;2
457278;202006;352590;N;7739099;0;1;-1
457279;202006;352590;P;8512100;0;1;-1
457286;202006;352590;N;8112500;0;1;-1
457287;202006;352590;Q;8640202;1;0;1
457382;202006;352590;C;2944100;4;4;0
457721;202006;352590;F;4292802;2;4;-2
457797;202006;352590;H;4930202;4;0;4
457821;202006;352590;G;4721102;1;1;0
457837;202006;352590;K;6550200;1;0;1
457903;202006;352590;E;3839401;1;0;1
458008;202006;352590;H;4930202;0;1;-1
458063;202006;352590;N;7732201;1;1;0
458211;202006;352590;G;4633802;0;1;-1
458255;202006;352590;C;1314600;3;0;3
458409;202006;352590;G;4744005;0;1;-1
458979;202006;352590;M;7210000;0;1;-1
459090;202006;352590;C;2522500;4;9;-5
459309;202006;352590;C;3299005;0;17;-17
459333;202006;352590;Q;8610101;3;1;2
459369;202006;352590;C;2014200;0;3;-3
459491;202006;352590;C;2812700;0;3;-3
459902;202006;352590;K;6422100;0;1;-1
459939;202006;352590;C;2222600;0;2;-2
459966;202006;352590;I;5612100;0;1;-1
460031;202006;352590;S;9529102;0;1;-1
460124;202006;352590;G;4511104;0;3;-3
460185;202006;352590;B;810099;1;1;0
460186;202006;352590;C;2330302;0;2;-2
460446;202006;352590;C;1099603;0;1;-1
460480;202006;352590;G;4530703;0;2;-2
460657;202006;352590;C;3104700;0;4;-4
460663;202006;352590;P;8513900;0;1;-1
460664;202006;352590;Q;8711502;4;1;3
460666;202006;352590;P;8513900;0;2;-2
460759;202006;352590;Q;8640212;1;0;1
460764;202006;352590;Q;8640212;1;0;1
460795;202006;352590;S;9491000;0;11;-11
461193;202006;352590;G;4646001;0;1;-1
461346;202006;352590;C;2591800;15;1;14
461405;202006;352590;G;4635402;5;2;3
461412;202006;352590;C;1122401;6;3;3
461529;202006;352590;C;1721400;0;13;-13
461612;202006;352590;G;4711302;8;7;1
462017;202006;352590;G;4771701;0;1;-1
462071;202006;352590;G;4771701;2;1;1
462173;202006;352590;G;4771701;3;2;1
462358;202006;352590;G;4771701;0;1;-1
462731;202006;352590;N;8211300;8;8;0
462830;202006;352590;C;1411801;0;5;-5
462968;202006;352590;G;4771701;0;1;-1
463014;202006;352590;G;4771701;0;1;-1
463107;202006;352590;G;4771701;0;1;-1
463109;202006;352590;G;4771701;0;2;-2
463156;202006;352590;G;4771701;1;0;1
463181;202006;352590;G;4771701;0;2;-2
463212;202006;352590;G;4771701;0;1;-1
463291;202006;352590;G;4771701;0;1;-1
463318;202006;352590;G;4771701;0;1;-1
463348;202006;352590;G;4771701;0;1;-1
463360;202006;352590;G;4771701;0;1;-1
463490;202006;352590;Q;8800600;2;20;-18
463781;202006;352590;P;8512100;0;1;-1
463782;202006;352590;P;8512100;1;0;1
463786;202006;352590;N;8121400;0;131;-131
464082;202006;352590;F;4330403;0;1;-1
464204;202006;352590;F;4110700;2;0;2
464328;202006;352590;G;4741500;0;1;-1
464631;202006;352590;I;5612100;0;1;-1
464693;202006;352590;G;4637107;0;5;-5
464728;202006;352590;F;4321500;0;1;-1
465046;202006;352590;I;5611203;1;0;1
465312;202006;352590;G;4789002;2;2;0
465325;202006;352590;C;2229301;1;2;-1
465462;202006;352590;G;4530701;1;1;0
466130;202006;352590;C;1096100;0;1;-1
466178;202006;352590;I;5611201;0;1;-1
466189;202006;352590;J;6209100;2;5;-3
466190;202006;352590;N;8211300;0;1;-1
466194;202006;352590;Q;8660700;7;3;4
466236;202006;352590;J;5829800;0;1;-1
466283;202006;352590;G;4771701;1;0;1
466295;202006;352590;H;4930202;1;0;1
466901;202006;352590;F;4120400;0;1;-1
466902;202006;352590;C;3314710;2;7;-5
467807;202006;352590;H;4930202;0;1;-1
467811;202006;352590;F;4330401;0;1;-1
468058;202006;352590;G;4711302;13;25;-12
468089;202006;352590;C;1099699;3;1;2
468172;202006;352590;F;4211101;1;1;0
468203;202006;352590;P;8512100;1;0;1
468265;202006;352590;G;4771702;0;1;-1
468712;202006;352590;G;4684201;0;1;-1
468759;202006;352590;N;7739099;8;8;0
468774;202006;352590;I;5611203;0;6;-6
468775;202006;352590;I;5611203;0;2;-2
468878;202006;352590;G;4789099;1;1;0
469245;202006;352590;N;8111700;6;18;-12
469246;202006;352590;H;5223100;0;1;-1
469247;202006;352590;S;9430800;0;1;-1
469248;202006;352590;M;6920601;0;1;-1
469258;202006;352590;H;5223100;0;1;-1
469259;202006;352590;P;8512100;0;2;-2
469264;202006;352590;N;8112500;0;1;-1
469319;202006;352590;G;4771701;3;1;2
469320;202006;352590;G;4771701;1;0;1
469386;202006;352590;G;4744005;4;1;3
469554;202006;352590;C;2014200;4;2;2
469572;202006;352590;G;4711302;3;0;3
469636;202006;352590;F;4120400;14;1;13
469664;202006;352590;C;2222600;5;2;3
469731;202006;352590;F;4120400;1;2;-1
469817;202006;352590;G;4729699;0;1;-1
469976;202006;352590;G;4637199;0;4;-4
470143;202006;352590;I;5620101;1;0;1
470155;202006;352590;I;5620101;0;1;-1
470204;202006;352590;I;5620101;2;2;0
470398;202006;352590;M;6920601;1;0;1
470479;202006;352590;C;1412601;0;1;-1
470495;202006;352590;G;4744005;1;0;1
470522;202006;352590;G;4623199;2;0;2
470533;202006;352590;H;4930202;0;2;-2
470656;202006;352590;G;4645103;0;1;-1
470693;202006;352590;G;4721102;1;0;1
470798;202006;352590;G;4763601;0;1;-1
471498;202006;352590;G;4771701;0;1;-1
471509;202006;352590;J;6203100;1;1;0
471901;202006;352590;G;4771702;2;1;1
471933;202006;352590;G;4530703;1;0;1
473179;202006;352590;G;4511101;3;2;1
473295;202006;352590;C;2229301;25;2;23
473418;202006;352590;G;4759899;1;2;-1
473447;202006;352590;F;4110700;1;0;1
473518;202006;352590;C;3314710;1;1;0
473618;202006;352590;I;5611201;1;0;1
473643;202006;352590;G;4754702;1;0;1
473803;202006;352590;G;4741500;1;0;1
474894;202006;352590;G;4789099;0;1;-1
474923;202006;352590;H;5310502;0;2;-2
475017;202006;352590;I;5611201;1;0;1
475041;202006;352590;G;4789099;1;1;0
475065;202006;352590;G;4692300;1;2;-1
475762;202006;352590;G;4635402;0;8;-8
476718;202006;352590;H;5310502;2;3;-1
476727;202006;352590;H;5223100;0;1;-1
476961;202006;352590;P;8599601;0;1;-1
477114;202006;352590;G;4669901;0;1;-1
477133;202006;352590;G;4789002;0;1;-1
477187;202006;352590;G;4744001;1;0;1
477217;202006;352590;I;5611203;0;2;-2
477230;202006;352590;G;4520001;0;2;-2
477274;202006;352590;G;4711302;1;2;-1
477323;202006;352590;C;2014200;1;1;0
477366;202006;352590;N;7820500;0;1;-1
478123;202006;352590;G;4711301;5;9;-4
478470;202006;352590;I;5620101;0;16;-16
478672;202006;352590;C;2349401;0;3;-3
479128;202006;352590;H;4930202;1;1;0
481264;202006;352590;H;4930203;1;4;-3
482778;202006;352590;H;4930202;0;1;-1
483392;202006;352590;G;4530703;1;1;0
483768;202006;352590;G;4711301;0;1;-1
489966;202006;352590;C;3314710;6;4;2
490776;202006;352590;G;4541201;0;7;-7
495503;202006;352590;H;4930202;4;0;4
496557;202006;352590;C;1733800;12;17;-5
496558;202006;352590;C;1733800;21;50;-29
500505;202006;352590;G;4781400;0;1;-1
502631;202006;352590;I;5620101;1;2;-1
503909;202006;352590;C;1733800;0;1;-1
504051;202006;352590;N;7732201;1;0;1
504086;202006;352590;N;8111700;0;2;-2
504342;202006;352590;I;5620101;4;0;4
504354;202006;352590;G;4771702;1;0;1
504437;202006;352590;Q;8630503;1;1;0
504534;202006;352590;C;2599399;0;3;-3
505277;202006;352590;F;4330401;2;0;2
505328;202006;352590;H;5229002;0;1;-1
505725;202006;352590;C;2813500;35;4;31
505726;202006;352590;C;2349401;0;4;-4
513411;202006;352590;M;6912500;1;0;1
138;202103;352590;K;6422100;0;2;-2
674;202103;352590;K;6422100;0;2;-2
920;202103;352590;K;6422100;0;3;-3
1027;202103;352590;K;6422100;0;1;-1
1068;202103;352590;K;6422100;0;2;-2
1074;202103;352590;K;6422100;0;1;-1
2362;202103;352590;Q;8640202;1;0;1
2697;202103;352590;L;6810202;1;0;1
2854;202103;352590;G;4752100;0;1;-1
3762;202103;352590;C;2599399;1;7;-6
3922;202103;352590;L;6810202;2;1;1
4023;202103;352590;G;4744005;1;0;1
4589;202103;352590;C;2812700;5;3;2
4624;202103;352590;H;4930203;28;0;28
4716;202103;352590;C;1091101;0;1;-1
5121;202103;352590;C;2222600;1;0;1
5123;202103;352590;C;2222600;0;1;-1
5145;202103;352590;C;1629301;0;1;-1
5239;202103;352590;Q;8630503;4;0;4
5262;202103;352590;C;2949299;0;8;-8
5369;202103;352590;G;4772500;1;0;1
5474;202103;352590;I;5611203;1;0;1
6098;202103;352590;N;8219901;0;1;-1
6305;202103;352590;C;2040100;12;7;5
6440;202103;352590;N;7739099;2;1;1
6525;202103;352590;H;4924800;6;0;6
6557;202103;352590;N;7810800;15;22;-7
6696;202103;352590;C;2014200;1;0;1
6752;202103;352590;K;6622300;1;5;-4
6848;202103;352590;Q;8610102;2;0;2
7595;202103;352590;G;4789099;0;1;-1
7596;202103;352590;C;2512800;0;2;-2
8293;202103;352590;K;6436100;0;1;-1
8536;202103;352590;H;4930203;0;1;-1
8702;202103;352590;G;4753900;3;6;-3
9908;202103;352590;G;4712100;0;1;-1
10402;202103;352590;G;4721102;2;1;1
10437;202103;352590;G;4744002;1;0;1
10667;202103;352590;G;4649406;5;0;5
10743;202103;352590;I;5611203;0;1;-1
10981;202103;352590;G;4672900;1;1;0
11775;202103;352590;M;6920601;1;0;1
12570;202103;352590;G;4789099;1;0;1
13405;202103;352590;G;4754701;1;0;1
13837;202103;352590;H;5211701;6;8;-2
14435;202103;352590;G;4772500;0;1;-1
14734;202103;352590;I;5611203;2;0;2
14845;202103;352590;Q;8610101;6;5;1
15188;202103;352590;G;4633801;3;0;3
15473;202103;352590;C;2342702;13;2;11
15780;202103;352590;G;4763604;0;1;-1
16159;202103;352590;J;6203100;2;3;-1
16182;202103;352590;G;4511102;0;1;-1
16291;202103;352590;G;4771702;3;2;1
16294;202103;352590;H;4929902;4;7;-3
16489;202103;352590;S;9601703;8;7;1
16493;202103;352590;S;9601703;29;49;-20
16837;202103;352590;C;1413401;4;1;3
17004;202103;352590;G;4530705;1;0;1
17272;202103;352590;P;8599601;1;1;0
17273;202103;352590;M;6920601;0;1;-1
17286;202103;352590;K;6629100;0;1;-1
17339;202103;352590;C;2341900;1;1;0
18163;202103;352590;M;6920601;0;1;-1
19120;202103;352590;P;8512100;3;1;2
19122;202103;352590;S;9420100;0;1;-1
19123;202103;352590;Q;8640299;1;0;1
19868;202103;352590;G;4732600;0;1;-1
20258;202103;352590;R;9319199;1;0;1
20275;202103;352590;G;4753900;0;1;-1
20606;202103;352590;G;4530703;0;1;-1
20813;202103;352590;G;4789099;1;0;1
21058;202103;352590;C;2229303;0;1;-1
21228;202103;352590;I;5611203;1;0;1
21316;202103;352590;C;3240099;1;2;-1
21408;202103;352590;C;2731700;1;2;-1
21540;202103;352590;G;4711301;2;14;-12
21614;202103;352590;G;4511101;4;4;0
22243;202103;352590;H;5223100;0;1;-1
22305;202103;352590;I;5611201;0;2;-2
22337;202103;352590;E;3701100;0;1;-1
22443;202103;352590;G;4644301;64;46;18
22474;202103;352590;I;5620101;2;0;2
22528;202103;352590;M;7112000;3;14;-11
22640;202103;352590;J;6202300;1;0;1
22809;202103;352590;K;6622300;3;1;2
23333;202103;352590;K;6424703;0;1;-1
23343;202103;352590;G;4771701;0;1;-1
23465;202103;352590;I;5611201;0;4;-4
23729;202103;352590;Q;8640208;0;1;-1
24004;202103;352590;N;8299701;248;19;229
24190;202103;352590;S;9430800;0;1;-1
24453;202103;352590;I;5611201;3;0;3
25189;202103;352590;I;5611203;0;1;-1
25405;202103;352590;I;5611203;0;1;-1
25453;202103;352590;G;4721102;0;2;-2
25551;202103;352590;K;6622300;1;0;1
25959;202103;352590;C;2229302;4;3;1
26208;202103;352590;G;4689399;1;1;0
26915;202103;352590;M;6920601;0;1;-1
26982;202103;352590;G;4652400;0;1;-1
27099;202103;352590;F;4313400;0;1;-1
27381;202103;352590;C;3102100;12;5;7
27888;202103;352590;H;4930203;4;2;2
28170;202103;352590;I;5510803;0;1;-1
28218;202103;352590;G;4689301;0;1;-1
28232;202103;352590;N;8112500;0;1;-1
28233;202103;352590;M;6920601;2;5;-3
28234;202103;352590;Q;8640299;4;2;2
28240;202103;352590;F;4329104;1;4;-3
28534;202103;352590;G;4530705;0;1;-1
28585;202103;352590;G;4751201;1;5;-4
28812;202103;352590;L;6810202;0;1;-1
29052;202103;352590;C;2091600;0;1;-1
29064;202103;352590;C;2222600;0;1;-1
29212;202103;352590;Q;8630502;1;0;1
29684;202103;352590;G;4649499;1;0;1
30640;202103;352590;F;4399199;1;0;1
30947;202103;352590;H;4930202;5;1;4
31174;202103;352590;C;1062700;2;3;-1
31247;202103;352590;M;6920601;0;1;-1
31720;202103;352590;G;4789099;2;0;2
31968;202103;352590;P;8511200;0;1;-1
31969;202103;352590;C;1081302;6;13;-7
32565;202103;352590;M;6920601;1;2;-1
32603;202103;352590;C;2539001;0;2;-2
33122;202103;352590;C;3250705;0;2;-2
33128;202103;352590;I;5611201;0;1;-1
33836;202103;352590;G;4741500;0;1;-1
33853;202103;352590;G;4732600;0;1;-1
34066;202103;352590;G;4687703;0;1;-1
34593;202103;352590;P;8512100;0;1;-1
34674;202103;352590;N;8211300;17;15;2
34675;202103;352590;G;4634601;15;3;12
35448;202103;352590;C;2219600;1;0;1
35520;202103;352590;G;4712100;2;2;0
35628;202103;352590;P;8592903;0;4;-4
36656;202103;352590;I;5611201;0;1;-1
36945;202103;352590;P;8599601;1;1;0
37191;202103;352590;G;4530701;1;0;1
37315;202103;352590;G;4744005;1;0;1
37502;202103;352590;I;5611201;1;0;1
37735;202103;352590;C;2949299;2;1;1
38096;202103;352590;G;4530701;2;2;0
38289;202103;352590;G;4712100;1;0;1
38636;202103;352590;G;4530702;3;0;3
38789;202103;352590;C;2539001;1;1;0
38909;202103;352590;G;4687701;1;0;1
39142;202103;352590;C;2599399;11;4;7
39273;202103;352590;S;9430800;1;1;0
39696;202103;352590;G;4744005;2;1;1
39697;202103;352590;G;4744005;0;1;-1
40350;202103;352590;C;1413402;1;1;0
40421;202103;352590;H;4930202;1;1;0
40541;202103;352590;C;2099199;1;0;1
40931;202103;352590;F;4313400;0;1;-1
41916;202103;352590;G;4781400;0;1;-1
42174;202103;352590;M;6920601;0;1;-1
42252;202103;352590;G;4649403;2;0;2
42488;202103;352590;N;8211300;10;8;2
42508;202103;352590;C;2539001;1;0;1
43070;202103;352590;C;2511000;1;0;1
43150;202103;352590;R;9312300;0;1;-1
43275;202103;352590;G;4751201;1;1;0
43653;202103;352590;P;8511200;3;0;3
43654;202103;352590;P;8512100;1;0;1
44266;202103;352590;G;4763602;0;1;-1
44681;202103;352590;C;1081302;10;14;-4
44968;202103;352590;N;8011101;5;16;-11
45287;202103;352590;G;4789099;0;1;-1
45370;202103;352590;N;7820500;22;5;17
45961;202103;352590;C;1749400;0;1;-1
46131;202103;352590;S;9430800;1;0;1
46549;202103;352590;J;6110801;0;1;-1
47018;202103;352590;G;4781400;0;1;-1
47020;202103;352590;C;1340501;0;1;-1
47169;202103;352590;F;4120400;0;1;-1
47240;202103;352590;M;6920601;3;2;1
47250;202103;352590;G;4511101;1;0;1
47289;202103;352590;H;5221400;66;51;15
47410;202103;352590;C;2941700;16;7;9
47420;202103;352590;R;9313100;2;0;2
47656;202103;352590;F;4329101;1;0;1
48295;202103;352590;H;4930203;0;1;-1
48408;202103;352590;G;4754701;1;0;1
48425;202103;352590;G;4619200;1;0;1
48748;202103;352590;Q;8630502;1;0;1
48865;202103;352590;C;2751100;6;0;6
49182;202103;352590;G;4789099;1;0;1
49283;202103;352590;C;2229302;0;3;-3
50489;202103;352590;C;1099604;0;1;-1
51715;202103;352590;P;8513900;1;1;0
52269;202103;352590;M;7490105;0;1;-1
53266;202103;352590;Q;8630503;0;1;-1
53328;202103;352590;G;4511101;1;1;0
54006;202103;352590;N;8291100;1;0;1
54124;202103;352590;G;4789099;1;0;1
54150;202103;352590;G;4729699;0;1;-1
54323;202103;352590;G;4744005;0;1;-1
54414;202103;352590;C;2091600;15;6;9
54572;202103;352590;G;4530705;1;0;1
55193;202103;352590;G;4781400;0;2;-2
55304;202103;352590;H;4930202;4;14;-10
55761;202103;352590;H;5211799;11;25;-14
55972;202103;352590;C;2949299;1;1;0
55989;202103;352590;N;8211300;9;4;5
56421;202103;352590;C;3312102;1;0;1
56623;202103;352590;C;2532201;1;0;1
56987;202103;352590;M;6920601;1;0;1
57293;202103;352590;I;5620103;2;3;-1
57352;202103;352590;H;4930202;52;16;36
57697;202103;352590;C;1013901;3;23;-20
57760;202103;352590;G;4722901;0;1;-1
58187;202103;352590;S;9430800;1;1;0
58296;202103;352590;C;2814301;2;0;2
58417;202103;352590;P;8511200;4;1;3
58526;202103;352590;H;5223100;0;2;-2
58797;202103;352590;L;6821802;3;0;3
59057;202103;352590;G;4789099;2;1;1
60102;202103;352590;G;4755503;1;0;1
60536;202103;352590;G;4741500;2;0;2
60795;202103;352590;H;4930202;1;0;1
61351;202103;352590;H;4930202;13;7;6
61654;202103;352590;G;4789001;0;1;-1
61698;202103;352590;N;8111700;0;1;-1
61902;202103;352590;N;8121400;27;30;-3
61984;202103;352590;N;8291100;0;4;-4
62018;202103;352590;M;6920601;1;2;-1
62217;202103;352590;G;4771702;1;2;-1
62260;202103;352590;C;2222600;7;5;2
62653;202103;352590;G;4771701;1;1;0
62834;202103;352590;G;4752100;1;0;1
62878;202103;352590;I;5611201;0;1;-1
63181;202103;352590;J;5829800;1;0;1
63257;202103;352590;G;4689399;1;0;1
63489;202103;352590;C;2539001;4;2;2
63919;202103;352590;K;6622300;0;2;-2
64547;202103;352590;F;4330499;11;2;9
66039;202103;352590;P;8512100;0;1;-1
66288;202103;352590;G;4646001;1;4;-3
66907;202103;352590;I;5620101;2;1;1
66912;202103;352590;I;5620101;0;1;-1
66937;202103;352590;Q;8720401;1;3;-2
67126;202103;352590;G;4772500;0;1;-1
68611;202103;352590;I;5611201;0;1;-1
68833;202103;352590;F;4120400;0;1;-1
69929;202103;352590;K;6622300;0;2;-2
70032;202103;352590;C;2814301;0;1;-1
70168;202103;352590;G;4744099;1;2;-1
70215;202103;352590;G;4781400;2;0;2
71187;202103;352590;G;4711302;1;1;0
71380;202103;352590;G;4711302;3;3;0
71447;202103;352590;G;4712100;0;2;-2
71956;202103;352590;G;4755503;0;1;-1
71994;202103;352590;F;4391600;3;4;-1
72931;202103;352590;G;4530703;1;0;1
73217;202103;352590;C;2539002;2;1;1
73380;202103;352590;H;4930202;1;1;0
74176;202103;352590;E;3600601;0;2;-2
74201;202103;352590;I;5611203;1;7;-6
74390;202103;352590;N;8292000;6;0;6
74569;202103;352590;C;1093702;126;15;111
75023;202103;352590;N;7820500;286;223;63
75092;202103;352590;F;4120400;8;1;7
75335;202103;352590;I;5611201;1;0;1
76780;202103;352590;G;4724500;1;0;1
76840;202103;352590;P;8541400;1;1;0
77104;202103;352590;C;3292202;1;2;-1
77202;202103;352590;H;4930202;1;0;1
77523;202103;352590;P;8599699;1;3;-2
77689;202103;352590;C;2829199;1;2;-1
77931;202103;352590;N;7820500;428;363;65
78923;202103;352590;G;4781400;1;0;1
79000;202103;352590;G;4754701;1;0;1
79216;202103;352590;P;8599699;1;1;0
79608;202103;352590;P;8599699;4;1;3
79650;202103;352590;P;8599699;2;1;1
79651;202103;352590;P;8599699;7;1;6
79991;202103;352590;J;6190601;1;0;1
80809;202103;352590;M;6920601;1;0;1
80833;202103;352590;Q;8630501;1;0;1
80913;202103;352590;G;4755502;1;0;1
80914;202103;352590;G;4755502;0;1;-1
81084;202103;352590;N;8129000;59;49;10
81160;202103;352590;G;4744005;2;1;1
81218;202103;352590;C;2222600;2;7;-5
81608;202103;352590;H;4929902;0;1;-1
81695;202103;352590;G;4721104;0;1;-1
82046;202103;352590;H;4930202;3;2;1
82047;202103;352590;H;4930202;4;7;-3
82338;202103;352590;H;5120000;2;3;-1
82341;202103;352590;H;5120000;2;0;2
82475;202103;352590;N;8122200;1;1;0
82561;202103;352590;G;4789005;1;0;1
83122;202103;352590;G;4744005;2;1;1
83183;202103;352590;I;5611203;0;4;-4
83184;202103;352590;G;4637106;6;6;0
84212;202103;352590;I;5611203;0;1;-1
84665;202103;352590;I;5510803;2;1;1
84735;202103;352590;I;5510803;1;1;0
84915;202103;352590;Q;8630501;0;2;-2
85720;202103;352590;G;4649499;0;3;-3
85739;202103;352590;G;4771701;2;0;2
85839;202103;352590;G;4781400;1;1;0
86199;202103;352590;N;8211300;0;1;-1
86293;202103;352590;J;6203100;0;1;-1
86476;202103;352590;N;8291100;1;3;-2
87178;202103;352590;Q;8630503;1;0;1
87471;202103;352590;G;4672900;1;2;-1
87566;202103;352590;I;5611201;6;9;-3
87569;202103;352590;I;5611201;6;3;3
87571;202103;352590;I;5611201;4;0;4
87840;202103;352590;N;8299799;5;7;-2
87841;202103;352590;N;8299799;1;1;0
87898;202103;352590;Q;8711502;4;5;-1
88174;202103;352590;J;6203100;2;1;1
88407;202103;352590;N;7820500;0;1;-1
88873;202103;352590;F;4120400;4;0;4
88925;202103;352590;F;4120400;0;2;-2
89172;202103;352590;D;3514000;1;0;1
89178;202103;352590;D;3514000;0;1;-1
89205;202103;352590;H;4930202;1;0;1
89378;202103;352590;Q;8650004;1;0;1
89735;202103;352590;G;4789099;1;1;0
90694;202103;352590;N;8121400;3;2;1
90760;202103;352590;H;4930201;1;2;-1
90822;202103;352590;S;9491000;1;1;0
90875;202103;352590;J;6209100;1;0;1
91020;202103;352590;G;4530703;1;0;1
91080;202103;352590;C;2029100;1;0;1
91430;202103;352590;H;5112901;15;5;10
91833;202103;352590;G;4520001;0;1;-1
92138;202103;352590;C;2945000;1;0;1
92464;202103;352590;G;4781400;0;1;-1
92481;202103;352590;I;5510803;1;0;1
92636;202103;352590;P;8532500;7;2;5
92712;202103;352590;G;4789002;2;1;1
92735;202103;352590;P;8599699;4;3;1
93294;202103;352590;G;4541202;2;0;2
93736;202103;352590;C;3314707;1;0;1
94889;202103;352590;Q;8630501;1;0;1
95184;202103;352590;C;3314721;15;1;14
95596;202103;352590;G;4511101;3;0;3
96085;202103;352590;F;4299599;13;7;6
96088;202103;352590;F;4299599;0;3;-3
96576;202103;352590;Q;8640210;1;1;0
96577;202103;352590;Q;8640210;1;1;0
96578;202103;352590;Q;8640210;1;0;1
96758;202103;352590;M;6920601;1;2;-1
96908;202103;352590;G;4753900;0;2;-2
97114;202103;352590;G;4731800;1;2;-1
97179;202103;352590;G;4639701;12;10;2
98197;202103;352590;M;6911701;1;0;1
98440;202103;352590;H;5250804;1;0;1
99062;202103;352590;G;4757100;0;1;-1
99133;202103;352590;N;8299799;11;8;3
99522;202103;352590;G;4751201;1;0;1
100062;202103;352590;E;3839499;0;1;-1
100251;202103;352590;Q;8630503;1;0;1
100364;202103;352590;C;2449199;1;1;0
101180;202103;352590;P;8512100;6;4;2
101354;202103;352590;H;5250801;0;1;-1
101402;202103;352590;S;9511800;2;0;2
101682;202103;352590;G;4789007;0;1;-1
101925;202103;352590;G;4744005;0;1;-1
102024;202103;352590;M;6920601;1;0;1
102092;202103;352590;N;8211300;19;62;-43
102291;202103;352590;G;4511102;0;1;-1
102344;202103;352590;G;4789002;0;1;-1
102377;202103;352590;G;4789099;3;2;1
102592;202103;352590;R;9329802;0;1;-1
102611;202103;352590;C;3299004;2;0;2
104027;202103;352590;J;6203100;0;2;-2
104101;202103;352590;I;5611201;0;1;-1
104596;202103;352590;M;6920601;1;0;1
104601;202103;352590;C;2399199;2;0;2
105339;202103;352590;Q;8630504;1;1;0
105409;202103;352590;G;4520001;2;1;1
105981;202103;352590;Q;8650099;10;13;-3
106212;202103;352590;G;4789007;8;1;7
106318;202103;352590;G;4753900;2;2;0
106410;202103;352590;G;4757100;0;1;-1
106803;202103;352590;I;5611201;1;1;0
108043;202103;352590;N;8299706;1;1;0
108252;202103;352590;K;6612603;0;1;-1
108683;202103;352590;H;4930201;5;5;0
108837;202103;352590;G;4664800;0;1;-1
109785;202103;352590;C;2222600;5;2;3
109807;202103;352590;C;1032599;1;0;1
109877;202103;352590;G;4724500;2;11;-9
109891;202103;352590;G;4724500;1;2;-1
110391;202103;352590;R;9313100;0;1;-1
110500;202103;352590;M;6920601;1;1;0
110566;202103;352590;H;4929901;0;1;-1
111033;202103;352590;I;5510803;0;1;-1
111316;202103;352590;G;4511101;1;0;1
112712;202103;352590;G;4689399;0;1;-1
112930;202103;352590;F;4299599;0;3;-3
113182;202103;352590;R;9313100;1;2;-1
113702;202103;352590;G;4520002;0;2;-2
113794;202103;352590;S;9430800;10;1;9
114304;202103;352590;S;9430800;1;4;-3
114814;202103;352590;I;5611203;0;1;-1
115366;202103;352590;G;4729699;2;1;1
115731;202103;352590;H;4930202;1;1;0
116155;202103;352590;I;5611202;1;0;1
116275;202103;352590;I;5611203;0;1;-1
117595;202103;352590;J;5914600;0;5;-5
117680;202103;352590;G;4530703;4;2;2
117702;202103;352590;I;5611201;1;0;1
117703;202103;352590;F;4110700;2;0;2
117855;202103;352590;Q;8640205;0;1;-1
118227;202103;352590;G;4731800;1;1;0
118259;202103;352590;F;4313400;0;1;-1
118601;202103;352590;I;5611203;0;1;-1
118603;202103;352590;N;7719599;1;0;1
118722;202103;352590;C;2330302;1;0;1
118806;202103;352590;F;4313400;33;9;24
118886;202103;352590;P;8512100;1;0;1
118983;202103;352590;G;4511101;2;7;-5
119260;202103;352590;P;8512100;1;0;1
119306;202103;352590;G;4781400;0;1;-1
119528;202103;352590;P;8513900;1;1;0
119604;202103;352590;H;4929902;0;1;-1
119801;202103;352590;G;4520001;1;0;1
119859;202103;352590;R;9313100;0;1;-1
121145;202103;352590;J;6201501;4;1;3
121330;202103;352590;J;6204000;1;0;1
121470;202103;352590;C;1412601;1;1;0
121554;202103;352590;M;6920601;1;0;1
121813;202103;352590;G;4687703;1;1;0
122124;202103;352590;N;8112500;1;1;0
122575;202103;352590;G;4722901;0;1;-1
122641;202103;352590;N;7820500;98;133;-35
123764;202103;352590;Q;8712300;7;3;4
123931;202103;352590;C;1621800;1;0;1
124266;202103;352590;H;5240199;0;3;-3
124461;202103;352590;J;6202300;5;1;4
124604;202103;352590;I;5611203;0;1;-1
124820;202103;352590;M;6920601;0;1;-1
125142;202103;352590;G;4755502;1;0;1
125178;202103;352590;M;6920601;1;1;0
125225;202103;352590;P;8599604;0;1;-1
125978;202103;352590;G;4789008;1;0;1
126004;202103;352590;G;4781400;0;2;-2
126170;202103;352590;G;4744002;2;3;-1
126374;202103;352590;C;2599399;0;1;-1
126528;202103;352590;M;7311400;1;1;0
126804;202103;352590;N;8219999;0;2;-2
126873;202103;352590;G;4541203;1;1;0
127123;202103;352590;G;4721102;1;1;0
127675;202103;352590;P;8511200;1;0;1
127838;202103;352590;R;9313100;2;1;1
128345;202103;352590;G;4774100;0;1;-1
128588;202103;352590;G;4669999;0;1;-1
128594;202103;352590;K;6622300;0;1;-1
128682;202103;352590;N;8299799;0;1;-1
128898;202103;352590;J;6201501;0;1;-1
129070;202103;352590;N;8299799;0;1;-1
129994;202103;352590;G;4687702;2;1;1
130307;202103;352590;G;4693100;1;0;1
130510;202103;352590;G;4711302;11;8;3
130541;202103;352590;G;4774100;0;2;-2
130662;202103;352590;G;4753900;2;0;2
130664;202103;352590;Q;8640204;0;1;-1
130864;202103;352590;M;6920601;2;1;1
131187;202103;352590;Q;8630503;2;0;2
132172;202103;352590;C;2219600;2;0;2
132342;202103;352590;Q;8650003;2;0;2
132602;202103;352590;C;2823200;2;1;1
132608;202103;352590;G;4789099;1;0;1
132820;202103;352590;C;2825900;0;1;-1
133599;202103;352590;G;4781400;0;1;-1
133732;202103;352590;G;4741500;1;0;1
133872;202103;352590;G;4639701;1;1;0
134299;202103;352590;P;8512100;6;2;4
134442;202103;352590;G;4744099;1;0;1
134499;202103;352590;G;4759899;0;5;-5
134501;202103;352590;G;4759899;0;4;-4
134502;202103;352590;G;4759899;0;4;-4
134510;202103;352590;G;4649499;13;4;9
134606;202103;352590;G;4761001;0;3;-3
134688;202103;352590;G;4744099;1;0;1
134774;202103;352590;G;4520001;0;1;-1
135517;202103;352590;H;4930203;1;2;-1
135579;202103;352590;G;4712100;3;2;1
135635;202103;352590;N;8299799;0;7;-7
135876;202103;352590;G;4789004;0;1;-1
135937;202103;352590;C;1099699;0;1;-1
136087;202103;352590;C;1082100;3;3;0
136376;202103;352590;G;4645101;0;1;-1
136659;202103;352590;F;4120400;1;1;0
136889;202103;352590;C;1091102;0;1;-1
137324;202103;352590;G;4711302;4;0;4
137466;202103;352590;G;4711301;6;11;-5
137716;202103;352590;G;4711302;0;2;-2
137757;202103;352590;G;4511102;2;1;1
138143;202103;352590;G;4751201;0;1;-1
138307;202103;352590;C;2829199;4;0;4
138360;202103;352590;I;5611201;2;0;2
138375;202103;352590;I;5611203;1;1;0
138665;202103;352590;P;8531700;1;6;-5
139086;202103;352590;G;4744001;0;1;-1
139129;202103;352590;Q;8650004;1;0;1
139906;202103;352590;G;4753900;0;1;-1
139930;202103;352590;G;4530703;1;0;1
140103;202103;352590;C;2591800;5;2;3
140815;202103;352590;K;6424703;1;1;0
140871;202103;352590;I;5611201;1;2;-1
141280;202103;352590;G;4744005;1;0;1
142190;202103;352590;G;4781400;0;1;-1
142449;202103;352590;F;4120400;0;1;-1
142742;202103;352590;G;4759899;1;1;0
142818;202103;352590;G;4530703;2;0;2
142930;202103;352590;F;4313400;12;13;-1
143372;202103;352590;G;4781400;1;0;1
143777;202103;352590;C;1013902;10;7;3
144452;202103;352590;R;9313100;0;1;-1
144528;202103;352590;H;4930202;0;3;-3
145097;202103;352590;G;4712100;6;3;3
145275;202103;352590;G;4789002;2;0;2
145276;202103;352590;G;4789002;0;2;-2
145745;202103;352590;G;4763602;0;1;-1
146143;202103;352590;H;4930202;2;3;-1
148107;202103;352590;I;5611201;0;1;-1
148780;202103;352590;C;2391503;0;1;-1
148851;202103;352590;N;8299799;23;6;17
149714;202103;352590;G;4781400;0;1;-1
150431;202103;352590;H;5250804;2;1;1
150628;202103;352590;F;4330401;0;1;-1
150696;202103;352590;G;4687702;1;0;1
151150;202103;352590;C;2592601;0;1;-1
151212;202103;352590;G;4711302;23;11;12
151287;202103;352590;I;5611201;1;0;1
151351;202103;352590;G;4713002;0;1;-1
152148;202103;352590;I;5611201;0;2;-2
152510;202103;352590;Q;8800600;1;1;0
152593;202103;352590;I;5611201;0;1;-1
152933;202103;352590;G;4763603;4;2;2
152990;202103;352590;G;4731800;2;0;2
153154;202103;352590;I;5611201;0;1;-1
153304;202103;352590;G;4663000;1;0;1
153504;202103;352590;N;8011101;18;11;7
154256;202103;352590;G;4530703;0;1;-1
154417;202103;352590;K;6424703;0;1;-1
154421;202103;352590;K;6424703;1;0;1
154962;202103;352590;H;4930202;2;2;0
155441;202103;352590;N;8211300;6;3;3
156199;202103;352590;C;2542000;0;1;-1
156301;202103;352590;G;4781400;9;2;7
156304;202103;352590;M;7320300;0;1;-1
156362;202103;352590;Q;8630503;0;1;-1
156363;202103;352590;G;4530703;1;0;1
156843;202103;352590;G;4530703;1;0;1
156898;202103;352590;C;2790299;5;8;-3
156905;202103;352590;G;4530703;0;1;-1
157912;202103;352590;C;1053800;1;4;-3
158083;202103;352590;Q;8630501;1;5;-4
158089;202103;352590;G;4774100;1;0;1
158538;202103;352590;G;4633801;1;5;-4
159608;202103;352590;G;4744099;1;0;1
160055;202103;352590;P;8513900;1;1;0
160926;202103;352590;N;8111700;1;2;-1
161369;202103;352590;C;2710403;1;0;1
161548;202103;352590;F;4299599;0;1;-1
161623;202103;352590;G;4685100;0;1;-1
161854;202103;352590;C;2071100;0;1;-1
162257;202103;352590;J;6209100;0;1;-1
162258;202103;352590;G;4731800;1;0;1
162673;202103;352590;S;9430800;1;0;1
162985;202103;352590;G;4619200;1;0;1
163387;202103;352590;G;4771701;1;0;1
163526;202103;352590;H;5223100;0;1;-1
163537;202103;352590;I;5620101;0;1;-1
163612;202103;352590;C;2759799;5;0;5
163889;202103;352590;M;7490104;1;0;1
164274;202103;352590;G;4652400;1;1;0
164758;202103;352590;I;5611201;1;6;-5
164915;202103;352590;G;4744003;0;2;-2
165400;202103;352590;H;4930202;2;1;1
165772;202103;352590;C;2219600;5;1;4
166195;202103;352590;H;4930202;1;1;0
166248;202103;352590;G;4731800;2;2;0
166521;202103;352590;C;2029100;0;14;-14
166548;202103;352590;G;4635402;6;5;1
166580;202103;352590;G;4744002;1;0;1
167099;202103;352590;H;4930202;0;3;-3
167560;202103;352590;S;9493600;1;0;1
168134;202103;352590;H;4930202;3;6;-3
168464;202103;352590;M;7020400;0;1;-1
168657;202103;352590;R;9313100;0;2;-2
168755;202103;352590;G;4520001;1;0;1
168761;202103;352590;G;4754703;4;2;2
169440;202103;352590;G;4617600;0;1;-1
170025;202103;352590;S;9511800;1;1;0
170267;202103;352590;G;4721102;1;2;-1
170324;202103;352590;P;8512100;1;0;1
170987;202103;352590;J;6204000;1;1;0
170991;202103;352590;G;4759899;0;1;-1
171254;202103;352590;G;4774100;1;0;1
171848;202103;352590;G;4520001;0;2;-2
171977;202103;352590;R;9329899;0;1;-1
171987;202103;352590;P;8520100;4;1;3
172000;202103;352590;J;6201501;0;1;-1
172026;202103;352590;K;6612604;0;1;-1
172271;202103;352590;J;6203100;3;0;3
172290;202103;352590;H;4930202;1;0;1
172522;202103;352590;C;2543800;2;0;2
172823;202103;352590;I;5620104;0;1;-1
172994;202103;352590;G;4772500;2;1;1
173372;202103;352590;N;8112500;2;0;2
173402;202103;352590;C;1053800;0;2;-2
173814;202103;352590;H;4930201;0;1;-1
173925;202103;352590;G;4754702;0;1;-1
174953;202103;352590;C;1032599;0;1;-1
175055;202103;352590;C;1099601;6;4;2
175188;202103;352590;P;8512100;0;2;-2
175196;202103;352590;P;8520100;1;2;-1
175519;202103;352590;C;1042200;2;1;1
175657;202103;352590;N;8219999;0;1;-1
175667;202103;352590;P;8513900;1;1;0
175669;202103;352590;N;7711000;0;1;-1
175670;202103;352590;P;8513900;2;0;2
176191;202103;352590;H;4930202;3;1;2
176193;202103;352590;I;5510801;1;1;0
176359;202103;352590;N;8122200;0;1;-1
176549;202103;352590;G;4781400;1;0;1
176660;202103;352590;G;4742300;0;2;-2
177392;202103;352590;K;6619399;0;1;-1
178251;202103;352590;M;7120100;1;0;1
178621;202103;352590;G;4511101;1;1;0
178900;202103;352590;M;6920601;1;2;-1
179007;202103;352590;M;7112000;0;1;-1
179340;202103;352590;N;7711000;1;0;1
179635;202103;352590;I;5611203;1;2;-1
179639;202103;352590;I;5611203;1;0;1
180333;202103;352590;N;8130300;0;1;-1
181826;202103;352590;N;7732201;1;0;1
182541;202103;352590;G;4753900;1;2;-1
182542;202103;352590;G;4753900;0;2;-2
182666;202103;352590;G;4789099;3;1;2
183307;202103;352590;P;8512100;2;0;2
183434;202103;352590;G;4639701;0;1;-1
184039;202103;352590;G;4721104;0;1;-1
184044;202103;352590;G;4530703;0;1;-1
184375;202103;352590;G;4781400;0;1;-1
184606;202103;352590;G;4751201;2;0;2
184607;202103;352590;G;4751201;0;1;-1
185027;202103;352590;P;8511200;0;1;-1
185070;202103;352590;G;4744001;4;1;3
185115;202103;352590;G;4686902;1;1;0
185215;202103;352590;B;891600;1;0;1
185360;202103;352590;G;4771701;1;0;1
185498;202103;352590;G;4755502;0;3;-3
185850;202103;352590;C;2621300;78;41;37
185851;202103;352590;C;2632900;83;33;50
185902;202103;352590;G;4759899;1;0;1
185927;202103;352590;N;8299799;131;100;31
186212;202103;352590;I;5611201;0;1;-1
186841;202103;352590;G;4729699;2;1;1
187175;202103;352590;Q;8630503;2;0;2
187603;202103;352590;C;2229303;0;1;-1
187645;202103;352590;C;1096100;1;0;1
187722;202103;352590;H;5212500;0;7;-7
188255;202103;352590;H;4930202;1;0;1
188967;202103;352590;G;4752100;0;1;-1
189384;202103;352590;G;4731800;0;1;-1
189761;202103;352590;M;6920601;0;1;-1
189847;202103;352590;F;4321500;0;2;-2
189945;202103;352590;N;7732201;1;0;1
190389;202103;352590;G;4731800;2;2;0
190417;202103;352590;N;7830200;1;1;0
190591;202103;352590;I;5611203;0;1;-1
190796;202103;352590;P;8513900;0;1;-1
190971;202103;352590;G;4759899;1;0;1
191464;202103;352590;J;6201501;1;1;0
192204;202103;352590;H;4930202;0;4;-4
192475;202103;352590;F;4399199;1;1;0
192530;202103;352590;G;4731800;1;0;1
192594;202103;352590;K;6491300;1;1;0
194140;202103;352590;F;4120400;7;2;5
194253;202103;352590;G;4712100;0;1;-1
194399;202103;352590;I;5611203;0;1;-1
194458;202103;352590;P;8512100;1;0;1
194588;202103;352590;G;4530703;1;1;0
195103;202103;352590;G;4744001;4;1;3
195507;202103;352590;G;4744099;1;0;1
195894;202103;352590;P;8512100;3;1;2
196016;202103;352590;G;4789004;1;0;1
196541;202103;352590;F;4213800;9;5;4
197111;202103;352590;C;2840200;1;0;1
197134;202103;352590;G;4729699;2;5;-3
197461;202103;352590;C;2539001;0;1;-1
197462;202103;352590;G;4663000;2;0;2
197557;202103;352590;I;5611203;1;0;1
197672;202103;352590;H;5212500;16;13;3
197777;202103;352590;N;8111700;16;15;1
197810;202103;352590;G;4721104;1;0;1
198478;202103;352590;G;4773300;2;0;2
198900;202103;352590;N;7820500;2;5;-3
199638;202103;352590;G;4781400;0;1;-1
199655;202103;352590;G;4754701;1;0;1
199835;202103;352590;C;2093200;1;0;1
199910;202103;352590;F;4120400;1;0;1
200611;202103;352590;G;4782201;0;1;-1
201256;202103;352590;S;9420100;1;0;1
201257;202103;352590;S;9420100;0;1;-1
201258;202103;352590;G;4721102;0;1;-1
201328;202103;352590;G;4530703;1;0;1
201396;202103;352590;G;4729699;5;7;-2
202064;202103;352590;P;8599603;2;1;1
202318;202103;352590;J;5812301;1;0;1
202933;202103;352590;C;3101200;1;0;1
203021;202103;352590;J;6202300;0;1;-1
203028;202103;352590;I;5611203;0;1;-1
203230;202103;352590;H;4930202;1;0;1
203266;202103;352590;M;7112000;1;0;1
203425;202103;352590;F;4222701;5;5;0
203561;202103;352590;G;4754703;0;1;-1
203682;202103;352590;G;4789099;2;2;0
203925;202103;352590;G;4686902;5;3;2
204423;202103;352590;G;4530703;0;1;-1
204475;202103;352590;Q;8711502;0;2;-2
204522;202103;352590;E;3832700;3;1;2
204872;202103;352590;I;5611201;6;5;1
204908;202103;352590;I;5611201;1;1;0
204938;202103;352590;G;4784900;0;1;-1
205116;202103;352590;I;5611203;0;1;-1
205347;202103;352590;C;2222600;1;5;-4
205542;202103;352590;P;8511200;0;1;-1
206194;202103;352590;G;4511101;1;2;-1
206533;202103;352590;I;5611203;0;1;-1
207069;202103;352590;G;4789099;0;2;-2
208076;202103;352590;H;4930202;0;1;-1
208459;202103;352590;G;4754701;1;4;-3
208959;202103;352590;H;4930201;1;0;1
209972;202103;352590;I;5611201;0;1;-1
210415;202103;352590;P;8541400;0;2;-2
210452;202103;352590;G;4731800;1;0;1
210720;202103;352590;I;5611203;0;1;-1
211266;202103;352590;I;5620101;4;3;1
211906;202103;352590;G;4731800;2;2;0
212279;202103;352590;G;4789005;6;2;4
212815;202103;352590;G;4754701;1;1;0
213036;202103;352590;M;6920601;2;1;1
213038;202103;352590;C;3321000;1;0;1
213385;202103;352590;S;9521500;2;0;2
213386;202103;352590;S;9521500;0;5;-5
213817;202103;352590;M;7112000;7;1;6
213818;202103;352590;J;6204000;3;2;1
214314;202103;352590;J;6311900;3;1;2
215598;202103;352590;G;4771701;2;0;2
216136;202103;352590;F;4321500;3;0;3
216154;202103;352590;G;4772500;0;2;-2
216380;202103;352590;G;4722901;1;1;0
216492;202103;352590;I;5611201;1;4;-3
217604;202103;352590;G;4789099;0;1;-1
217705;202103;352590;I;5611201;0;1;-1
218005;202103;352590;G;4511102;0;1;-1
218006;202103;352590;G;4530703;1;0;1
218013;202103;352590;G;4511101;0;1;-1
218409;202103;352590;N;8211300;1;0;1
218758;202103;352590;I;5620101;0;1;-1
218950;202103;352590;Q;8610101;3;5;-2
219525;202103;352590;N;8219999;3;0;3
219526;202103;352590;N;8219999;0;1;-1
219529;202103;352590;G;4686902;5;3;2
219600;202103;352590;G;4724500;5;10;-5
219601;202103;352590;G;4633801;0;5;-5
219602;202103;352590;G;4724500;9;9;0
221098;202103;352590;C;2222600;0;1;-1
221150;202103;352590;G;4751201;0;1;-1
221463;202103;352590;C;2812700;1;0;1
221581;202103;352590;C;2229399;0;1;-1
221623;202103;352590;F;4120400;0;1;-1
221865;202103;352590;J;5914600;0;8;-8
222099;202103;352590;I;5611201;0;1;-1
222734;202103;352590;H;4930202;0;1;-1
222860;202103;352590;I;5510801;1;0;1
223040;202103;352590;H;5250805;2;3;-1
223078;202103;352590;C;2621300;13;5;8
223316;202103;352590;G;4772500;0;1;-1
223378;202103;352590;G;4618499;1;0;1
223612;202103;352590;G;4691500;6;6;0
224045;202103;352590;C;3291400;1;0;1
224189;202103;352590;Q;8711502;2;0;2
224324;202103;352590;G;4781400;0;1;-1
224440;202103;352590;G;4721103;0;1;-1
225082;202103;352590;F;4399103;1;1;0
225103;202103;352590;G;4520006;0;1;-1
225122;202103;352590;C;2511000;4;7;-3
225237;202103;352590;G;4731800;0;1;-1
226932;202103;352590;P;8511200;1;0;1
226934;202103;352590;M;6920601;1;0;1
227590;202103;352590;H;5211701;4;0;4
227591;202103;352590;H;5211701;0;1;-1
227792;202103;352590;M;7119701;2;0;2
227864;202103;352590;C;3329501;1;0;1
228007;202103;352590;C;2660400;1;14;-13
228337;202103;352590;Q;8630503;1;0;1
228728;202103;352590;Q;8640205;1;0;1
229104;202103;352590;G;4633801;0;1;-1
230304;202103;352590;G;4647802;1;0;1
230316;202103;352590;G;4511101;1;2;-1
231743;202103;352590;G;4520004;1;1;0
232324;202103;352590;G;4754701;10;4;6
232328;202103;352590;G;4754701;1;0;1
232780;202103;352590;N;8211300;2;5;-3
232815;202103;352590;G;4713002;0;1;-1
233124;202103;352590;G;4772500;0;1;-1
233627;202103;352590;N;8220200;3;4;-1
234077;202103;352590;N;8299706;0;1;-1
234156;202103;352590;G;4530703;1;0;1
234526;202103;352590;C;2532201;0;1;-1
235980;202103;352590;P;8599601;0;1;-1
236262;202103;352590;J;6311900;0;1;-1
236454;202103;352590;H;5250804;0;1;-1
238685;202103;352590;H;4930202;0;1;-1
238799;202103;352590;M;6920601;2;1;1
238926;202103;352590;J;6204000;2;0;2
240419;202103;352590;G;4732600;1;0;1
240693;202103;352590;C;2222600;2;14;-12
241304;202103;352590;C;3314707;6;2;4
241957;202103;352590;C;2651500;1;1;0
242674;202103;352590;N;8020001;1;1;0
242949;202103;352590;J;6319400;0;1;-1
243050;202103;352590;M;7020400;0;1;-1
243747;202103;352590;C;1629301;0;1;-1
243953;202103;352590;G;4731800;1;2;-1
244811;202103;352590;G;4771701;0;1;-1
244884;202103;352590;G;4712100;3;2;1
244885;202103;352590;N;8299799;5;1;4
245407;202103;352590;G;4687703;1;0;1
245505;202103;352590;H;4930202;2;0;2
246812;202103;352590;Q;8630502;4;3;1
246996;202103;352590;F;4321500;1;0;1
247117;202103;352590;I;5611203;0;1;-1
247168;202103;352590;M;6920601;0;1;-1
247399;202103;352590;H;4930202;0;1;-1
247563;202103;352590;M;6920601;1;3;-2
248231;202103;352590;K;6462000;0;2;-2
248481;202103;352590;G;4781400;0;1;-1
249544;202103;352590;P;8511200;7;1;6
249867;202103;352590;H;4930202;18;24;-6
250091;202103;352590;F;4213800;1;1;0
250195;202103;352590;C;1099699;1;1;0
251607;202103;352590;C;1099699;1;0;1
251897;202103;352590;G;4530703;0;1;-1
252539;202103;352590;N;8299799;0;1;-1
252543;202103;352590;C;3211602;1;0;1
252555;202103;352590;G;4712100;0;1;-1
252588;202103;352590;G;4669999;0;1;-1
253284;202103;352590;N;7911200;1;0;1
253587;202103;352590;G;4623109;6;3;3
253621;202103;352590;G;4781400;0;8;-8
253633;202103;352590;G;4511104;2;0;2
253654;202103;352590;P;8513900;0;1;-1
253655;202103;352590;P;8513900;0;1;-1
253657;202103;352590;N;8130300;36;35;1
253658;202103;352590;G;4789099;8;2;6
253728;202103;352590;G;4789005;0;1;-1
254404;202103;352590;G;4761003;3;1;2
254656;202103;352590;C;2840200;1;1;0
255269;202103;352590;M;7120100;0;1;-1
255395;202103;352590;G;4781400;0;1;-1
255396;202103;352590;G;4781400;0;2;-2
255684;202103;352590;A;132600;3;0;3
255760;202103;352590;H;4930202;0;1;-1
255761;202103;352590;H;4930202;1;0;1
256053;202103;352590;N;8299799;0;2;-2
256075;202103;352590;C;3314710;5;0;5
256121;202103;352590;L;6821802;1;0;1
256553;202103;352590;N;8299799;2;1;1
256910;202103;352590;C;2311700;3;1;2
256911;202103;352590;G;4744002;2;0;2
256914;202103;352590;G;4781400;1;0;1
257696;202103;352590;H;5212500;5;12;-7
258093;202103;352590;C;3314721;1;0;1
258149;202103;352590;C;2349401;4;1;3
258398;202103;352590;C;2599399;1;0;1
258659;202103;352590;Q;8630501;0;1;-1
260233;202103;352590;G;4773300;0;1;-1
260364;202103;352590;F;4321500;0;1;-1
260645;202103;352590;N;8211300;0;1;-1
260699;202103;352590;Q;8630506;3;0;3
261089;202103;352590;N;8211300;1;1;0
262317;202103;352590;C;2072000;3;3;0
262341;202103;352590;N;8011101;1;1;0
262879;202103;352590;G;4781400;1;0;1
263258;202103;352590;N;8299799;0;2;-2
263479;202103;352590;G;4731800;1;0;1
263709;202103;352590;G;4649499;2;1;1
264170;202103;352590;I;5611201;0;1;-1
264449;202103;352590;P;8513900;1;0;1
264474;202103;352590;G;4520007;4;2;2
264857;202103;352590;G;4789002;4;0;4
264943;202103;352590;S;9499500;0;1;-1
265069;202103;352590;H;4930202;4;2;2
265374;202103;352590;C;2542000;1;1;0
265441;202103;352590;C;1830003;0;1;-1
265525;202103;352590;G;4782201;1;0;1
266323;202103;352590;Q;8712300;0;4;-4
266561;202103;352590;C;1091101;1;2;-1
268580;202103;352590;C;1733800;1;2;-1
268788;202103;352590;I;5611203;1;1;0
268806;202103;352590;I;5611203;0;1;-1
268963;202103;352590;P;8513900;2;2;0
269194;202103;352590;I;5620101;0;2;-2
269221;202103;352590;P;8599603;1;0;1
269258;202103;352590;H;4930202;1;1;0
269534;202103;352590;I;5611203;0;1;-1
269721;202103;352590;I;5611201;1;0;1
269943;202103;352590;G;4781400;1;3;-2
270305;202103;352590;G;4520001;0;13;-13
270563;202103;352590;G;4731800;1;0;1
270661;202103;352590;N;8230001;0;1;-1
272068;202103;352590;C;2229302;1;2;-1
272377;202103;352590;J;6311900;5;1;4
272664;202103;352590;G;4722901;1;0;1
272835;202103;352590;J;5811500;1;0;1
273220;202103;352590;F;4322302;2;3;-1
273454;202103;352590;L;6821802;4;2;2
273473;202103;352590;P;8512100;0;1;-1
273702;202103;352590;M;6911701;1;1;0
274308;202103;352590;I;5611204;1;1;0
274676;202103;352590;S;9609208;0;1;-1
274916;202103;352590;C;1733800;1;6;-5
275146;202103;352590;G;4771701;0;1;-1
275150;202103;352590;P;8520100;1;0;1
275275;202103;352590;G;4530703;0;1;-1
275438;202103;352590;S;9601701;0;1;-1
276340;202103;352590;M;6920601;2;2;0
276576;202103;352590;G;4713002;0;1;-1
276880;202103;352590;F;4330404;0;1;-1
277817;202103;352590;F;4399103;1;1;0
278241;202103;352590;C;1066000;17;6;11
278714;202103;352590;G;4781400;1;3;-2
278715;202103;352590;G;4781400;0;1;-1
278808;202103;352590;S;9521500;2;3;-1
279454;202103;352590;C;3250705;0;1;-1
279462;202103;352590;I;5611203;0;2;-2
280124;202103;352590;P;8512100;1;0;1
280128;202103;352590;E;3821100;7;9;-2
280131;202103;352590;I;5611201;0;1;-1
280132;202103;352590;I;5611201;0;1;-1
280182;202103;352590;K;6462000;8;5;3
280237;202103;352590;N;8111700;20;17;3
280313;202103;352590;J;6319400;0;1;-1
280435;202103;352590;F;4330499;8;0;8
281049;202103;352590;I;5611203;1;0;1
281602;202103;352590;F;4120400;6;4;2
282366;202103;352590;I;5510801;0;1;-1
282680;202103;352590;I;5611201;1;5;-4
282681;202103;352590;I;5611201;0;2;-2
283145;202103;352590;J;6209100;1;0;1
283428;202103;352590;M;7490104;1;0;1
283673;202103;352590;G;4781400;1;0;1
283881;202103;352590;G;4744099;2;2;0
284286;202103;352590;N;8111700;1;1;0
284544;202103;352590;G;4759899;1;0;1
285246;202103;352590;J;6190601;0;1;-1
285247;202103;352590;N;8121400;2;2;0
285361;202103;352590;C;2342702;1;1;0
285383;202103;352590;G;4744001;2;0;2
285395;202103;352590;P;8513900;4;0;4
285749;202103;352590;M;6920601;0;1;-1
285988;202103;352590;F;4120400;0;10;-10
286399;202103;352590;F;4322302;1;1;0
286499;202103;352590;P;8512100;0;1;-1
287231;202103;352590;M;7420001;2;1;1
287270;202103;352590;P;8541400;0;1;-1
287271;202103;352590;L;6821801;0;1;-1
288606;202103;352590;P;8511200;1;0;1
288607;202103;352590;P;8511200;1;0;1
289812;202103;352590;G;4619200;1;1;0
289820;202103;352590;S;9602502;0;6;-6
290061;202103;352590;H;4930201;1;0;1
290077;202103;352590;P;8511200;0;2;-2
290082;202103;352590;G;4743100;3;2;1
290225;202103;352590;I;5611203;0;4;-4
290637;202103;352590;H;4930202;3;2;1
292609;202103;352590;G;4761002;1;0;1
292651;202103;352590;Q;8630504;0;1;-1
292775;202103;352590;G;4772500;0;1;-1
293601;202103;352590;Q;8711501;1;0;1
293663;202103;352590;G;4530701;2;1;1
293880;202103;352590;N;8111700;8;3;5
294711;202103;352590;G;4691500;18;16;2
295209;202103;352590;N;8299706;0;1;-1
295999;202103;352590;N;8211300;3;1;2
296036;202103;352590;G;4637199;3;0;3
296196;202103;352590;N;8230001;0;1;-1
296453;202103;352590;I;5611203;0;2;-2
297119;202103;352590;C;1091102;2;0;2
297941;202103;352590;H;4930202;1;1;0
298055;202103;352590;F;4330403;1;0;1
298059;202103;352590;F;4330499;1;1;0
298875;202103;352590;G;4763601;0;1;-1
299814;202103;352590;N;7733100;1;0;1
299819;202103;352590;N;7733100;1;0;1
300016;202103;352590;N;8299706;1;0;1
300566;202103;352590;I;5611201;0;3;-3
300682;202103;352590;L;6822600;1;0;1
300806;202103;352590;G;4619200;1;0;1
301003;202103;352590;G;4774100;0;1;-1
301392;202103;352590;G;4712100;1;1;0
301503;202103;352590;H;4930202;6;0;6
301885;202103;352590;G;4689399;2;1;1
302018;202103;352590;P;8511200;1;0;1
302019;202103;352590;P;8511200;0;1;-1
302171;202103;352590;F;4213800;0;1;-1
302178;202103;352590;H;4930201;0;1;-1
302706;202103;352590;F;4399101;4;2;2
302867;202103;352590;G;4669999;5;3;2
303762;202103;352590;F;4399103;1;0;1
304205;202103;352590;N;8299799;1;0;1
304602;202103;352590;I;5611203;0;2;-2
305006;202103;352590;M;6920601;0;1;-1
305009;202103;352590;J;6311900;1;0;1
305019;202103;352590;G;4732600;0;1;-1
305252;202103;352590;G;4632003;1;0;1
307133;202103;352590;C;1093701;1;0;1
307349;202103;352590;F;4299501;0;1;-1
307477;202103;352590;J;6110803;0;1;-1
307888;202103;352590;G;4781400;0;1;-1
308086;202103;352590;I;5620102;0;1;-1
308184;202103;352590;P;8541400;0;1;-1
308430;202103;352590;G;4686902;0;2;-2
308535;202103;352590;C;3314708;3;1;2
308641;202103;352590;G;4530703;1;1;0
308871;202103;352590;F;4221905;0;1;-1
309309;202103;352590;E;3702900;0;1;-1
309569;202103;352590;G;4784900;0;1;-1
309685;202103;352590;K;6619399;5;0;5
309686;202103;352590;K;6622300;6;2;4
309948;202103;352590;C;3314719;1;1;0
309949;202103;352590;G;4763603;0;1;-1
310300;202103;352590;N;8230001;4;0;4
311030;202103;352590;C;2731700;2;1;1
311089;202103;352590;J;6190601;0;2;-2
311171;202103;352590;C;3101200;1;0;1
311568;202103;352590;G;4789099;0;3;-3
311572;202103;352590;Q;8640205;0;1;-1
311573;202103;352590;Q;8640205;0;1;-1
311670;202103;352590;I;5611201;0;1;-1
311783;202103;352590;H;4930201;0;1;-1
312322;202103;352590;H;5211701;25;34;-9
312891;202103;352590;O;8411600;1;1;0
313622;202103;352590;G;4530704;2;7;-5
313693;202103;352590;G;4753900;2;1;1
314271;202103;352590;G;4530705;1;1;0
314487;202103;352590;G;4771701;2;1;1
315376;202103;352590;C;3314702;1;14;-13
315380;202103;352590;G;4744001;0;1;-1
315592;202103;352590;G;4754701;4;4;0
315798;202103;352590;G;4781400;0;2;-2
315898;202103;352590;H;4930201;1;0;1
316325;202103;352590;G;4520007;1;0;1
316338;202103;352590;G;4744099;1;2;-1
316346;202103;352590;C;1091101;7;7;0
316350;202103;352590;C;2599399;0;4;-4
316519;202103;352590;C;3314708;3;2;1
317734;202103;352590;C;1413401;0;2;-2
317802;202103;352590;H;4930202;1;1;0
319314;202103;352590;F;4399103;2;0;2
320072;202103;352590;G;4781400;0;1;-1
321701;202103;352590;F;4399199;2;0;2
322282;202103;352590;G;4530703;4;1;3
322404;202103;352590;G;4761001;0;1;-1
322935;202103;352590;M;6920601;2;0;2
323077;202103;352590;G;4789004;1;0;1
323684;202103;352590;G;4623109;2;1;1
324013;202103;352590;M;7112000;0;1;-1
324017;202103;352590;K;6622300;1;0;1
324097;202103;352590;F;4322303;5;4;1
324346;202103;352590;G;4729699;0;1;-1
324347;202103;352590;G;4713002;0;1;-1
324854;202103;352590;N;8291100;0;1;-1
325531;202103;352590;G;4781400;0;1;-1
325639;202103;352590;C;1052000;0;1;-1
326545;202103;352590;G;4741500;0;2;-2
326776;202103;352590;Q;8650003;1;0;1
326885;202103;352590;G;4744099;0;1;-1
327756;202103;352590;M;6920601;1;0;1
327800;202103;352590;N;7810800;4;3;1
327811;202103;352590;G;4721104;18;6;12
327812;202103;352590;G;4637107;7;1;6
327919;202103;352590;C;3101200;4;1;3
327920;202103;352590;G;4754701;2;0;2
327921;202103;352590;G;4754701;1;0;1
328388;202103;352590;I;5611203;0;1;-1
328971;202103;352590;J;6190699;1;0;1
329000;202103;352590;I;5611201;0;3;-3
329394;202103;352590;G;4693100;1;0;1
329760;202103;352590;Q;8712300;4;0;4
330122;202103;352590;F;4120400;1;1;0
330573;202103;352590;G;4757100;0;2;-2
330577;202103;352590;M;6920601;0;1;-1
330671;202103;352590;N;8121400;2;1;1
330796;202103;352590;H;5223100;0;1;-1
330956;202103;352590;P;8599603;0;1;-1
331262;202103;352590;I;5620104;0;1;-1
331337;202103;352590;I;5611203;0;1;-1
331461;202103;352590;P;8511200;0;1;-1
331463;202103;352590;I;5611201;0;1;-1
334093;202103;352590;G;4782201;0;5;-5
334383;202103;352590;G;4520002;1;0;1
334477;202103;352590;H;5212500;0;1;-1
334950;202103;352590;G;4781400;0;1;-1
335042;202103;352590;G;4520002;0;1;-1
335260;202103;352590;M;7112000;0;16;-16
335433;202103;352590;N;7711000;2;0;2
335526;202103;352590;N;7711000;1;1;0
335688;202103;352590;C;2823200;1;2;-1
335708;202103;352590;M;7111100;1;0;1
335800;202103;352590;Q;8630503;4;0;4
335958;202103;352590;C;3101200;1;0;1
336463;202103;352590;J;6209100;2;0;2
336509;202103;352590;S;9521500;1;0;1
336726;202103;352590;N;8299799;0;1;-1
336962;202103;352590;P;8511200;0;2;-2
337395;202103;352590;I;5611201;1;0;1
337869;202103;352590;G;4782201;0;7;-7
338180;202103;352590;N;7911200;4;0;4
338383;202103;352590;G;4781400;1;1;0
338384;202103;352590;R;9313100;0;2;-2
338416;202103;352590;G;4782201;0;1;-1
338769;202103;352590;I;5611203;1;1;0
338836;202103;352590;S;9601701;1;3;-2
338873;202103;352590;N;8111700;4;4;0
339061;202103;352590;H;4930202;9;13;-4
339070;202103;352590;F;4321500;2;1;1
339223;202103;352590;H;5211701;0;1;-1
339556;202103;352590;P;8511200;1;3;-2
339558;202103;352590;I;5611203;1;0;1
339882;202103;352590;G;4755502;2;2;0
340179;202103;352590;H;4930201;1;1;0
340361;202103;352590;P;8512100;1;1;0
340647;202103;352590;P;8511200;3;0;3
340941;202103;352590;G;4712100;0;2;-2
341597;202103;352590;G;4721102;0;1;-1
341823;202103;352590;P;8512100;1;0;1
341824;202103;352590;G;4781400;0;1;-1
342436;202103;352590;I;5611203;1;1;0
342773;202103;352590;C;2229302;2;2;0
342954;202103;352590;N;8112500;1;0;1
342955;202103;352590;N;8112500;0;1;-1
343067;202103;352590;I;5611201;1;0;1
343069;202103;352590;R;9313100;2;0;2
343070;202103;352590;R;9313100;0;1;-1
343317;202103;352590;S;9603301;4;2;2
343703;202103;352590;K;6422100;0;1;-1
343750;202103;352590;K;6422100;0;1;-1
344271;202103;352590;H;5240199;1;1;0
344276;202103;352590;Q;8630504;1;1;0
344434;202103;352590;M;6920601;1;0;1
344435;202103;352590;P;8511200;0;1;-1
344720;202103;352590;M;6920601;2;1;1
345700;202103;352590;G;4774100;2;1;1
346361;202103;352590;N;8112500;1;0;1
346368;202103;352590;G;4781400;0;1;-1
346560;202103;352590;H;5229002;1;0;1
347316;202103;352590;I;5620103;0;3;-3
347609;202103;352590;H;4930202;3;2;1
347950;202103;352590;C;3321000;1;0;1
348876;202103;352590;G;4742300;1;0;1
349014;202103;352590;N;8121400;0;1;-1
349747;202103;352590;P;8592999;1;0;1
349785;202103;352590;G;4711302;0;1;-1
350109;202103;352590;G;4751201;3;2;1
350350;202103;352590;H;5250803;1;1;0
350487;202103;352590;G;4789001;1;0;1
350665;202103;352590;G;4520005;9;14;-5
351161;202103;352590;G;4781400;0;1;-1
351404;202103;352590;N;8219999;3;3;0
351518;202103;352590;G;4721104;1;1;0
351718;202103;352590;C;1813001;1;0;1
351940;202103;352590;N;7911200;1;0;1
352531;202103;352590;M;6911701;1;0;1
352603;202103;352590;F;4120400;5;5;0
352860;202103;352590;M;7319003;3;0;3
353275;202103;352590;G;4663000;4;5;-1
353654;202103;352590;N;8112500;0;1;-1
353704;202103;352590;I;5611203;0;1;-1
353947;202103;352590;F;4120400;0;1;-1
354465;202103;352590;G;4541201;0;1;-1
354538;202103;352590;Q;8711502;2;0;2
354612;202103;352590;I;5611201;2;0;2
354706;202103;352590;G;4752100;0;1;-1
354848;202103;352590;L;6821802;0;1;-1
355253;202103;352590;G;4782201;2;0;2
355506;202103;352590;F;4120400;14;4;10
355562;202103;352590;C;3250701;0;1;-1
357172;202103;352590;G;4741500;0;1;-1
357220;202103;352590;G;4771702;1;4;-3
357302;202103;352590;N;8299799;1;0;1
358323;202103;352590;G;4789099;1;1;0
358553;202103;352590;N;8211300;1;0;1
359109;202103;352590;N;8219999;1;1;0
359170;202103;352590;I;5611201;0;1;-1
359458;202103;352590;S;9609299;0;2;-2
359634;202103;352590;M;6920601;0;3;-3
360214;202103;352590;G;4752100;1;1;0
360338;202103;352590;G;4753900;1;0;1
360621;202103;352590;F;4120400;0;1;-1
360882;202103;352590;H;4930201;3;4;-1
361258;202103;352590;I;5611201;2;1;1
361457;202103;352590;S;9602501;1;0;1
361715;202103;352590;G;4789002;2;0;2
361829;202103;352590;G;4634601;0;1;-1
362273;202103;352590;I;5611201;7;0;7
362399;202103;352590;G;4789004;1;0;1
362554;202103;352590;M;7319003;1;1;0
362623;202103;352590;F;4399199;4;8;-4
362678;202103;352590;G;4530703;1;0;1
362727;202103;352590;Q;8650004;0;1;-1
362849;202103;352590;Q;8711502;0;2;-2
362886;202103;352590;G;4781400;0;1;-1
363586;202103;352590;G;4713002;1;2;-1
364335;202103;352590;H;4930201;0;1;-1
365262;202103;352590;F;4292802;0;2;-2
365435;202103;352590;G;4732600;2;0;2
365942;202103;352590;G;4642701;0;1;-1
366312;202103;352590;G;4751201;1;1;0
366733;202103;352590;G;4789004;1;0;1
366769;202103;352590;C;2823200;0;1;-1
366880;202103;352590;N;8011101;3;1;2
367626;202103;352590;N;8211300;1;0;1
367869;202103;352590;L;6822600;0;1;-1
367922;202103;352590;C;1412601;2;0;2
368872;202103;352590;G;4783101;0;2;-2
369653;202103;352590;M;7319003;1;1;0
369707;202103;352590;N;8111700;7;1;6
369760;202103;352590;G;4781400;0;1;-1
370055;202103;352590;P;8599603;1;0;1
370082;202103;352590;N;7912100;1;0;1
370254;202103;352590;N;7911200;1;3;-2
370989;202103;352590;G;4724500;1;1;0
372690;202103;352590;C;1013901;3;1;2
372800;202103;352590;S;9601701;0;1;-1
372881;202103;352590;F;4321500;1;0;1
373053;202103;352590;N;8219999;0;1;-1
373451;202103;352590;P;8599605;2;1;1
374216;202103;352590;Q;8650004;1;0;1
374339;202103;352590;K;6462000;0;1;-1
374532;202103;352590;I;5611203;0;1;-1
376309;202103;352590;G;4789099;1;0;1
376923;202103;352590;N;7911200;0;1;-1
377109;202103;352590;C;2222600;5;2;3
379491;202103;352590;G;4520001;1;1;0
379509;202103;352590;R;9313100;0;1;-1
379769;202103;352590;C;3212400;1;0;1
379906;202103;352590;N;8291100;0;1;-1
380027;202103;352590;C;2532201;0;1;-1
380210;202103;352590;P;8512100;1;0;1
380222;202103;352590;N;8112500;1;0;1
380808;202103;352590;N;8220200;209;86;123
381100;202103;352590;G;4712100;1;1;0
381646;202103;352590;F;4399103;0;3;-3
381788;202103;352590;M;6920601;2;1;1
382119;202103;352590;M;6920601;1;0;1
382407;202103;352590;D;3512300;0;1;-1
382458;202103;352590;G;4753900;0;1;-1
383515;202103;352590;I;5611203;0;1;-1
383634;202103;352590;I;5611201;0;2;-2
383720;202103;352590;H;4930202;1;0;1
384282;202103;352590;G;4789001;0;1;-1
386376;202103;352590;G;4774100;0;1;-1
386434;202103;352590;J;6204000;2;1;1
386890;202103;352590;G;4744099;1;0;1
386892;202103;352590;H;4930202;1;0;1
387700;202103;352590;I;5611203;0;1;-1
388188;202103;352590;S;9602502;1;0;1
388385;202103;352590;G;4761001;0;2;-2
388403;202103;352590;F;4330403;0;1;-1
388966;202103;352590;G;4722901;0;1;-1
389089;202103;352590;I;5611201;0;1;-1
389332;202103;352590;I;5611203;1;1;0
389406;202103;352590;J;6201501;1;0;1
389790;202103;352590;P;8593700;2;2;0
390073;202103;352590;G;4520002;0;1;-1
390136;202103;352590;N;8130300;10;6;4
390256;202103;352590;G;4652400;5;1;4
390257;202103;352590;G;4752100;0;1;-1
390382;202103;352590;G;4744002;1;0;1
390488;202103;352590;F;4321500;3;2;1
390596;202103;352590;F;4120400;175;82;93
390921;202103;352590;C;2222600;1;0;1
391479;202103;352590;M;7111100;1;0;1
392166;202103;352590;J;6209100;1;0;1
392480;202103;352590;F;4330405;9;2;7
393055;202103;352590;N;8112500;1;0;1
393322;202103;352590;G;4713002;0;2;-2
393742;202103;352590;N;8122200;1;0;1
393743;202103;352590;G;4520001;1;0;1
393746;202103;352590;H;4930201;6;1;5
393846;202103;352590;G;4721102;1;1;0
393939;202103;352590;F;4120400;4;0;4
393987;202103;352590;G;4721102;1;0;1
394683;202103;352590;G;4774100;0;1;-1
394754;202103;352590;G;4721102;2;1;1
395056;202103;352590;G;4783101;1;0;1
395134;202103;352590;G;4781400;1;0;1
395200;202103;352590;G;4781400;0;1;-1
395673;202103;352590;G;4789002;0;1;-1
395819;202103;352590;G;4754701;5;0;5
396380;202103;352590;G;4781400;0;2;-2
396590;202103;352590;M;7319003;1;0;1
397339;202103;352590;J;6201501;2;0;2
397645;202103;352590;H;4930202;7;6;1
397803;202103;352590;Q;8712300;3;5;-2
398814;202103;352590;C;2222600;2;0;2
399886;202103;352590;I;5611203;1;0;1
400611;202103;352590;H;4930201;1;0;1
400695;202103;352590;P;8550302;6;3;3
401727;202103;352590;L;6810202;1;0;1
402072;202103;352590;G;4520001;1;0;1
402080;202103;352590;H;4930201;1;0;1
402363;202103;352590;G;4752100;0;1;-1
402395;202103;352590;S;9602502;1;0;1
402967;202103;352590;N;7820500;1;8;-7
404077;202103;352590;P;8512100;2;0;2
404490;202103;352590;C;3313902;1;0;1
404654;202103;352590;G;4781400;1;0;1
404778;202103;352590;S;9601701;0;1;-1
405533;202103;352590;I;5611203;2;1;1
405560;202103;352590;G;4781400;1;1;0
406079;202103;352590;G;4731800;3;2;1
407073;202103;352590;C;2949299;0;3;-3
408197;202103;352590;N;8121400;1;1;0
408746;202103;352590;I;5611201;0;1;-1
408842;202103;352590;H;5211702;1;0;1
408933;202103;352590;N;8111700;3;2;1
409248;202103;352590;G;4669999;11;5;6
409893;202103;352590;S;9511800;2;1;1
410576;202103;352590;G;4672900;0;1;-1
411194;202103;352590;G;4754701;0;1;-1
411251;202103;352590;N;8112500;2;0;2
411983;202103;352590;H;4930202;0;1;-1
412575;202103;352590;G;4712100;2;0;2
413124;202103;352590;G;4771701;0;1;-1
414775;202103;352590;H;4930202;10;14;-4
415946;202103;352590;N;8121400;1;3;-2
416128;202103;352590;H;4930202;0;1;-1
416130;202103;352590;G;4789001;1;0;1
416154;202103;352590;P;8512100;1;1;0
416213;202103;352590;L;6821802;1;0;1
416348;202103;352590;G;4712100;0;1;-1
416579;202103;352590;N;8130300;1;2;-1
416696;202103;352590;F;4399199;2;1;1
417812;202103;352590;I;5611203;0;1;-1
417992;202103;352590;H;4930202;1;0;1
418640;202103;352590;P;8511200;0;1;-1
419073;202103;352590;N;8299799;0;1;-1
419478;202103;352590;G;4530703;1;0;1
420133;202103;352590;N;7911200;1;0;1
420514;202103;352590;G;4645101;22;7;15
420965;202103;352590;C;1099699;1;0;1
420981;202103;352590;G;4771701;0;1;-1
421326;202103;352590;H;4930202;1;0;1
421703;202103;352590;G;4741500;0;1;-1
421846;202103;352590;G;4772500;1;0;1
422073;202103;352590;I;5611203;0;1;-1
422240;202103;352590;G;4789001;0;1;-1
422753;202103;352590;G;4721102;1;0;1
422754;202103;352590;G;4721102;0;4;-4
422812;202103;352590;N;8112500;1;0;1
423122;202103;352590;N;8121400;5;2;3
423270;202103;352590;L;6822600;0;1;-1
423656;202103;352590;G;4789099;0;1;-1
424091;202103;352590;G;4744005;1;0;1
424328;202103;352590;M;6920601;0;1;-1
424954;202103;352590;M;7112000;4;0;4
425350;202103;352590;G;4618499;1;0;1
425373;202103;352590;H;5212500;13;3;10
425515;202103;352590;G;4731800;1;1;0
425618;202103;352590;C;1412601;13;6;7
425761;202103;352590;F;4321500;6;0;6
425805;202103;352590;G;4713004;2;7;-5
426478;202103;352590;N;8219999;1;0;1
426582;202103;352590;C;2950600;1;2;-1
426650;202103;352590;G;4520001;1;0;1
426880;202103;352590;G;4774100;2;0;2
427083;202103;352590;G;4752100;1;0;1
427199;202103;352590;F;4330403;0;3;-3
427784;202103;352590;F;4120400;0;1;-1
428100;202103;352590;G;4759899;1;0;1
428150;202103;352590;G;4511102;0;1;-1
428438;202103;352590;Q;8630504;0;1;-1
428472;202103;352590;C;3314719;2;0;2
428898;202103;352590;G;4731800;2;1;1
429042;202103;352590;Q;8630504;0;1;-1
429197;202103;352590;G;4649499;0;1;-1
429274;202103;352590;G;4713002;0;1;-1
429419;202103;352590;P;8599604;1;1;0
429553;202103;352590;P;8599603;1;2;-1
429705;202103;352590;M;7490104;0;1;-1
429901;202103;352590;P;8512100;1;2;-1
429903;202103;352590;M;7120100;1;0;1
430180;202103;352590;G;4729699;2;6;-4
430422;202103;352590;N;7721700;0;1;-1
430783;202103;352590;G;4789099;1;0;1
431207;202103;352590;G;4781400;0;1;-1
431417;202103;352590;N;8111700;2;0;2
431668;202103;352590;H;5223100;0;1;-1
431998;202103;352590;H;4930202;0;1;-1
432151;202103;352590;F;4291000;2;2;0
432177;202103;352590;N;8230002;1;0;1
432557;202103;352590;H;5250804;1;0;1
432638;202103;352590;Q;8630503;1;0;1
432678;202103;352590;G;4679699;0;1;-1
433178;202103;352590;C;3321000;1;0;1
433529;202103;352590;F;4120400;2;0;2
433695;202103;352590;N;8112500;1;0;1
433833;202103;352590;I;5620101;4;7;-3
433836;202103;352590;I;5620101;2;4;-2
433837;202103;352590;I;5620101;1;0;1
433840;202103;352590;I;5620101;3;0;3
433842;202103;352590;I;5620101;1;1;0
434118;202103;352590;J;6190601;0;1;-1
434940;202103;352590;S;9529105;0;1;-1
435011;202103;352590;H;5229002;0;1;-1
435316;202103;352590;G;4633801;0;1;-1
435644;202103;352590;I;5611203;0;1;-1
436249;202103;352590;G;4646001;0;1;-1
436494;202103;352590;H;5211701;12;4;8
436647;202103;352590;N;8112500;0;1;-1
437216;202103;352590;G;4712100;0;1;-1
437288;202103;352590;M;7490104;3;1;2
437555;202103;352590;F;4330404;2;0;2
437583;202103;352590;P;8512100;1;1;0
437878;202103;352590;G;4754701;1;0;1
438076;202103;352590;N;8220200;156;128;28
438079;202103;352590;N;8211300;0;6;-6
438353;202103;352590;N;8299799;1;0;1
438400;202103;352590;G;4781400;0;1;-1
438401;202103;352590;G;4781400;1;2;-1
438631;202103;352590;J;6209100;3;2;1
439392;202103;352590;G;4783101;1;1;0
439689;202103;352590;I;5611201;0;2;-2
439799;202103;352590;C;2229399;2;0;2
440940;202103;352590;H;5212500;7;1;6
441862;202103;352590;P;8599604;1;1;0
442107;202103;352590;H;4930201;34;1;33
442135;202103;352590;Q;8630502;1;1;0
442227;202103;352590;F;4221904;6;6;0
442436;202103;352590;H;4930201;1;1;0
442674;202103;352590;C;2330305;1;2;-1
443077;202103;352590;F;4330499;1;0;1
443394;202103;352590;G;4729602;1;0;1
443578;202103;352590;G;4530703;2;0;2
443579;202103;352590;G;4530703;0;1;-1
443601;202103;352590;H;4930202;1;0;1
443742;202103;352590;R;9313100;0;1;-1
444014;202103;352590;M;6920601;2;0;2
444218;202103;352590;G;4679603;3;1;2
444523;202103;352590;N;8299799;27;23;4
444589;202103;352590;F;4399103;1;0;1
444606;202103;352590;N;8111700;6;6;0
444932;202103;352590;G;4633801;5;1;4
445046;202103;352590;H;4930202;1;6;-5
445327;202103;352590;G;4530703;3;1;2
445362;202103;352590;N;7733100;1;0;1
446269;202103;352590;N;8299799;1;0;1
446364;202103;352590;G;4711302;2;1;1
447292;202103;352590;P;8599604;9;7;2
447446;202103;352590;K;6622300;0;1;-1
447565;202103;352590;G;4751201;1;0;1
447673;202103;352590;F;4321500;1;0;1
447995;202103;352590;S;9601701;2;0;2
448467;202103;352590;G;4639701;1;10;-9
448686;202103;352590;G;4520007;1;1;0
448966;202103;352590;N;8111700;4;3;1
449356;202103;352590;F;4330499;3;1;2
449651;202103;352590;G;4520004;0;1;-1
449664;202103;352590;C;1095300;3;4;-1
450377;202103;352590;G;4712100;0;1;-1
450832;202103;352590;G;4753900;3;14;-11
451441;202103;352590;G;4754701;0;1;-1
451689;202103;352590;G;4781400;0;1;-1
451725;202103;352590;G;4781400;0;1;-1
451744;202103;352590;N;8112500;1;0;1
451903;202103;352590;G;4774100;1;0;1
452035;202103;352590;N;8211300;0;1;-1
452418;202103;352590;G;4759899;0;1;-1
453867;202103;352590;C;2943300;2;2;0
454189;202103;352590;J;6209100;1;1;0
454273;202103;352590;C;2941700;2;2;0
454645;202103;352590;M;7112000;0;1;-1
454827;202103;352590;N;8211300;0;1;-1
455276;202103;352590;G;4731800;1;0;1
455323;202103;352590;F;4312600;4;0;4
455648;202103;352590;Q;8650004;1;1;0
455688;202103;352590;I;5611201;0;1;-1
455768;202103;352590;I;5611203;3;3;0
455771;202103;352590;I;5611203;1;2;-1
455772;202103;352590;I;5611203;2;0;2
455773;202103;352590;I;5611203;0;4;-4
455775;202103;352590;I;5611203;1;4;-3
456611;202103;352590;G;4781400;0;1;-1
457134;202103;352590;G;4789099;1;1;0
457494;202103;352590;G;4646001;0;3;-3
457523;202103;352590;C;3314707;0;3;-3
457591;202103;352590;G;4781400;0;2;-2
458414;202103;352590;L;6821801;1;0;1
459163;202103;352590;G;4637199;5;0;5
459499;202103;352590;J;6319400;0;1;-1
459908;202103;352590;G;4782201;1;0;1
459918;202103;352590;Q;8711502;2;0;2
461097;202103;352590;I;5611201;1;0;1
461689;202103;352590;G;4530705;0;1;-1
462088;202103;352590;G;4761003;1;0;1
462456;202103;352590;G;4722901;0;1;-1
462863;202103;352590;P;8599604;1;0;1
463013;202103;352590;C;2943300;1;0;1
463064;202103;352590;G;4754702;1;0;1
463519;202103;352590;G;4744099;1;0;1
463528;202103;352590;G;4781400;0;1;-1
463559;202103;352590;R;9313100;2;0;2
464317;202103;352590;M;6920601;1;1;0
464384;202103;352590;F;4330404;0;1;-1
464492;202103;352590;M;7112000;1;0;1
465063;202103;352590;F;4330405;0;1;-1
465192;202103;352590;P;8599603;1;0;1
465553;202103;352590;G;4781400;1;1;0
465655;202103;352590;G;4755502;1;0;1
466432;202103;352590;P;8593700;2;0;2
467892;202103;352590;G;4789099;0;1;-1
468200;202103;352590;Q;8630504;2;0;2
468458;202103;352590;C;2349499;1;0;1
468575;202103;352590;H;5250804;0;3;-3
468631;202103;352590;I;5611201;0;1;-1
468733;202103;352590;G;4722901;2;0;2
469658;202103;352590;C;2542000;1;0;1
469704;202103;352590;C;3321000;0;2;-2
469769;202103;352590;I;5620104;1;1;0
470047;202103;352590;P;8511200;0;1;-1
470173;202103;352590;G;4781400;0;1;-1
470579;202103;352590;G;4789099;0;1;-1
471174;202103;352590;C;3299003;0;1;-1
471290;202103;352590;F;4120400;0;1;-1
471335;202103;352590;G;4646001;1;0;1
471497;202103;352590;F;4313400;1;0;1
471773;202103;352590;G;4724500;1;1;0
471929;202103;352590;M;6911701;1;1;0
472458;202103;352590;C;1069400;0;2;-2
472997;202103;352590;I;5611201;0;1;-1
473759;202103;352590;Q;8630504;1;0;1
473774;202103;352590;G;4755502;1;1;0
473820;202103;352590;G;4789004;1;0;1
473981;202103;352590;I;5611201;1;1;0
474036;202103;352590;F;4321500;1;1;0
474718;202103;352590;I;5611203;0;1;-1
474727;202103;352590;N;8121400;1;0;1
474836;202103;352590;G;4729699;0;1;-1
475285;202103;352590;H;5250804;6;4;2
475558;202103;352590;G;4774100;0;1;-1
475559;202103;352590;G;4774100;1;1;0
475707;202103;352590;N;7740300;1;1;0
475807;202103;352590;C;2869100;0;3;-3
475809;202103;352590;G;4721102;1;0;1
476086;202103;352590;N;8111700;3;1;2
476181;202103;352590;J;6202300;2;1;1
476276;202103;352590;N;8011101;2;1;1
476315;202103;352590;I;5611201;0;3;-3
476325;202103;352590;H;5223100;1;0;1
476423;202103;352590;G;4759899;1;1;0
476993;202103;352590;G;4729602;1;0;1
476998;202103;352590;G;4729602;2;1;1
477147;202103;352590;G;4724500;1;0;1
477276;202103;352590;J;5811500;0;1;-1
477403;202103;352590;G;4772500;1;0;1
477631;202103;352590;I;5611201;0;1;-1
477722;202103;352590;S;9511800;0;1;-1
477978;202103;352590;G;4781400;0;1;-1
478581;202103;352590;G;4789005;0;1;-1
478792;202103;352590;F;4292802;64;10;54
479023;202103;352590;I;5611203;0;2;-2
479109;202103;352590;G;4520006;0;2;-2
479527;202103;352590;G;4721102;1;1;0
479536;202103;352590;C;1091102;0;1;-1
479848;202103;352590;Q;8630502;1;0;1
479878;202103;352590;H;4930201;1;0;1
480353;202103;352590;F;4322302;1;0;1
481010;202103;352590;M;7319003;2;1;1
481067;202103;352590;G;4722901;0;1;-1
481110;202103;352590;F;4120400;5;0;5
481765;202103;352590;G;4686902;0;1;-1
482099;202103;352590;C;3314713;1;2;-1
482123;202103;352590;Q;8630503;1;0;1
482370;202103;352590;G;4772500;1;0;1
482382;202103;352590;H;4930202;0;1;-1
482932;202103;352590;G;4789001;2;0;2
483249;202103;352590;G;4771701;0;2;-2
483250;202103;352590;G;4771701;1;0;1
483318;202103;352590;M;6920601;1;1;0
483473;202103;352590;G;4781400;0;1;-1
483764;202103;352590;F;4322301;2;0;2
483941;202103;352590;F;4330403;5;0;5
483947;202103;352590;F;4292801;0;1;-1
484333;202103;352590;H;4930202;5;3;2
485033;202103;352590;I;5611201;1;0;1
485071;202103;352590;Q;8630503;0;1;-1
486103;202103;352590;R;9321200;0;2;-2
486658;202103;352590;F;4321500;0;1;-1
487005;202103;352590;N;8111700;1;0;1
487308;202103;352590;H;4930202;10;0;10
487513;202103;352590;K;6462000;0;2;-2
487856;202103;352590;G;4789099;1;0;1
488066;202103;352590;G;4789004;1;1;0
488230;202103;352590;H;4930202;1;0;1
488715;202103;352590;M;7490104;1;2;-1
489661;202103;352590;M;7112000;3;0;3
489775;202103;352590;I;5611201;0;1;-1
490122;202103;352590;M;6911701;1;0;1
490528;202103;352590;M;6911701;0;1;-1
490549;202103;352590;F;4120400;0;1;-1
490910;202103;352590;M;6911701;1;0;1
490936;202103;352590;G;4721102;0;1;-1
491232;202103;352590;G;4722901;1;0;1
491453;202103;352590;P;8593700;0;1;-1
491627;202103;352590;C;2511000;0;2;-2
491688;202103;352590;H;5223100;1;0;1
491746;202103;352590;J;6201501;0;1;-1
491971;202103;352590;G;4687702;4;0;4
491972;202103;352590;G;4687702;0;2;-2
492039;202103;352590;G;4772500;0;1;-1
492066;202103;352590;G;4693100;0;11;-11
492420;202103;352590;G;4772500;1;0;1
492503;202103;352590;I;5611201;0;1;-1
492663;202103;352590;G;4520003;5;0;5
492701;202103;352590;N;8299799;0;2;-2
493508;202103;352590;C;2740602;1;0;1
493950;202103;352590;Q;8640202;3;2;1
493966;202103;352590;G;4711302;2;1;1
494304;202103;352590;G;4721102;0;1;-1
494378;202103;352590;N;7820500;14;5;9
495057;202103;352590;I;5611201;0;1;-1
495601;202103;352590;N;7729299;0;1;-1
495993;202103;352590;F;4120400;5;1;4
496816;202103;352590;G;4763601;0;1;-1
497220;202103;352590;I;5611201;0;1;-1
498987;202103;352590;N;7739099;0;2;-2
499195;202103;352590;H;4930202;1;2;-1
499331;202103;352590;H;4930202;3;0;3
499625;202103;352590;P;8593700;1;0;1
500007;202103;352590;M;7112000;0;3;-3
500290;202103;352590;G;4633801;4;0;4
500421;202103;352590;G;4729602;0;1;-1
500450;202103;352590;G;4649410;0;1;-1
500481;202103;352590;I;5611203;0;1;-1
501258;202103;352590;H;4930201;1;0;1
501295;202103;352590;H;5240101;1;1;0
501296;202103;352590;H;5240101;1;1;0
501441;202103;352590;R;9321200;0;4;-4
502658;202103;352590;Q;8630504;1;1;0
502850;202103;352590;F;4110700;0;2;-2
502987;202103;352590;C;1091100;3;0;3
503010;202103;352590;Q;8640202;2;1;1
503041;202103;352590;G;4789004;0;2;-2
503078;202103;352590;Q;8630504;3;4;-1
503113;202103;352590;M;7119704;0;1;-1
503795;202103;352590;G;4722901;0;1;-1
504256;202103;352590;Q;8711502;2;1;1
504348;202103;352590;F;4322303;1;0;1
504911;202103;352590;G;4721102;1;0;1
505088;202103;352590;G;4789005;0;1;-1
505628;202103;352590;N;8111700;2;11;-9
505733;202103;352590;I;5620104;1;0;1
505855;202103;352590;G;4541206;0;1;-1
505892;202103;352590;H;5223100;0;1;-1
505893;202103;352590;H;5223100;2;1;1
506052;202103;352590;J;6110803;0;1;-1
506482;202103;352590;I;5620104;3;0;3
507004;202103;352590;I;5620101;0;1;-1
507137;202103;352590;F;4120400;0;5;-5
507336;202103;352590;G;4789099;1;0;1
507478;202103;352590;G;4783102;0;1;-1
507829;202103;352590;N;8129000;3;0;3
507957;202103;352590;G;4729602;1;0;1
508547;202103;352590;P;8512100;1;0;1
508753;202103;352590;H;5212500;0;6;-6
508957;202103;352590;G;4763601;0;1;-1
509105;202103;352590;C;1053800;1;5;-4
509279;202103;352590;G;4789099;1;1;0
509280;202103;352590;G;4752100;0;1;-1
509296;202103;352590;Q;8630504;1;2;-1
509299;202103;352590;G;4729699;0;1;-1
509363;202103;352590;I;5611201;2;3;-1
509460;202103;352590;S;9511800;1;0;1
510705;202103;352590;I;5620101;1;0;1
510965;202103;352590;C;1091102;0;1;-1
511129;202103;352590;R;9313100;0;3;-3
511454;202103;352590;M;7112000;2;1;1
511497;202103;352590;I;5611203;0;1;-1
511848;202103;352590;G;4679699;1;0;1
511884;202103;352590;G;4712100;1;1;0
511981;202103;352590;M;7112000;0;1;-1
512101;202103;352590;G;4712100;0;1;-1
512453;202103;352590;G;4789099;0;2;-2
512454;202103;352590;P;8599605;1;4;-3
512653;202103;352590;J;6319400;1;0;1
514218;202103;352590;G;4772500;1;3;-2
514251;202103;352590;G;4771701;1;1;0
514311;202103;352590;I;5611203;0;1;-1
515137;202103;352590;G;4712100;0;1;-1
515351;202103;352590;I;5611203;1;0;1
515860;202103;352590;M;7112000;1;0;1
516078;202103;352590;G;4781400;1;1;0
516522;202103;352590;F;4399199;0;2;-2
516739;202103;352590;G;4781400;0;1;-1
517295;202103;352590;J;6209100;0;1;-1
517299;202103;352590;G;4781400;1;0;1
518181;202103;352590;H;5112901;3;0;3
518337;202103;352590;N;8299799;0;2;-2
519516;202103;352590;F;4330401;1;0;1
519862;202103;352590;N;8291100;4;5;-1
520022;202103;352590;G;4729699;0;3;-3
520089;202103;352590;G;4773300;1;0;1
520255;202103;352590;K;6491300;1;0;1
520690;202103;352590;S;9602501;0;1;-1
521022;202103;352590;I;5611201;0;1;-1
521337;202103;352590;P;8512100;2;0;2
521678;202103;352590;I;5611201;2;1;1
522179;202103;352590;G;4744099;5;0;5
522324;202103;352590;H;4930202;1;0;1
523381;202103;352590;N;8299799;1;1;0
524068;202103;352590;F;4321500;2;0;2
524069;202103;352590;F;4321500;0;4;-4
524134;202103;352590;I;5611203;1;0;1
524345;202103;352590;G;4723700;1;1;0
524702;202103;352590;I;5611201;0;2;-2
524866;202103;352590;J;6110803;4;1;3
525370;202103;352590;P;8512100;0;1;-1
525383;202103;352590;N;8291100;1;1;0
526571;202103;352590;S;9601703;10;7;3
526720;202103;352590;S;9491000;1;0;1
527021;202103;352590;H;4930202;10;3;7
527262;202103;352590;C;3314799;1;4;-3
527593;202103;352590;Q;8630503;2;0;2
527637;202103;352590;N;7732201;1;4;-3
528461;202103;352590;N;8111700;1;0;1
528802;202103;352590;N;8211300;0;1;-1
529440;202103;352590;C;1091102;0;1;-1
530261;202103;352590;S;9601701;1;1;0
530337;202103;352590;G;4781400;0;1;-1
530344;202103;352590;J;6202300;1;1;0
531470;202103;352590;P;8512100;1;0;1
531646;202103;352590;I;5611201;1;1;0
531769;202103;352590;M;7112000;1;1;0
532134;202103;352590;G;4712100;1;0;1
532578;202103;352590;C;1091100;2;0;2
532730;202103;352590;M;7112000;0;3;-3
533401;202103;352590;N;8211300;1;0;1
533536;202103;352590;Q;8630504;1;0;1
533617;202103;352590;I;5620101;1;1;0
533755;202103;352590;G;4711301;10;5;5
534147;202103;352590;C;2229399;1;0;1
534174;202103;352590;Q;8630504;0;1;-1
534395;202103;352590;G;4781400;1;1;0
534670;202103;352590;I;5611201;0;4;-4
534964;202103;352590;G;4679603;0;3;-3
535257;202103;352590;P;8599603;1;0;1
535797;202103;352590;G;4783101;0;2;-2
536480;202103;352590;G;4789004;1;0;1
536644;202103;352590;M;7119701;1;0;1
536796;202103;352590;M;7112000;1;0;1
537188;202103;352590;G;4711302;1;0;1
537430;202103;352590;P;8599699;0;1;-1
537537;202103;352590;I;5611201;0;1;-1
538670;202103;352590;H;4930202;0;1;-1
538882;202103;352590;G;4731800;1;2;-1
539835;202103;352590;G;4732600;1;0;1
540249;202103;352590;G;4781400;0;6;-6
540790;202103;352590;P;8513900;2;0;2
541408;202103;352590;G;4781400;1;0;1
541705;202103;352590;H;5320202;5;5;0
542785;202103;352590;P;8593700;2;0;2
543141;202103;352590;G;4782201;0;1;-1
543857;202103;352590;J;6201502;0;1;-1
544162;202103;352590;L;6821801;0;1;-1
544359;202103;352590;G;4729699;0;1;-1
544850;202103;352590;N;8111700;1;1;0
544981;202103;352590;N;7810800;5;10;-5
545258;202103;352590;N;8121400;1;9;-8
545630;202103;352590;G;4789001;1;0;1
545958;202103;352590;F;4299599;13;1;12
546308;202103;352590;G;4639701;1;14;-13
546423;202103;352590;C;2539000;0;1;-1
546460;202103;352590;G;4520001;0;1;-1
546815;202103;352590;M;6920601;1;0;1
547013;202103;352590;N;7739099;17;10;7
547141;202103;352590;G;4752100;2;4;-2
547269;202103;352590;P;8511200;0;1;-1
547351;202103;352590;Q;8650004;1;0;1
547390;202103;352590;G;4637199;8;2;6
547396;202103;352590;N;7739099;0;1;-1
548614;202103;352590;I;5620103;2;0;2
548640;202103;352590;Q;8630504;1;0;1
549305;202103;352590;P;8593700;3;0;3
549602;202103;352590;P;8599604;0;1;-1
549973;202103;352590;Q;8630503;0;1;-1
551166;202103;352590;K;6622300;1;0;1
551560;202103;352590;G;4744005;0;2;-2
551654;202103;352590;G;4729699;0;1;-1
552280;202103;352590;N;7732201;0;1;-1
553228;202103;352590;C;2222600;0;2;-2
553306;202103;352590;M;7319002;1;0;1
553840;202103;352590;H;5229099;1;2;-1
554478;202103;352590;G;4722902;1;0;1
554593;202103;352590;H;4930201;0;2;-2
555019;202103;352590;G;4724500;1;0;1
555261;202103;352590;I;5611201;0;1;-1
555604;202103;352590;G;4520003;1;0;1
555660;202103;352590;I;5620104;0;1;-1
555966;202103;352590;M;7490104;6;1;5
556052;202103;352590;I;5611203;0;1;-1
556103;202103;352590;N;8111700;2;1;1
557097;202103;352590;I;5611201;2;0;2
557229;202103;352590;S;9601701;0;1;-1
557281;202103;352590;C;2093200;3;0;3
557683;202103;352590;C;2222600;0;1;-1
557902;202103;352590;G;4713002;0;1;-1
558211;202103;352590;G;4789002;13;3;10
558345;202103;352590;G;4781400;0;2;-2
558463;202103;352590;I;5611203;1;0;1
559390;202103;352590;G;4781400;0;1;-1
559511;202103;352590;G;4741500;1;0;1
559709;202103;352590;P;8511200;1;0;1
559901;202103;352590;C;1091102;1;0;1
560138;202103;352590;G;4742300;2;0;2
560183;202103;352590;G;4763602;1;0;1
560424;202103;352590;G;4781400;3;0;3
561244;202103;352590;I;5611203;1;0;1
561916;202103;352590;P;8511200;2;0;2
561922;202103;352590;G;4712100;1;0;1
562806;202103;352590;G;4742300;0;1;-1
562891;202103;352590;C;2061400;0;1;-1
562954;202103;352590;G;4782201;0;1;-1
563197;202103;352590;P;8512100;2;0;2
563241;202103;352590;G;4711302;1;0;1
563538;202103;352590;M;7112000;3;0;3
563949;202103;352590;H;5320202;0;1;-1
564055;202103;352590;C;1099699;2;0;2
564684;202103;352590;I;5611203;1;0;1
565748;202103;352590;P;8592999;1;0;1
566389;202103;352590;P;8520100;1;0;1
567148;202103;352590;R;9313100;0;3;-3
567464;202103;352590;N;8211300;0;2;-2
567931;202103;352590;I;5611203;0;1;-1
568972;202103;352590;S;9601701;1;0;1
570809;202103;352590;N;8111700;8;1;7
571069;202103;352590;I;5611201;0;1;-1
571737;202103;352590;G;4755503;1;0;1
571765;202103;352590;N;8219999;1;6;-5
572091;202103;352590;N;8299799;0;1;-1
573368;202103;352590;M;7119701;0;1;-1
573392;202103;352590;G;4520006;3;1;2
573407;202103;352590;I;5611201;0;1;-1
574096;202103;352590;N;8211300;2;2;0
574441;202103;352590;G;4789001;1;0;1
574442;202103;352590;G;4789001;0;2;-2
574763;202103;352590;N;8230001;2;3;-1
574855;202103;352590;G;4711302;0;2;-2
575074;202103;352590;N;7722500;0;1;-1
575816;202103;352590;I;5611203;0;1;-1
576038;202103;352590;Q;8630503;1;1;0
576189;202103;352590;I;5611201;1;1;0
576244;202103;352590;I;5611201;2;1;1
576398;202103;352590;G;4753900;0;4;-4
576609;202103;352590;G;4753900;39;49;-10
576610;202103;352590;G;4753900;1;5;-4
576611;202103;352590;G;4753900;1;3;-2
576612;202103;352590;G;4753900;0;2;-2
577062;202103;352590;G;4753900;50;24;26
577089;202103;352590;G;4753900;1;0;1
577146;202103;352590;G;4753900;1;0;1
577735;202103;352590;N;7820500;53;55;-2
577804;202103;352590;G;4712100;0;1;-1
577805;202103;352590;G;4712100;0;6;-6
577905;202103;352590;J;6201501;2;0;2
578354;202103;352590;C;3101200;1;0;1
578575;202103;352590;C;1812100;0;1;-1
579101;202103;352590;G;4781400;1;0;1
579637;202103;352590;H;4930202;276;5;271
580125;202103;352590;G;4781400;0;6;-6
580197;202103;352590;G;4781400;1;8;-7
580506;202103;352590;H;4930202;0;1;-1
580894;202103;352590;G;4781400;0;1;-1
581430;202103;352590;G;4520005;0;1;-1
581670;202103;352590;I;5611201;0;1;-1
582235;202103;352590;G;4773300;1;0;1
582334;202103;352590;F;4330404;0;5;-5
582382;202103;352590;N;8020001;1;0;1
582489;202103;352590;I;5611201;1;0;1
582679;202103;352590;F;4330405;0;1;-1
582932;202103;352590;G;4742300;1;1;0
583167;202103;352590;F;4330404;3;0;3
583232;202103;352590;K;6492100;1;0;1
583614;202103;352590;C;2599399;9;6;3
585615;202103;352590;M;7500100;2;0;2
585778;202103;352590;C;3321000;1;0;1
586057;202103;352590;S;9529102;0;1;-1
586415;202103;352590;N;8211300;3;0;3
586440;202103;352590;C;2812700;4;0;4
587458;202103;352590;H;4930201;1;0;1
587558;202103;352590;C;2099199;1;0;1
588158;202103;352590;G;4729699;1;0;1
588699;202103;352590;G;4723700;1;0;1
588790;202103;352590;P;8513900;1;0;1
588845;202103;352590;I;5611201;0;2;-2
589080;202103;352590;I;5611203;2;1;1
589353;202103;352590;I;5611203;2;0;2
591159;202103;352590;P;8512100;3;0;3
591717;202103;352590;C;2391503;1;0;1
592280;202103;352590;Q;8630504;1;3;-2
592429;202103;352590;G;4721104;0;1;-1
592430;202103;352590;G;4721104;0;1;-1
592511;202103;352590;Q;8711502;1;1;0
592973;202103;352590;G;4752100;0;1;-1
595369;202103;352590;G;4784900;0;1;-1
595712;202103;352590;I;5620101;0;1;-1
596814;202103;352590;F;4299599;2;2;0
596989;202103;352590;G;4741500;1;0;1
598142;202103;352590;G;4763602;0;2;-2
598367;202103;352590;Q;8640202;7;7;0
598503;202103;352590;I;5611203;0;2;-2
598862;202103;352590;S;9602502;1;1;0
599488;202103;352590;G;4785799;0;2;-2
599557;202103;352590;F;4312600;3;0;3
599703;202103;352590;G;4781400;0;2;-2
600772;202103;352590;H;5229099;0;3;-3
601735;202103;352590;G;4781400;0;2;-2
602110;202103;352590;N;8121400;2;0;2
602706;202103;352590;C;1721400;2;1;1
602921;202103;352590;G;4789004;2;0;2
603230;202103;352590;F;4120400;0;13;-13
603491;202103;352590;G;4721102;1;3;-2
603493;202103;352590;G;4772500;0;1;-1
603999;202103;352590;I;5620103;1;1;0
604292;202103;352590;G;4669999;13;5;8
604378;202103;352590;G;4729602;0;1;-1
604515;202103;352590;I;5620104;0;5;-5
605096;202103;352590;H;4930202;1;0;1
605136;202103;352590;I;5611201;0;1;-1
606003;202103;352590;I;5611203;2;1;1
606053;202103;352590;I;5611203;0;2;-2
606854;202103;352590;C;3299003;0;2;-2
607046;202103;352590;C;2599302;4;2;2
607236;202103;352590;G;4772500;0;1;-1
608124;202103;352590;I;5611201;3;7;-4
608767;202103;352590;G;4782201;0;1;-1
608870;202103;352590;G;4771701;1;0;1
609055;202103;352590;G;4520002;1;0;1
609715;202103;352590;H;4930202;2;0;2
610564;202103;352590;C;1091102;0;2;-2
611399;202103;352590;G;4771701;2;0;2
611420;202103;352590;N;8230001;0;5;-5
611769;202103;352590;N;8211300;6;4;2
612049;202103;352590;G;4774100;0;1;-1
612269;202103;352590;G;4782201;2;0;2
612585;202103;352590;I;5611201;0;1;-1
612649;202103;352590;C;3092000;0;1;-1
612662;202103;352590;C;3314799;2;0;2
612664;202103;352590;G;4774100;0;1;-1
612740;202103;352590;G;4781400;1;0;1
613137;202103;352590;G;4721102;1;0;1
614581;202103;352590;I;5620104;1;0;1
614703;202103;352590;R;9329899;1;0;1
615160;202103;352590;G;4781400;0;1;-1
615188;202103;352590;F;4120400;3;2;1
615490;202103;352590;G;4731800;1;0;1
615520;202103;352590;R;9313100;0;1;-1
616357;202103;352590;N;8211300;3;1;2
616421;202103;352590;I;5611203;0;1;-1
616442;202103;352590;R;9319199;0;2;-2
616789;202103;352590;G;4781400;1;1;0
616790;202103;352590;G;4781400;0;2;-2
616895;202103;352590;P;8599604;1;0;1
617204;202103;352590;G;4520002;0;1;-1
617668;202103;352590;P;8541400;1;0;1
618487;202103;352590;G;4744099;1;0;1
619395;202103;352590;F;4329101;0;1;-1
619436;202103;352590;H;5320201;4;0;4
619576;202103;352590;I;5611201;0;1;-1
619855;202103;352590;I;5611203;1;0;1
620306;202103;352590;G;4754701;1;0;1
621500;202103;352590;J;6204000;2;0;2
622721;202103;352590;S;9602502;0;1;-1
623504;202103;352590;N;8111700;1;0;1
623851;202103;352590;G;4712100;1;0;1
624007;202103;352590;F;4329199;0;2;-2
624039;202103;352590;N;7739002;0;1;-1
624279;202103;352590;G;4721104;2;0;2
624632;202103;352590;G;4729699;2;0;2
624932;202103;352590;G;4781400;0;1;-1
625077;202103;352590;N;8111700;16;3;13
625095;202103;352590;C;1091102;4;0;4
626082;202103;352590;N;8291100;19;10;9
626145;202103;352590;G;4774100;3;0;3
626563;202103;352590;G;4781400;1;0;1
627520;202103;352590;F;4313400;0;1;-1
627951;202103;352590;G;4723700;1;0;1
628076;202103;352590;H;4930202;19;0;19
628628;202103;352590;Q;8711502;2;1;1
629032;202103;352590;G;4520001;1;0;1
631581;202103;352590;H;4930202;0;1;-1
631849;202103;352590;G;4721104;0;1;-1
632374;202103;352590;M;7319002;1;6;-5
632743;202103;352590;C;1091102;1;0;1
632809;202103;352590;G;4530703;3;0;3
632906;202103;352590;G;4771701;0;1;-1
633034;202103;352590;C;3329501;1;0;1
633616;202103;352590;G;4754701;2;0;2
634427;202103;352590;N;8111700;26;3;23
634580;202103;352590;F;4120400;0;1;-1
634594;202103;352590;M;7311400;0;1;-1
634631;202103;352590;G;4771701;1;0;1
634664;202103;352590;F;4399103;7;0;7
635174;202103;352590;I;5611201;0;1;-1
635913;202103;352590;G;4781400;1;1;0
636478;202103;352590;S;9602502;1;1;0
636768;202103;352590;G;4744001;2;1;1
637412;202103;352590;G;4781400;1;0;1
638110;202103;352590;I;5611203;0;2;-2
639703;202103;352590;P;8599604;1;0;1
639713;202103;352590;N;8211300;0;1;-1
640385;202103;352590;H;4930202;0;1;-1
640508;202103;352590;G;4781400;2;0;2
641184;202103;352590;G;4773300;0;1;-1
641385;202103;352590;G;4729602;1;0;1
642125;202103;352590;G;4781400;3;0;3
642329;202103;352590;Q;8630506;1;0;1
642593;202103;352590;G;4759899;12;3;9
643341;202103;352590;G;4781400;2;0;2
643536;202103;352590;G;4713002;1;0;1
643568;202103;352590;G;4781400;0;1;-1
644536;202103;352590;F;4330402;0;2;-2
645249;202103;352590;N;8291100;1;0;1
645621;202103;352590;N;8020001;3;0;3
645910;202103;352590;Q;8630506;0;1;-1
646272;202103;352590;G;4772500;1;0;1
646479;202103;352590;M;7490104;4;1;3
646502;202103;352590;I;5611203;1;0;1
646689;202103;352590;H;5320202;6;0;6
646761;202103;352590;G;4686902;1;1;0
646874;202103;352590;S;9602502;0;3;-3
646920;202103;352590;J;6209100;4;4;0
647143;202103;352590;S;9602502;1;0;1
647378;202103;352590;I;5611201;0;1;-1
647428;202103;352590;C;2539001;0;1;-1
647852;202103;352590;Q;8630503;1;1;0
648156;202103;352590;C;1091102;0;1;-1
648498;202103;352590;I;5611204;1;2;-1
648518;202103;352590;G;4530703;2;2;0
648742;202103;352590;I;5611203;0;1;-1
648753;202103;352590;N;7719502;2;0;2
649887;202103;352590;G;4782201;1;1;0
651017;202103;352590;F;4222701;0;1;-1
651223;202103;352590;G;4530703;1;0;1
651225;202103;352590;G;4713001;0;2;-2
651246;202103;352590;I;5611201;1;0;1
652182;202103;352590;G;4759899;1;0;1
652707;202103;352590;N;8299706;1;0;1
652807;202103;352590;P;8599604;1;0;1
653292;202103;352590;M;6911701;1;0;1
653617;202103;352590;P;8593700;1;1;0
653815;202103;352590;G;4729699;0;1;-1
654381;202103;352590;G;4744005;2;1;1
655590;202103;352590;G;4781400;0;1;-1
656558;202103;352590;Q;8630504;0;2;-2
656628;202103;352590;I;5620104;2;0;2
657458;202103;352590;N;8292000;0;1;-1
658030;202103;352590;I;5611201;3;2;1
658076;202103;352590;I;5611203;0;1;-1
658148;202103;352590;G;4771701;1;0;1
658381;202103;352590;G;4635499;2;0;2
659443;202103;352590;G;4729699;5;0;5
659775;202103;352590;G;4789003;1;0;1
660787;202103;352590;S;9609208;1;0;1
660885;202103;352590;G;4633801;1;0;1
661065;202103;352590;I;5611203;0;1;-1
661154;202103;352590;S;9602502;1;0;1
661554;202103;352590;I;5611203;1;0;1
662005;202103;352590;G;4743100;1;0;1
662494;202103;352590;N;8020001;1;0;1
663490;202103;352590;G;4669999;4;1;3
663491;202103;352590;C;1094500;1;2;-1
663753;202103;352590;G;4729699;0;1;-1
664296;202103;352590;I;5611203;3;1;2
665107;202103;352590;M;7020400;1;0;1
665334;202103;352590;J;6120501;0;1;-1
665418;202103;352590;J;6141800;0;2;-2
666100;202103;352590;H;4930202;1;0;1
666362;202103;352590;Q;8630504;1;0;1
666905;202103;352590;F;4399105;1;0;1
667278;202103;352590;G;4772500;4;0;4
667511;202103;352590;N;8299799;2;0;2
668854;202103;352590;G;4774100;1;0;1
669526;202103;352590;I;5611203;3;1;2
669634;202103;352590;I;5510801;3;0;3
669840;202103;352590;I;5620104;3;0;3
670488;202103;352590;C;3319800;1;0;1
670712;202103;352590;N;8111700;9;1;8
671912;202103;352590;H;4930202;1;0;1
674003;202103;352590;I;5611203;0;2;-2
674102;202103;352590;C;1062700;9;1;8
674103;202103;352590;C;1062700;5;3;2
674752;202103;352590;C;1813099;0;4;-4
674966;202103;352590;H;5222200;0;1;-1
675204;202103;352590;G;4774100;2;0;2
675312;202103;352590;C;2091600;1;1;0
675755;202103;352590;P;8513900;2;1;1
675927;202103;352590;F;4313400;1;0;1
675964;202103;352590;G;4753900;0;1;-1
675974;202103;352590;G;4753900;0;1;-1
676029;202103;352590;H;4930202;2;0;2
676035;202103;352590;F;4120400;7;6;1
676228;202103;352590;G;4772500;0;1;-1
676247;202103;352590;C;2019399;6;1;5
676323;202103;352590;C;2543800;0;1;-1
676324;202103;352590;C;2599399;2;4;-2
676325;202103;352590;C;2599399;2;4;-2
676499;202103;352590;C;2710402;23;14;9
676543;202103;352590;G;4789099;0;1;-1
676651;202103;352590;L;6822600;0;1;-1
677236;202103;352590;G;4744005;1;1;0
677237;202103;352590;S;9430800;1;3;-2
677238;202103;352590;M;6920601;0;1;-1
677239;202103;352590;S;9430800;2;1;1
677242;202103;352590;K;6550200;1;0;1
677243;202103;352590;C;1091100;0;4;-4
677245;202103;352590;K;6550200;20;18;2
677261;202103;352590;K;6550200;1;1;0
677311;202103;352590;K;6550200;1;1;0
677352;202103;352590;F;4399105;3;1;2
677353;202103;352590;S;9430800;0;1;-1
677354;202103;352590;G;4789099;1;0;1
677355;202103;352590;C;3313901;1;0;1
677356;202103;352590;I;5611201;2;0;2
677357;202103;352590;S;9529199;1;0;1
677359;202103;352590;G;4755502;1;0;1
677360;202103;352590;R;9312300;0;1;-1
677525;202103;352590;C;2013402;5;2;3
677526;202103;352590;C;2013402;5;3;2
678199;202103;352590;G;4781400;2;6;-4
678356;202103;352590;G;4781400;2;1;1
678821;202103;352590;G;4782201;1;3;-2
678822;202103;352590;G;4782201;1;5;-4
678825;202103;352590;G;4782201;1;2;-1
678827;202103;352590;G;4782201;1;3;-2
678828;202103;352590;G;4782201;4;12;-8
678829;202103;352590;G;4782201;1;0;1
678913;202103;352590;G;4711301;4;10;-6
679048;202103;352590;G;4731800;4;4;0
679195;202103;352590;G;4771701;3;1;2
679270;202103;352590;I;5510803;0;1;-1
679456;202103;352590;C;2821601;1;1;0
679468;202103;352590;G;4672900;1;0;1
679469;202103;352590;G;4713002;0;1;-1
679473;202103;352590;O;8411600;69;9;60
679789;202103;352590;G;4530705;1;2;-1
680147;202103;352590;C;3250705;5;3;2
680315;202103;352590;C;2063100;7;9;-2
680335;202103;352590;C;2651500;2;8;-6
680401;202103;352590;G;4781400;2;1;1
680485;202103;352590;G;4646001;1;0;1
680515;202103;352590;H;4930202;0;1;-1
680778;202103;352590;I;5510801;2;0;2
680779;202103;352590;P;8599601;0;1;-1
680794;202103;352590;G;4744002;2;3;-1
680813;202103;352590;Q;8630504;0;1;-1
680816;202103;352590;H;4930202;1;0;1
680817;202103;352590;G;4639701;4;6;-2
680842;202103;352590;G;4754701;2;1;1
680843;202103;352590;H;4929902;2;0;2
681069;202103;352590;C;2342702;1;1;0
681098;202103;352590;G;4781400;2;1;1
681793;202103;352590;G;4711302;2;1;1
682239;202103;352590;G;4711302;4;2;2
682563;202103;352590;Q;8640202;0;1;-1
682566;202103;352590;Q;8690999;1;1;0
682581;202103;352590;Q;8640299;1;1;0
682586;202103;352590;Q;8640202;2;1;1
682767;202103;352590;F;4110700;1;0;1
682861;202103;352590;G;4789002;0;1;-1
682862;202103;352590;G;4637107;2;3;-1
682864;202103;352590;G;4711302;1;0;1
683142;202103;352590;G;4713004;2;4;-2
683448;202103;352590;G;4713004;1;0;1
684516;202103;352590;G;4712100;1;0;1
684531;202103;352590;H;4921301;12;4;8
684802;202103;352590;G;4731800;1;0;1
685398;202103;352590;H;5211799;1;0;1
685434;202103;352590;G;4731800;1;0;1
685487;202103;352590;Q;8640205;6;3;3
685547;202103;352590;C;2229399;2;1;1
685666;202103;352590;M;6920601;0;2;-2
685667;202103;352590;G;4712100;0;1;-1
685744;202103;352590;G;4784900;0;1;-1
685747;202103;352590;G;4731800;1;0;1
685793;202103;352590;G;4781400;1;1;0
685833;202103;352590;G;4741500;0;1;-1
686183;202103;352590;I;5620101;0;1;-1
686274;202103;352590;I;5620101;0;1;-1
686309;202103;352590;I;5620101;1;3;-2
686370;202103;352590;I;5620101;0;1;-1
686476;202103;352590;I;5620101;1;1;0
686608;202103;352590;I;5620101;0;1;-1
686627;202103;352590;I;5620101;1;1;0
686731;202103;352590;I;5620101;1;0;1
686735;202103;352590;I;5620101;1;0;1
686762;202103;352590;I;5620101;5;1;4
686894;202103;352590;G;4772500;1;0;1
686904;202103;352590;G;4511102;0;1;-1
686905;202103;352590;Q;8630503;1;0;1
686909;202103;352590;C;1813099;13;11;2
686910;202103;352590;M;6920601;2;1;1
686911;202103;352590;P;8599601;0;2;-2
686912;202103;352590;G;4530703;2;1;1
686991;202103;352590;P;8599699;10;14;-4
687005;202103;352590;R;9313100;0;1;-1
687028;202103;352590;G;4755503;0;1;-1
687381;202103;352590;G;4744005;1;1;0
687385;202103;352590;C;1330800;37;34;3
687767;202103;352590;K;6550200;5;1;4
687768;202103;352590;K;6550200;0;1;-1
687770;202103;352590;K;6550200;1;0;1
687771;202103;352590;K;6550200;19;10;9
687772;202103;352590;K;6550200;0;1;-1
687984;202103;352590;F;4120400;1;1;0
687985;202103;352590;G;4731800;2;0;2
688019;202103;352590;H;4921301;3;9;-6
688024;202103;352590;C;1623400;0;2;-2
688026;202103;352590;C;1122401;3;0;3
688027;202103;352590;C;1081302;0;1;-1
688029;202103;352590;C;1112700;3;3;0
688031;202103;352590;G;4783101;1;0;1
688032;202103;352590;G;4744099;3;1;2
688033;202103;352590;C;1112700;0;1;-1
688035;202103;352590;G;4763602;1;2;-1
688036;202103;352590;G;4731800;1;1;0
688039;202103;352590;P;8513900;31;7;24
688040;202103;352590;G;4511101;1;3;-2
688041;202103;352590;C;2229302;2;4;-2
688044;202103;352590;R;9312300;1;1;0
688048;202103;352590;C;1033301;1;1;0
688049;202103;352590;C;2219600;5;1;4
688051;202103;352590;G;4689399;0;2;-2
688052;202103;352590;G;4783101;0;1;-1
688053;202103;352590;C;1629301;3;10;-7
688055;202103;352590;G;4729699;1;0;1
688057;202103;352590;K;6622300;6;11;-5
688060;202103;352590;G;4511104;2;1;1
688061;202103;352590;G;4530703;2;1;1
688062;202103;352590;G;4530705;1;1;0
688063;202103;352590;C;2212900;2;1;1
688064;202103;352590;G;4530703;0;1;-1
688068;202103;352590;H;4929902;7;1;6
688070;202103;352590;Q;8610101;54;39;15
688071;202103;352590;G;4541203;1;0;1
688072;202103;352590;C;1091101;1;0;1
688080;202103;352590;G;4731800;1;1;0
688081;202103;352590;G;4711302;1;4;-3
688083;202103;352590;G;4711302;0;13;-13
688086;202103;352590;G;4711302;0;3;-3
688088;202103;352590;G;4711302;2;6;-4
688090;202103;352590;G;4711302;4;13;-9
688091;202103;352590;G;4711302;0;1;-1
688092;202103;352590;G;4711302;9;17;-8
688093;202103;352590;G;4711302;0;1;-1
688095;202103;352590;G;4711302;2;10;-8
688096;202103;352590;G;4639701;60;1;59
688098;202103;352590;G;4711302;3;6;-3
688100;202103;352590;G;4711302;2;1;1
688102;202103;352590;G;4711302;2;1;1
688103;202103;352590;G;4711302;3;1;2
688104;202103;352590;G;4711302;1;9;-8
688105;202103;352590;H;4921301;3;1;2
688106;202103;352590;C;1311100;30;16;14
688108;202103;352590;J;6010100;2;0;2
688109;202103;352590;C;2229301;9;16;-7
688110;202103;352590;C;2229301;3;23;-20
688111;202103;352590;C;2229301;2;27;-25
688112;202103;352590;C;2229301;1;5;-4
688115;202103;352590;Q;8730102;3;0;3
688116;202103;352590;Q;8730102;1;0;1
688124;202103;352590;G;4511101;3;2;1
688131;202103;352590;S;9430800;2;3;-1
688132;202103;352590;M;7112000;2;1;1
688133;202103;352590;C;1813099;2;3;-1
688134;202103;352590;G;4721102;0;1;-1
688139;202103;352590;Q;8610101;3;1;2
688140;202103;352590;S;9430800;1;0;1
688142;202103;352590;G;4771701;0;1;-1
688143;202103;352590;S;9430800;0;1;-1
688144;202103;352590;M;6920601;0;1;-1
688146;202103;352590;Q;8610101;14;12;2
688147;202103;352590;P;8599601;1;0;1
688148;202103;352590;Q;8800600;0;1;-1
688149;202103;352590;M;6920601;1;1;0
688150;202103;352590;C;2342702;2;1;1
688159;202103;352590;Q;8711502;2;3;-1
688161;202103;352590;G;4744099;1;1;0
688167;202103;352590;H;4930202;0;1;-1
688172;202103;352590;G;4711302;12;5;7
688173;202103;352590;G;4711302;6;5;1
688174;202103;352590;G;4711302;4;4;0
688175;202103;352590;G;4711302;5;2;3
688177;202103;352590;G;4711302;2;2;0
688179;202103;352590;G;4731800;1;0;1
688187;202103;352590;S;9420100;1;0;1
688190;202103;352590;S;9491000;1;0;1
688191;202103;352590;S;9491000;0;1;-1
688199;202103;352590;G;4633801;5;4;1
688200;202103;352590;H;4929902;0;1;-1
688206;202103;352590;I;5611203;0;1;-1
688207;202103;352590;S;9491000;2;0;2
688261;202103;352590;C;1053800;0;1;-1
688470;202103;352590;N;8211300;1;2;-1
688546;202103;352590;N;8299706;1;0;1
688547;202103;352590;M;6920601;0;1;-1
688552;202103;352590;P;8513900;2;2;0
688553;202103;352590;G;4687703;4;0;4
688555;202103;352590;G;4541203;0;1;-1
688570;202103;352590;C;2071100;5;2;3
688871;202103;352590;C;1013901;0;4;-4
689218;202103;352590;G;4744099;2;1;1
689354;202103;352590;F;4120400;1;0;1
689355;202103;352590;Q;8640202;1;2;-1
689356;202103;352590;Q;8640202;3;0;3
689357;202103;352590;Q;8640202;5;3;2
689358;202103;352590;Q;8640201;2;1;1
689361;202103;352590;Q;8640202;1;0;1
689364;202103;352590;Q;8650004;3;2;1
689365;202103;352590;Q;8640202;1;6;-5
689366;202103;352590;Q;8640202;1;1;0
689368;202103;352590;Q;8640202;1;4;-3
689369;202103;352590;Q;8640202;1;0;1
689372;202103;352590;Q;8650099;0;1;-1
689402;202103;352590;Q;8610101;12;4;8
689438;202103;352590;P;8520100;1;0;1
689439;202103;352590;S;9499500;2;0;2
689448;202103;352590;G;4647801;0;1;-1
689449;202103;352590;P;8511200;0;1;-1
689532;202103;352590;C;1622699;1;0;1
689569;202103;352590;H;5112901;5;0;5
689720;202103;352590;C;3250707;6;4;2
689810;202103;352590;C;2342702;9;3;6
689824;202103;352590;G;4661300;9;9;0
689918;202103;352590;I;5611201;2;1;1
690000;202103;352590;N;8112500;1;1;0
690001;202103;352590;P;8512100;2;1;1
690020;202103;352590;N;7820500;3;7;-4
690083;202103;352590;G;4639701;0;2;-2
690103;202103;352590;G;4744099;1;1;0
690127;202103;352590;H;4930202;3;5;-2
690145;202103;352590;G;4782201;0;1;-1
690320;202103;352590;H;4930202;0;3;-3
690380;202103;352590;G;4771702;7;4;3
690381;202103;352590;N;8211300;3;3;0
690470;202103;352590;G;4755502;0;1;-1
690473;202103;352590;I;5611201;1;1;0
690567;202103;352590;G;4530703;1;1;0
690727;202103;352590;G;4721102;1;1;0
690754;202103;352590;C;1031700;9;4;5
691172;202103;352590;G;4789004;1;0;1
691411;202103;352590;G;4669999;7;6;1
691768;202103;352590;G;4722901;0;1;-1
691817;202103;352590;G;4731800;1;0;1
691930;202103;352590;G;4663000;1;0;1
692043;202103;352590;G;4761003;0;1;-1
692306;202103;352590;S;9529199;0;1;-1
692335;202103;352590;G;4520006;2;0;2
692383;202103;352590;H;4930201;1;0;1
692425;202103;352590;G;4781400;0;1;-1
692463;202103;352590;G;4781400;0;1;-1
692578;202103;352590;G;4732600;1;0;1
692722;202103;352590;Q;8640203;0;11;-11
692759;202103;352590;G;4530705;0;1;-1
692783;202103;352590;H;4930202;2;0;2
692785;202103;352590;Q;8711501;0;1;-1
692787;202103;352590;N;8112500;0;3;-3
692789;202103;352590;M;7112000;0;3;-3
692793;202103;352590;S;9420100;1;1;0
692794;202103;352590;P;8513900;3;3;0
692796;202103;352590;P;8512100;0;1;-1
692865;202103;352590;I;5620101;0;1;-1
692919;202103;352590;G;4712100;1;1;0
692974;202103;352590;I;5611203;0;1;-1
693032;202103;352590;C;3314799;0;1;-1
693587;202103;352590;G;4712100;3;1;2
693588;202103;352590;G;4712100;1;1;0
693737;202103;352590;L;6810202;1;0;1
693872;202103;352590;G;4530703;0;1;-1
693873;202103;352590;N;7732201;0;1;-1
693874;202103;352590;Q;8690999;1;0;1
693875;202103;352590;Q;8630502;0;1;-1
693878;202103;352590;N;8112500;0;2;-2
693942;202103;352590;G;4511101;2;1;1
693944;202103;352590;G;4530703;0;1;-1
693950;202103;352590;I;5620101;1;1;0
694025;202103;352590;C;1093702;1;0;1
694072;202103;352590;F;4322301;0;5;-5
694554;202103;352590;F;4399199;1;0;1
694561;202103;352590;G;4789002;0;1;-1
694666;202103;352590;H;4923002;1;1;0
694729;202103;352590;C;2821602;1;4;-3
694939;202103;352590;F;4222701;0;1;-1
695151;202103;352590;G;4774100;1;0;1
695241;202103;352590;F;4313400;0;1;-1
695247;202103;352590;C;2829199;0;1;-1
695296;202103;352590;B;810006;0;1;-1
695380;202103;352590;G;4771702;1;0;1
695386;202103;352590;G;4712100;0;1;-1
695398;202103;352590;G;4649499;1;1;0
695409;202103;352590;C;2823200;1;0;1
695413;202103;352590;C;3101200;0;2;-2
695500;202103;352590;G;4661300;5;0;5
695644;202103;352590;H;4930203;0;1;-1
695990;202103;352590;G;4721102;0;1;-1
695993;202103;352590;I;5510803;0;1;-1
696249;202103;352590;G;4781400;0;2;-2
696408;202103;352590;G;4761003;0;1;-1
696552;202103;352590;G;4753900;0;1;-1
696603;202103;352590;I;5510801;1;1;0
696693;202103;352590;K;6550200;1;1;0
696694;202103;352590;Q;8630502;2;1;1
696695;202103;352590;Q;8610102;5;4;1
696696;202103;352590;Q;8610101;11;8;3
696942;202103;352590;G;4761003;1;2;-1
697407;202103;352590;G;4731800;1;0;1
697437;202103;352590;C;3314708;1;3;-2
697547;202103;352590;G;4789001;1;0;1
697659;202103;352590;B;810007;2;0;2
697703;202103;352590;G;4774100;0;1;-1
697738;202103;352590;G;4763602;0;2;-2
698066;202103;352590;H;4930202;5;3;2
698111;202103;352590;G;4530703;0;1;-1
698137;202103;352590;F;4313400;2;0;2
698197;202103;352590;K;6493000;0;1;-1
698295;202103;352590;C;2099199;2;4;-2
698390;202103;352590;C;2539002;1;1;0
698396;202103;352590;C;2592602;4;3;1
698501;202103;352590;H;4930202;6;4;2
698526;202103;352590;C;1094500;1;1;0
698705;202103;352590;K;6493000;3;0;3
698889;202103;352590;K;6422100;1;0;1
698936;202103;352590;J;6204000;0;1;-1
699007;202103;352590;G;4712100;1;0;1
699069;202103;352590;I;5611201;0;2;-2
699157;202103;352590;I;5611201;0;1;-1
699233;202103;352590;I;5611203;0;3;-3
699252;202103;352590;S;9420100;0;1;-1
699269;202103;352590;N;8121400;3;2;1
699271;202103;352590;N;8112500;1;1;0
699272;202103;352590;H;5223100;0;1;-1
699273;202103;352590;H;5223100;1;2;-1
699274;202103;352590;P;8512100;1;0;1
699275;202103;352590;N;8112500;2;1;1
699276;202103;352590;P;8512100;1;0;1
699477;202103;352590;G;4761003;1;2;-1
699556;202103;352590;G;4789099;1;1;0
699612;202103;352590;F;4221902;12;2;10
699666;202103;352590;H;4929902;13;12;1
699693;202103;352590;I;5611201;1;2;-1
699694;202103;352590;I;5611201;0;2;-2
699930;202103;352590;G;4635402;12;15;-3
700036;202103;352590;C;2229399;38;19;19
700059;202103;352590;H;4930202;2;4;-2
700102;202103;352590;Q;8640205;1;4;-3
700106;202103;352590;I;5510801;0;1;-1
700148;202103;352590;S;9499500;1;1;0
700149;202103;352590;P;8512100;3;0;3
700150;202103;352590;P;8512100;2;0;2
700160;202103;352590;Q;8640202;1;2;-1
700161;202103;352590;S;9430800;0;4;-4
700288;202103;352590;C;2944100;20;129;-109
700324;202103;352590;C;1629301;5;1;4
700464;202103;352590;I;5510803;0;1;-1
700763;202103;352590;G;4520001;2;1;1
700782;202103;352590;F;4292802;2;9;-7
700889;202103;352590;H;4930202;1;0;1
700929;202103;352590;G;4721102;0;1;-1
700931;202103;352590;C;2539001;0;1;-1
700951;202103;352590;K;6550200;1;2;-1
701076;202103;352590;E;3839401;1;0;1
701284;202103;352590;N;7732201;0;1;-1
701311;202103;352590;G;4741500;3;0;3
701363;202103;352590;F;4120400;0;1;-1
701544;202103;352590;G;4731800;1;0;1
701581;202103;352590;C;1314600;2;1;1
701582;202103;352590;G;4530703;0;1;-1
701768;202103;352590;G;4744005;0;1;-1
701794;202103;352590;G;4672900;1;0;1
702153;202103;352590;G;4743100;0;1;-1
702417;202103;352590;C;2032100;2;1;1
702554;202103;352590;M;7210000;3;2;1
702569;202103;352590;G;4530701;0;3;-3
702589;202103;352590;G;4771701;0;1;-1
702694;202103;352590;C;2522500;3;10;-7
702994;202103;352590;Q;8610101;5;7;-2
703049;202103;352590;C;2014200;3;2;1
703181;202103;352590;G;4530703;2;2;0
703188;202103;352590;C;1412601;3;1;2
703198;202103;352590;C;2599399;1;0;1
703199;202103;352590;C;2599399;1;1;0
703257;202103;352590;K;6422100;3;0;3
703513;202103;352590;K;6422100;1;0;1
703583;202103;352590;K;6422100;1;0;1
703590;202103;352590;K;6422100;0;1;-1
703712;202103;352590;K;6422100;0;1;-1
703938;202103;352590;K;6422100;0;1;-1
703939;202103;352590;K;6422100;1;0;1
704405;202103;352590;K;6422100;0;2;-2
704706;202103;352590;K;6422100;0;1;-1
704712;202103;352590;K;6422100;0;1;-1
705186;202103;352590;Q;8690999;2;0;2
705187;202103;352590;Q;8690999;2;0;2
705285;202103;352590;G;4744005;3;0;3
705293;202103;352590;G;4511104;0;2;-2
705329;202103;352590;C;2539002;2;2;0
705334;202103;352590;C;2815101;0;1;-1
705390;202103;352590;B;810099;0;2;-2
705391;202103;352590;C;2330302;0;2;-2
705500;202103;352590;P;8513900;1;0;1
705739;202103;352590;G;4633802;1;0;1
705810;202103;352590;G;4530703;0;1;-1
705938;202103;352590;Q;8800600;0;1;-1
706032;202103;352590;C;3104700;0;1;-1
706038;202103;352590;P;8513900;0;1;-1
706039;202103;352590;Q;8711502;0;1;-1
706040;202103;352590;P;8511200;0;1;-1
706161;202103;352590;Q;8640212;3;0;3
706203;202103;352590;S;9491000;7;1;6
706251;202103;352590;C;2599399;10;1;9
706475;202103;352590;H;4922102;0;1;-1
706476;202103;352590;H;4922102;0;2;-2
706551;202103;352590;C;2949299;5;0;5
706552;202103;352590;C;2949299;12;4;8
706635;202103;352590;G;4713004;0;1;-1
706924;202103;352590;G;4713004;0;3;-3
706970;202103;352590;G;4646001;1;1;0
706971;202103;352590;G;4646001;1;0;1
707162;202103;352590;C;2591800;23;11;12
707240;202103;352590;G;4635402;8;4;4
707247;202103;352590;C;1122401;28;14;14
707434;202103;352590;C;1721400;4;1;3
707438;202103;352590;G;4647801;2;2;0
707488;202103;352590;C;3299002;0;4;-4
707568;202103;352590;G;4711302;8;3;5
708109;202103;352590;G;4771701;1;1;0
708150;202103;352590;G;4771701;0;1;-1
708395;202103;352590;G;4771701;1;1;0
708531;202103;352590;C;2949299;12;5;7
708605;202103;352590;G;4645101;1;0;1
708950;202103;352590;N;8211300;11;6;5
709107;202103;352590;C;1411801;40;22;18
709323;202103;352590;G;4771701;1;0;1
709450;202103;352590;G;4771701;1;1;0
709655;202103;352590;G;4771701;1;1;0
709779;202103;352590;G;4771701;0;1;-1
709824;202103;352590;G;4771701;0;1;-1
709842;202103;352590;G;4771701;1;0;1
709900;202103;352590;G;4771701;2;0;2
709916;202103;352590;G;4771701;0;2;-2
710154;202103;352590;G;4771701;0;3;-3
710232;202103;352590;G;4771701;2;2;0
710245;202103;352590;G;4771701;1;2;-1
710356;202103;352590;G;4771701;0;2;-2
710375;202103;352590;G;4771701;2;0;2
710495;202103;352590;G;4771701;0;1;-1
710499;202103;352590;G;4771701;1;0;1
710678;202103;352590;Q;8800600;33;19;14
710711;202103;352590;Q;8800600;0;1;-1
711012;202103;352590;N;8211300;1;0;1
711013;202103;352590;M;6920601;1;0;1
711014;202103;352590;J;6202300;0;1;-1
711018;202103;352590;N;8121400;61;20;41
711140;202103;352590;G;4782202;2;2;0
711733;202103;352590;G;4741500;0;1;-1
712086;202103;352590;G;4759899;0;3;-3
712234;202103;352590;C;2592601;1;0;1
712317;202103;352590;G;4637107;2;1;1
712371;202103;352590;F;4321500;0;2;-2
712797;202103;352590;I;5611203;0;1;-1
713075;202103;352590;Q;8800600;3;0;3
713129;202103;352590;P;8541400;1;0;1
713335;202103;352590;G;4789002;7;1;6
713350;202103;352590;C;2229301;2;5;-3
713529;202103;352590;G;4744099;1;0;1
713559;202103;352590;G;4530701;2;1;1
713615;202103;352590;G;4755503;0;1;-1
714629;202103;352590;J;6204000;0;1;-1
714639;202103;352590;J;6209100;5;3;2
714650;202103;352590;Q;8660700;33;11;22
714775;202103;352590;G;4771701;1;0;1
714789;202103;352590;H;4930202;0;1;-1
714819;202103;352590;G;4731800;0;1;-1
714821;202103;352590;P;8513900;2;0;2
714825;202103;352590;F;4120400;2;0;2
715256;202103;352590;G;4712100;0;1;-1
715436;202103;352590;G;4789099;1;0;1
715533;202103;352590;F;4120400;1;1;0
715540;202103;352590;C;3314710;11;2;9
715589;202103;352590;G;4731800;0;4;-4
715590;202103;352590;G;4731800;0;1;-1
715626;202103;352590;G;4782201;1;1;0
715855;202103;352590;I;5510803;1;1;0
716675;202103;352590;G;4663000;1;0;1
716706;202103;352590;H;4930202;1;0;1
716724;202103;352590;F;4330401;1;0;1
716746;202103;352590;G;4530701;0;1;-1
716780;202103;352590;J;6202300;7;3;4
716823;202103;352590;G;4789099;0;1;-1
716842;202103;352590;G;4721102;1;0;1
716845;202103;352590;G;4530703;1;0;1
716861;202103;352590;G;4755502;0;1;-1
717042;202103;352590;G;4711302;38;25;13
717093;202103;352590;C;1099699;0;1;-1
717207;202103;352590;F;4211101;1;0;1
717239;202103;352590;P;8512100;1;0;1
717240;202103;352590;N;8112500;2;0;2
717262;202103;352590;G;4783101;0;3;-3
717322;202103;352590;G;4530703;1;0;1
717333;202103;352590;G;4771702;0;1;-1
717976;202103;352590;G;4684201;2;1;1
718050;202103;352590;N;7739099;4;6;-2
718067;202103;352590;I;5611203;0;2;-2
718068;202103;352590;I;5611203;2;6;-4
718205;202103;352590;G;4789099;1;1;0
718775;202103;352590;N;8111700;11;33;-22
718798;202103;352590;P;8512100;4;0;4
718799;202103;352590;N;8112500;0;1;-1
718800;202103;352590;N;8112500;1;0;1
718801;202103;352590;Q;8690999;0;2;-2
718810;202103;352590;N;8112500;1;0;1
718811;202103;352590;P;8513900;0;1;-1
718813;202103;352590;Q;8630502;0;2;-2
718814;202103;352590;N;8112500;1;0;1
718816;202103;352590;Q;8630501;0;1;-1
718817;202103;352590;N;8112500;1;1;0
718818;202103;352590;N;8121400;1;3;-2
718819;202103;352590;N;8112500;0;1;-1
718820;202103;352590;Q;8640207;2;2;0
718899;202103;352590;G;4771701;2;1;1
718900;202103;352590;G;4771701;1;1;0
718930;202103;352590;H;4930202;0;1;-1
718937;202103;352590;C;2731700;1;1;0
718992;202103;352590;G;4744005;0;1;-1
719210;202103;352590;C;2014200;7;3;4
719234;202103;352590;G;4711302;1;0;1
719235;202103;352590;C;1013901;0;2;-2
719316;202103;352590;F;4120400;3;1;2
719317;202103;352590;F;4120400;14;6;8
719357;202103;352590;C;2222600;1;2;-1
719468;202103;352590;F;4120400;2;3;-1
719570;202103;352590;G;4729699;0;2;-2
719672;202103;352590;G;4520001;0;1;-1
719685;202103;352590;G;4789099;1;0;1
719729;202103;352590;C;2229399;0;3;-3
719993;202103;352590;I;5620101;1;0;1
720030;202103;352590;I;5620101;1;0;1
720382;202103;352590;I;5611201;2;0;2
720414;202103;352590;G;4744005;3;0;3
720427;202103;352590;S;9521500;1;0;1
720456;202103;352590;G;4623199;6;0;6
720473;202103;352590;H;4930202;1;2;-1
720492;202103;352590;C;2599399;1;0;1
720615;202103;352590;M;7020400;1;0;1
720653;202103;352590;G;4789001;0;1;-1
720899;202103;352590;I;5611203;0;1;-1
720909;202103;352590;G;4520007;0;1;-1
720974;202103;352590;G;4520001;0;1;-1
721763;202103;352590;G;4530703;0;1;-1
721786;202103;352590;G;4755501;1;0;1
721787;202103;352590;G;4712100;0;1;-1
721911;202103;352590;J;6203100;10;3;7
721955;202103;352590;G;4751201;2;0;2
722019;202103;352590;G;4637199;3;0;3
722065;202103;352590;C;2543800;5;2;3
722086;202103;352590;C;2330302;3;1;2
722262;202103;352590;G;4712100;1;1;0
722272;202103;352590;G;4712100;0;1;-1
722433;202103;352590;G;4771702;5;1;4
724347;202103;352590;C;2229301;38;28;10
724597;202103;352590;F;4110700;1;0;1
724598;202103;352590;F;4110700;2;1;1
724670;202103;352590;N;7739099;1;0;1
724686;202103;352590;C;3314710;2;0;2
724773;202103;352590;G;4771701;1;1;0
724795;202103;352590;I;5611201;1;0;1
724864;202103;352590;S;9602502;1;1;0
724931;202103;352590;G;4744005;0;1;-1
725010;202103;352590;G;4744005;1;0;1
725055;202103;352590;G;4741500;2;1;1
725057;202103;352590;G;4741500;1;0;1
725059;202103;352590;G;4741500;2;0;2
725060;202103;352590;G;4741500;1;0;1
725066;202103;352590;G;4741500;1;0;1
726216;202103;352590;C;3299099;2;0;2
726505;202103;352590;G;4781400;0;1;-1
726543;202103;352590;C;2822402;0;1;-1
726621;202103;352590;G;4761003;1;0;1
726632;202103;352590;G;4744002;0;1;-1
726652;202103;352590;G;4663000;1;0;1
726657;202103;352590;H;5310502;1;1;0
726779;202103;352590;G;4789099;0;1;-1
726816;202103;352590;C;2099199;0;1;-1
726817;202103;352590;G;4692300;2;2;0
726957;202103;352590;G;4520005;0;8;-8
726969;202103;352590;C;1629301;3;1;2
727142;202103;352590;J;5813100;1;1;0
727703;202103;352590;G;4635402;5;2;3
729087;202103;352590;H;5223100;2;0;2
729090;202103;352590;H;5223100;0;1;-1
729138;202103;352590;H;5310502;1;1;0
729409;202103;352590;P;8599601;0;1;-1
729603;202103;352590;I;5611201;1;0;1
729617;202103;352590;C;1330800;0;5;-5
729663;202103;352590;R;9313100;1;0;1
729727;202103;352590;G;4744099;2;2;0
729743;202103;352590;I;5611203;1;0;1
729813;202103;352590;G;4711302;2;0;2
729843;202103;352590;G;4771701;0;1;-1
729858;202103;352590;C;2869100;1;0;1
729876;202103;352590;G;4754703;1;1;0
729934;202103;352590;N;7820500;19;2;17
730015;202103;352590;H;4930202;1;0;1
730940;202103;352590;G;4711301;4;7;-3
731655;202103;352590;C;2349401;17;12;5
731661;202103;352590;N;8211300;3;10;-7
732211;202103;352590;H;4930202;9;1;8
733433;202103;352590;G;4672900;5;2;3
734253;202103;352590;C;2812700;0;2;-2
735087;202103;352590;H;4930203;3;0;3
737256;202103;352590;G;4781400;0;1;-1
737972;202103;352590;G;4530703;0;2;-2
738537;202103;352590;G;4711301;2;3;-1
740250;202103;352590;H;4930202;0;1;-1
741085;202103;352590;I;5510801;2;1;1
741991;202103;352590;S;9511800;2;2;0
744218;202103;352590;K;6424703;1;0;1
744221;202103;352590;K;6424703;1;1;0
744803;202103;352590;H;4930202;7;7;0
746360;202103;352590;G;4679604;0;2;-2
748108;202103;352590;G;4541201;0;1;-1
748143;202103;352590;G;4783101;0;1;-1
748158;202103;352590;G;4783101;2;0;2
753494;202103;352590;C;2330399;1;1;0
754565;202103;352590;H;4930202;2;0;2
756052;202103;352590;C;1733800;6;9;-3
756053;202103;352590;C;1733800;0;1;-1
757447;202103;352590;K;6422100;1;0;1
757448;202103;352590;K;6422100;0;1;-1
757510;202103;352590;K;6422100;0;1;-1
757511;202103;352590;K;6422100;0;1;-1
761589;202103;352590;G;4781400;3;2;1
761686;202103;352590;G;4781400;1;2;-1
764571;202103;352590;I;5620101;4;1;3
766317;202103;352590;C;1733800;2;8;-6
766528;202103;352590;N;7732201;0;1;-1
766576;202103;352590;N;8111700;1;0;1
766895;202103;352590;E;3832700;1;1;0
766897;202103;352590;I;5620104;3;1;2
766939;202103;352590;I;5611201;0;2;-2
767026;202103;352590;Q;8630503;0;1;-1
767094;202103;352590;C;2829199;0;2;-2
767142;202103;352590;C;2599399;0;2;-2
767158;202103;352590;G;4642702;1;0;1
769016;202103;352590;C;2813500;21;21;0
769017;202103;352590;C;2349401;82;28;54
779166;202103;352590;M;6912500;0;2;-2
785399;202103;352590;Q;8630504;1;0;1
787544;202103;352590;Q;8630504;0;1;-1
789428;202103;352590;M;6912500;1;1;0
196;202012;352590;C;2229399;0;1;-1
413;202012;352590;G;4751201;2;1;1
490;202012;352590;F;4329103;1;0;1
1213;202012;352590;Q;8640202;0;1;-1
1596;202012;352590;G;4752100;2;2;0
2151;202012;352590;G;4772500;1;0;1
2373;202012;352590;C;2599399;1;5;-4
2413;202012;352590;G;4712100;1;0;1
2573;202012;352590;G;4744005;1;0;1
3073;202012;352590;C;2812700;2;0;2
3170;202012;352590;C;1091101;2;0;2
3172;202012;352590;G;4744005;0;1;-1
3222;202012;352590;G;4789099;0;1;-1
3525;202012;352590;C;2222600;0;1;-1
3527;202012;352590;C;2222600;0;1;-1
3617;202012;352590;Q;8630503;0;2;-2
3633;202012;352590;C;2949299;0;46;-46
3796;202012;352590;I;5611203;1;0;1
4512;202012;352590;C;2040100;7;12;-5
4650;202012;352590;N;7739099;2;1;1
4749;202012;352590;N;7810800;88;88;0
4874;202012;352590;C;2014200;0;1;-1
4921;202012;352590;K;6622300;1;1;0
5445;202012;352590;K;6423900;0;3;-3
5754;202012;352590;K;6423900;0;2;-2
5871;202012;352590;K;6423900;0;1;-1
6382;202012;352590;G;4789099;0;2;-2
6383;202012;352590;C;2512800;0;1;-1
6831;202012;352590;C;1732000;3;3;0
6971;202012;352590;K;6436100;0;1;-1
7004;202012;352590;G;4732600;0;1;-1
7340;202012;352590;G;4753900;0;2;-2
7343;202012;352590;G;4753900;1;0;1
7697;202012;352590;R;9001906;0;1;-1
7847;202012;352590;C;2229303;1;1;0
8746;202012;352590;Q;8711502;1;1;0
8793;202012;352590;G;4721102;0;1;-1
9263;202012;352590;G;4672900;3;1;2
10308;202012;352590;G;4781400;0;1;-1
10346;202012;352590;G;4789007;0;1;-1
10348;202012;352590;G;4530703;0;1;-1
11768;202012;352590;H;5211799;7;4;3
12283;202012;352590;G;4772500;1;2;-1
12454;202012;352590;F;4391600;0;1;-1
12566;202012;352590;I;5611203;1;2;-1
12656;202012;352590;Q;8610101;3;1;2
12883;202012;352590;G;4721104;0;1;-1
12978;202012;352590;G;4633801;1;1;0
13285;202012;352590;C;2342702;3;5;-2
13809;202012;352590;J;6203100;0;1;-1
13911;202012;352590;G;4771702;2;0;2
13913;202012;352590;H;4929902;0;3;-3
14062;202012;352590;S;9601703;5;4;1
14066;202012;352590;S;9601703;37;33;4
14227;202012;352590;N;7723300;0;1;-1
14349;202012;352590;C;1413401;0;1;-1
14489;202012;352590;G;4530705;1;0;1
14787;202012;352590;C;2341900;0;3;-3
15074;202012;352590;M;6920601;1;1;0
15652;202012;352590;I;5611201;0;1;-1
15710;202012;352590;G;4789099;2;0;2
16300;202012;352590;P;8512100;0;2;-2
16301;202012;352590;P;8511200;0;3;-3
16303;202012;352590;Q;8640299;0;1;-1
16517;202012;352590;H;5229002;2;1;1
16833;202012;352590;G;4729699;0;1;-1
16851;202012;352590;G;4755502;0;1;-1
16950;202012;352590;G;4732600;0;1;-1
17097;202012;352590;S;9601701;0;2;-2
17831;202012;352590;G;4789099;0;1;-1
18020;202012;352590;F;4321500;1;1;0
18372;202012;352590;C;2731700;1;4;-3
18490;202012;352590;G;4693100;7;12;-5
18560;202012;352590;G;4511101;1;1;0
18773;202012;352590;G;4646001;1;0;1
19090;202012;352590;P;8593700;0;1;-1
19121;202012;352590;I;5611201;0;8;-8
19146;202012;352590;E;3701100;1;4;-3
19163;202012;352590;G;4742300;0;1;-1
19231;202012;352590;G;4644301;28;22;6
19260;202012;352590;I;5620101;1;1;0
19298;202012;352590;M;7112000;1;3;-2
19355;202012;352590;I;5611201;0;1;-1
19917;202012;352590;P;8512100;0;1;-1
19980;202012;352590;G;4771701;1;2;-1
20549;202012;352590;N;8299701;4;6;-2
21390;202012;352590;C;2099199;0;1;-1
21534;202012;352590;I;5611203;0;1;-1
21767;202012;352590;G;4721102;1;0;1
22207;202012;352590;C;2229302;0;3;-3
23154;202012;352590;C;2822402;2;2;0
23188;202012;352590;G;4652400;0;1;-1
23519;202012;352590;C;3102100;8;5;3
23964;202012;352590;H;4930203;26;9;17
23973;202012;352590;G;4781400;0;1;-1
24285;202012;352590;Q;8640299;0;2;-2
24291;202012;352590;F;4329104;9;4;5
24599;202012;352590;G;4751201;0;1;-1
25012;202012;352590;C;2222600;1;0;1
25328;202012;352590;Q;8630503;1;0;1
25568;202012;352590;C;2542000;1;1;0
25751;202012;352590;M;7312200;0;1;-1
26328;202012;352590;G;4744001;1;0;1
26382;202012;352590;F;4399199;0;1;-1
26649;202012;352590;H;4930202;2;0;2
26770;202012;352590;G;4639701;1;0;1
26845;202012;352590;C;1062700;2;1;1
26898;202012;352590;M;7120100;3;1;2
26899;202012;352590;P;8593700;0;1;-1
27566;202012;352590;P;8511200;1;1;0
27567;202012;352590;C;1081302;6;1;5
28074;202012;352590;C;2539001;0;4;-4
28542;202012;352590;C;3250705;0;1;-1
28794;202012;352590;G;4721104;0;1;-1
29731;202012;352590;H;5223100;0;1;-1
29732;202012;352590;P;8512100;0;9;-9
29814;202012;352590;N;8211300;14;20;-6
29815;202012;352590;G;4634601;6;19;-13
29953;202012;352590;G;4712100;1;0;1
30120;202012;352590;G;4752100;1;1;0
30543;202012;352590;G;4712100;1;0;1
30631;202012;352590;G;4751201;2;0;2
30640;202012;352590;P;8592903;0;1;-1
30667;202012;352590;C;2222600;1;0;1
30885;202012;352590;G;4763603;0;1;-1
31421;202012;352590;N;7911200;1;0;1
31502;202012;352590;I;5611201;3;0;3
31618;202012;352590;N;7711000;0;1;-1
32199;202012;352590;I;5611201;1;1;0
32698;202012;352590;G;4530701;3;1;2
33162;202012;352590;G;4530702;2;1;1
33363;202012;352590;G;4687703;1;0;1
33425;202012;352590;L;6821802;0;1;-1
33550;202012;352590;C;2599399;5;2;3
33552;202012;352590;G;4759899;2;2;0
33565;202012;352590;C;1412601;0;1;-1
33906;202012;352590;C;1610202;1;0;1
34040;202012;352590;G;4744005;1;1;0
34672;202012;352590;H;4930202;2;3;-1
35085;202012;352590;F;4313400;1;8;-7
36431;202012;352590;G;4639701;5;10;-5
36600;202012;352590;S;9430800;0;2;-2
37016;202012;352590;R;9312300;0;1;-1
37442;202012;352590;P;8511200;0;1;-1
37443;202012;352590;P;8512100;0;1;-1
38132;202012;352590;L;6810202;0;3;-3
38367;202012;352590;C;1081302;10;16;-6
38587;202012;352590;N;8011101;4;9;-5
39121;202012;352590;B;810007;0;1;-1
39302;202012;352590;G;4731800;0;1;-1
39541;202012;352590;K;6424703;0;1;-1
39727;202012;352590;G;4754701;1;1;0
39943;202012;352590;J;6110801;0;2;-2
40323;202012;352590;G;4781400;3;0;3
40324;202012;352590;C;1340501;0;1;-1
40429;202012;352590;F;4120400;0;4;-4
40487;202012;352590;M;6920601;1;2;-1
40498;202012;352590;G;4511101;5;3;2
40532;202012;352590;H;5221400;49;37;12
40646;202012;352590;C;2941700;20;2;18
40647;202012;352590;C;2941700;0;1;-1
40724;202012;352590;I;5510801;0;2;-2
40910;202012;352590;A;122900;1;0;1
41307;202012;352590;G;4731800;1;0;1
41405;202012;352590;G;4784900;1;0;1
41884;202012;352590;C;2751100;4;8;-4
42255;202012;352590;C;2229302;10;1;9
42456;202012;352590;J;6120501;0;2;-2
42755;202012;352590;F;4120400;0;1;-1
43049;202012;352590;G;4530703;0;2;-2
43241;202012;352590;C;1099604;2;0;2
43418;202012;352590;G;4731800;1;1;0
43657;202012;352590;I;5620104;0;1;-1
43882;202012;352590;P;8532500;0;3;-3
44258;202012;352590;P;8513900;0;1;-1
44664;202012;352590;M;6920601;1;0;1
45297;202012;352590;G;4712100;0;1;-1
45306;202012;352590;N;7820500;3;1;2
45372;202012;352590;G;4511101;2;1;1
45844;202012;352590;G;4511102;1;0;1
45882;202012;352590;C;2219600;2;1;1
46133;202012;352590;G;4722901;0;1;-1
46337;202012;352590;N;8291100;0;1;-1
46474;202012;352590;G;4721104;1;0;1
46611;202012;352590;G;4744005;1;0;1
46694;202012;352590;C;2091600;1;5;-4
46724;202012;352590;G;4520001;0;2;-2
46844;202012;352590;P;8512100;0;4;-4
47372;202012;352590;G;4781400;1;1;0
47470;202012;352590;H;4930202;12;8;4
47499;202012;352590;Q;8800600;0;1;-1
47885;202012;352590;H;5211799;0;2;-2
48081;202012;352590;N;8211300;5;5;0
48444;202012;352590;C;3312102;1;0;1
48688;202012;352590;C;2532201;1;1;0
49306;202012;352590;I;5620103;2;0;2
49365;202012;352590;H;4930202;4;0;4
49659;202012;352590;C;1013901;29;18;11
49719;202012;352590;G;4722901;0;1;-1
50218;202012;352590;G;4754701;0;1;-1
50359;202012;352590;H;5223100;5;1;4
50571;202012;352590;L;6821802;0;1;-1
50759;202012;352590;G;4789099;0;1;-1
51160;202012;352590;G;4754702;0;1;-1
51658;202012;352590;G;4713001;2;0;2
51741;202012;352590;G;4679601;1;0;1
52263;202012;352590;H;4930202;0;1;-1
52704;202012;352590;H;4930202;13;10;3
52993;202012;352590;G;4789001;0;2;-2
52997;202012;352590;G;4789001;2;0;2
53211;202012;352590;N;8121400;17;15;2
53282;202012;352590;N;8291100;0;1;-1
53488;202012;352590;G;4771702;2;0;2
53512;202012;352590;C;2222600;3;1;2
54002;202012;352590;G;4752100;2;0;2
54003;202012;352590;G;4752100;1;1;0
54035;202012;352590;I;5611201;1;1;0
54394;202012;352590;G;4689399;0;1;-1
54615;202012;352590;C;2539001;0;1;-1
54889;202012;352590;G;4639701;1;1;0
55206;202012;352590;G;4744002;0;1;-1
55229;202012;352590;S;9411100;0;1;-1
55455;202012;352590;F;4330499;2;5;-3
56524;202012;352590;H;5229002;2;0;2
56884;202012;352590;G;4783101;2;0;2
56955;202012;352590;G;4646001;1;2;-1
57439;202012;352590;G;4789004;1;0;1
57480;202012;352590;I;5620101;0;1;-1
57483;202012;352590;I;5620101;1;2;-1
57502;202012;352590;Q;8720401;5;2;3
57658;202012;352590;G;4772500;4;4;0
57727;202012;352590;H;4930203;1;1;0
58400;202012;352590;I;5611201;1;1;0
58932;202012;352590;G;4759899;1;0;1
59042;202012;352590;G;4731800;0;1;-1
59695;202012;352590;C;2599399;0;4;-4
60259;202012;352590;G;4744099;1;3;-2
60295;202012;352590;G;4781400;6;0;6
60355;202012;352590;G;4753900;0;1;-1
61097;202012;352590;G;4711302;1;0;1
61200;202012;352590;G;4711302;1;0;1
61568;202012;352590;G;4754701;1;0;1
61654;202012;352590;G;4755503;0;1;-1
61676;202012;352590;F;4391600;4;0;4
61795;202012;352590;I;5611201;0;1;-1
62746;202012;352590;C;2539002;1;1;0
63588;202012;352590;E;3600601;0;2;-2
63609;202012;352590;I;5611203;3;1;2
63910;202012;352590;C;1093702;0;6;-6
64315;202012;352590;N;7820500;169;341;-172
64371;202012;352590;F;4120400;5;2;3
65730;202012;352590;G;4751201;0;1;-1
65831;202012;352590;P;8541400;0;1;-1
66135;202012;352590;H;4930202;0;1;-1
66440;202012;352590;P;8599699;12;1;11
66557;202012;352590;C;2829199;0;3;-3
66778;202012;352590;N;7820500;164;487;-323
67588;202012;352590;G;4781400;0;2;-2
67848;202012;352590;P;8599699;1;4;-3
68244;202012;352590;P;8599699;0;6;-6
68291;202012;352590;P;8599699;0;3;-3
68292;202012;352590;P;8599699;0;6;-6
68575;202012;352590;F;4399199;5;0;5
68773;202012;352590;I;5611203;0;1;-1
69134;202012;352590;G;4686902;0;2;-2
69246;202012;352590;G;4633801;0;1;-1
69541;202012;352590;N;8129000;33;27;6
69561;202012;352590;G;4781400;1;0;1
69603;202012;352590;G;4744005;5;2;3
69658;202012;352590;C;2222600;0;7;-7
69673;202012;352590;C;2439300;1;1;0
69968;202012;352590;H;4929902;1;0;1
70049;202012;352590;G;4721104;1;0;1
70264;202012;352590;I;5611203;1;0;1
70318;202012;352590;G;4789099;2;0;2
70355;202012;352590;H;4930202;11;14;-3
70356;202012;352590;H;4930202;8;6;2
70464;202012;352590;G;4731800;0;1;-1
70592;202012;352590;H;5120000;3;0;3
70595;202012;352590;H;5120000;1;0;1
70664;202012;352590;K;6622300;1;0;1
71258;202012;352590;G;4744005;0;1;-1
71311;202012;352590;G;4637106;6;5;1
71887;202012;352590;G;4759801;1;0;1
72571;202012;352590;I;5510803;1;0;1
72619;202012;352590;I;5510803;0;1;-1
72739;202012;352590;G;4756300;1;1;0
72790;202012;352590;Q;8630501;2;2;0
73448;202012;352590;G;4649499;0;1;-1
73841;202012;352590;N;8211300;1;1;0
74071;202012;352590;N;8291100;0;1;-1
74558;202012;352590;G;4530703;0;19;-19
74728;202012;352590;S;9430800;0;1;-1
75060;202012;352590;I;5611201;10;11;-1
75063;202012;352590;I;5611201;3;2;1
75177;202012;352590;S;9430800;0;1;-1
75297;202012;352590;N;8299799;5;6;-1
75619;202012;352590;J;6203100;1;1;0
75821;202012;352590;N;7820500;3;1;2
76166;202012;352590;K;6622300;0;1;-1
76259;202012;352590;F;4120400;0;4;-4
76470;202012;352590;D;3514000;0;2;-2
76498;202012;352590;H;4930202;1;0;1
76543;202012;352590;G;4639701;1;0;1
77726;202012;352590;N;8121400;0;1;-1
77782;202012;352590;H;4930201;1;2;-1
78003;202012;352590;G;4530703;0;2;-2
78346;202012;352590;H;5112901;3;1;2
78660;202012;352590;G;4721102;2;1;1
79154;202012;352590;G;4781400;0;1;-1
79155;202012;352590;G;4781400;0;3;-3
79156;202012;352590;G;4781400;0;2;-2
79157;202012;352590;G;4781400;0;4;-4
79324;202012;352590;P;8532500;0;25;-25
79416;202012;352590;P;8599699;0;1;-1
79871;202012;352590;G;4541202;1;0;1
80447;202012;352590;S;9601701;0;1;-1
81050;202012;352590;G;4744003;1;0;1
81486;202012;352590;C;3314721;11;17;-6
81884;202012;352590;G;4511101;1;1;0
82082;202012;352590;N;7711000;2;0;2
82310;202012;352590;F;4299599;25;1;24
82312;202012;352590;F;4299599;12;15;-3
82720;202012;352590;N;8211300;0;1;-1
83019;202012;352590;G;4753900;1;0;1
83162;202012;352590;M;7112000;0;1;-1
83176;202012;352590;G;4731800;0;2;-2
83217;202012;352590;C;2599399;0;3;-3
83230;202012;352590;G;4639701;10;4;6
83655;202012;352590;G;4781400;0;1;-1
84115;202012;352590;C;2869100;1;0;1
84320;202012;352590;I;5611201;0;1;-1
84930;202012;352590;N;8299799;1;0;1
85523;202012;352590;G;4712100;1;0;1
85737;202012;352590;C;1099699;1;0;1
86715;202012;352590;P;8512100;0;9;-9
86851;202012;352590;H;5250801;0;1;-1
87174;202012;352590;G;4789007;1;1;0
87417;202012;352590;K;6622300;3;0;3
87419;202012;352590;M;6920601;0;1;-1
87448;202012;352590;G;4731800;1;1;0
87478;202012;352590;H;5250804;24;18;6
87552;202012;352590;G;4781400;1;0;1
87704;202012;352590;G;4789002;0;1;-1
87832;202012;352590;C;3321000;0;1;-1
87907;202012;352590;R;9329802;1;0;1
87929;202012;352590;C;3299004;0;1;-1
88731;202012;352590;G;4759899;1;0;1
89129;202012;352590;J;6203100;1;0;1
89192;202012;352590;I;5611201;1;0;1
89635;202012;352590;C;2399199;0;1;-1
90260;202012;352590;Q;8630504;0;1;-1
90324;202012;352590;G;4520001;1;1;0
90813;202012;352590;Q;8650099;3;8;-5
90905;202012;352590;R;9313100;1;0;1
91004;202012;352590;G;4789007;4;1;3
91027;202012;352590;C;2949299;0;1;-1
91100;202012;352590;G;4753900;0;2;-2
91519;202012;352590;I;5611201;1;1;0
91520;202012;352590;S;9491000;1;0;1
91522;202012;352590;F;4120400;0;2;-2
92532;202012;352590;I;5611203;1;0;1
93098;202012;352590;H;4930201;4;2;2
93174;202012;352590;M;6920601;0;7;-7
93245;202012;352590;G;4664800;3;1;2
93833;202012;352590;G;4773300;2;1;1
94086;202012;352590;C;2222600;4;2;2
94177;202012;352590;G;4724500;14;12;2
94591;202012;352590;R;9313100;0;1;-1
94723;202012;352590;H;4929901;1;0;1
94730;202012;352590;G;4712100;1;0;1
95371;202012;352590;G;4511101;2;0;2
95940;202012;352590;C;2424501;0;1;-1
95989;202012;352590;C;1813001;0;1;-1
96560;202012;352590;G;4771701;0;1;-1
96596;202012;352590;Q;8630501;2;1;1
96607;202012;352590;G;4689399;0;2;-2
96780;202012;352590;G;4731800;2;0;2
96788;202012;352590;F;4299599;0;8;-8
97010;202012;352590;R;9313100;2;0;2
97450;202012;352590;G;4520002;1;4;-3
97528;202012;352590;S;9430800;0;2;-2
97928;202012;352590;S;9430800;1;0;1
98340;202012;352590;I;5611203;1;0;1
98632;202012;352590;Q;8630504;1;0;1
98814;202012;352590;G;4729699;3;1;2
99136;202012;352590;H;5240199;1;1;0
99146;202012;352590;H;4930202;2;0;2
100740;202012;352590;J;5914600;0;1;-1
100814;202012;352590;G;4530703;2;3;-1
100839;202012;352590;C;2950600;1;0;1
100866;202012;352590;N;8219999;1;0;1
101268;202012;352590;G;4731800;3;2;1
101271;202012;352590;G;4782201;22;2;20
101292;202012;352590;F;4313400;1;1;0
101751;202012;352590;F;4313400;14;13;1
101811;202012;352590;P;8512100;0;1;-1
101896;202012;352590;G;4511101;7;7;0
102266;202012;352590;F;4330404;0;2;-2
102451;202012;352590;P;8513900;0;1;-1
102508;202012;352590;G;4781400;0;1;-1
103432;202012;352590;G;4789001;0;1;-1
103766;202012;352590;I;5510801;0;1;-1
103782;202012;352590;J;6201501;4;0;4
104056;202012;352590;C;1412601;1;0;1
104273;202012;352590;C;2599399;0;1;-1
104350;202012;352590;G;4687703;0;2;-2
104639;202012;352590;N;8112500;0;1;-1
105017;202012;352590;G;4722901;0;1;-1
105079;202012;352590;N;7820500;95;131;-36
106050;202012;352590;Q;8712300;1;1;0
106221;202012;352590;G;4781400;1;0;1
106473;202012;352590;H;5240199;0;1;-1
106641;202012;352590;J;6202300;5;3;2
107161;202012;352590;G;4755502;2;3;-1
107677;202012;352590;G;4781400;2;0;2
108053;202012;352590;G;4744002;0;1;-1
108086;202012;352590;G;4772500;1;1;0
108926;202012;352590;G;4633801;0;1;-1
109272;202012;352590;I;5611203;0;1;-1
109371;202012;352590;P;8511200;0;2;-2
109372;202012;352590;P;8511200;0;3;-3
109526;202012;352590;R;9313100;0;1;-1
109977;202012;352590;G;4520006;0;1;-1
110344;202012;352590;I;5611203;1;0;1
110422;202012;352590;C;2222600;0;10;-10
111311;202012;352590;G;4687702;2;1;1
111553;202012;352590;G;4693100;2;0;2
111716;202012;352590;G;4711302;14;11;3
111746;202012;352590;G;4774100;1;0;1
111854;202012;352590;G;4753900;0;2;-2
111856;202012;352590;Q;8640204;1;0;1
112011;202012;352590;G;4721104;1;0;1
112012;202012;352590;M;6920601;1;0;1
112305;202012;352590;G;4751201;0;1;-1
113176;202012;352590;M;6920601;0;1;-1
113177;202012;352590;G;4759899;1;0;1
113331;202012;352590;G;4744099;1;0;1
113463;202012;352590;C;2823200;0;1;-1
113658;202012;352590;C;2825900;0;1;-1
113707;202012;352590;G;4772500;2;0;2
113843;202012;352590;H;4929902;1;0;1
114676;202012;352590;C;2399101;2;0;2
114946;202012;352590;P;8512100;0;3;-3
115121;202012;352590;G;4759899;0;8;-8
115123;202012;352590;G;4759899;0;4;-4
115124;202012;352590;G;4759899;0;2;-2
115125;202012;352590;G;4759899;0;3;-3
115131;202012;352590;G;4649499;0;8;-8
115304;202012;352590;G;4744099;1;0;1
115799;202012;352590;G;4753900;2;0;2
115998;202012;352590;H;4930203;1;0;1
116021;202012;352590;N;8299799;0;10;-10
116045;202012;352590;G;4712100;0;3;-3
116090;202012;352590;N;8299799;0;6;-6
117491;202012;352590;G;4711302;10;6;4
117632;202012;352590;G;4711301;20;10;10
117902;202012;352590;F;4322302;0;1;-1
118362;202012;352590;C;2829199;1;0;1
118403;202012;352590;I;5611201;0;1;-1
118408;202012;352590;I;5611201;3;1;2
118423;202012;352590;I;5611203;0;1;-1
118663;202012;352590;P;8531700;0;16;-16
119694;202012;352590;G;4789002;1;0;1
119838;202012;352590;C;2591800;0;5;-5
120100;202012;352590;G;4753900;1;0;1
120457;202012;352590;K;6424703;0;1;-1
120495;202012;352590;G;4761001;0;2;-2
120496;202012;352590;I;5611201;2;0;2
120613;202012;352590;G;4530703;0;2;-2
121562;202012;352590;G;4781400;1;0;1
122031;202012;352590;G;4759899;0;1;-1
122134;202012;352590;G;4789001;1;0;1
122196;202012;352590;F;4313400;0;10;-10
122718;202012;352590;G;4520005;1;0;1
122910;202012;352590;C;1013902;7;2;5
124028;202012;352590;I;5611203;0;1;-1
124037;202012;352590;G;4712100;0;3;-3
124201;202012;352590;G;4789002;15;5;10
124675;202012;352590;G;4763602;10;2;8
125038;202012;352590;H;4930202;2;1;1
126084;202012;352590;J;6209100;2;0;2
126735;202012;352590;I;5611203;0;1;-1
127007;202012;352590;J;5829800;1;0;1
127451;202012;352590;M;6911703;0;1;-1
127473;202012;352590;N;8299799;16;12;4
128174;202012;352590;G;4781400;1;1;0
128986;202012;352590;G;4687702;0;1;-1
129180;202012;352590;C;2710402;1;2;-1
129359;202012;352590;G;4711302;5;12;-7
130152;202012;352590;I;5611201;0;1;-1
130799;202012;352590;G;4763603;1;1;0
130800;202012;352590;G;4763603;3;1;2
130842;202012;352590;G;4731800;3;2;1
130981;202012;352590;I;5611201;0;1;-1
131169;202012;352590;N;8211300;1;0;1
131275;202012;352590;N;8011101;9;3;6
132068;202012;352590;K;6424703;1;0;1
132071;202012;352590;K;6424703;0;1;-1
132491;202012;352590;H;4930202;0;1;-1
132886;202012;352590;N;8211300;3;3;0
133179;202012;352590;G;4530703;1;0;1
133211;202012;352590;G;4530703;0;1;-1
133617;202012;352590;G;4781400;3;5;-2
134102;202012;352590;C;2790299;12;6;6
134106;202012;352590;G;4530703;0;1;-1
134913;202012;352590;E;3701100;0;1;-1
134971;202012;352590;C;1053800;2;2;0
134998;202012;352590;G;4729699;1;0;1
135138;202012;352590;Q;8630501;11;7;4
135416;202012;352590;G;4722901;0;1;-1
135507;202012;352590;G;4633801;1;4;-3
136435;202012;352590;G;4781400;0;1;-1
136523;202012;352590;N;8211300;0;1;-1
136833;202012;352590;P;8513900;0;4;-4
136835;202012;352590;M;7120100;1;0;1
137076;202012;352590;C;2622100;0;5;-5
137322;202012;352590;C;1099604;1;0;1
137589;202012;352590;N;8111700;1;1;0
138147;202012;352590;G;4520005;1;1;0
138150;202012;352590;F;4299599;0;4;-4
138223;202012;352590;G;4685100;1;0;1
138396;202012;352590;C;2071100;1;0;1
138851;202012;352590;C;2790299;1;0;1
139091;202012;352590;S;9430800;3;4;-1
139582;202012;352590;P;8520100;0;2;-2
139672;202012;352590;G;4771701;1;1;0
139674;202012;352590;G;4771701;1;1;0
139883;202012;352590;C;2759799;0;2;-2
140136;202012;352590;M;7490104;1;0;1
141493;202012;352590;H;4930202;1;1;0
141494;202012;352590;G;4752100;0;1;-1
141824;202012;352590;C;2219600;0;2;-2
142223;202012;352590;G;4741500;1;2;-1
142224;202012;352590;G;4741500;1;1;0
142239;202012;352590;G;4731800;1;1;0
142492;202012;352590;C;2029100;4;8;-4
142518;202012;352590;G;4635402;2;3;-1
143857;202012;352590;H;4930202;10;1;9
144250;202012;352590;G;4744001;0;2;-2
144440;202012;352590;G;4754703;2;2;0
145025;202012;352590;G;4617600;2;5;-3
145244;202012;352590;C;1062700;1;0;1
145771;202012;352590;G;4721102;1;3;-2
145886;202012;352590;G;4722901;2;0;2
146290;202012;352590;G;4772500;1;1;0
146606;202012;352590;I;5510801;0;1;-1
146609;202012;352590;G;4774100;0;1;-1
147269;202012;352590;P;8520100;0;2;-2
147276;202012;352590;J;6201500;1;0;1
147715;202012;352590;C;2543800;1;0;1
148421;202012;352590;N;8112500;2;0;2
148445;202012;352590;C;1053800;2;3;-1
148802;202012;352590;H;4930202;1;1;0
148926;202012;352590;N;8112500;1;1;0
149772;202012;352590;C;1032599;0;2;-2
149858;202012;352590;C;1099601;0;2;-2
150252;202012;352590;C;1042200;1;1;0
150367;202012;352590;P;8513900;0;1;-1
150370;202012;352590;P;8513900;0;4;-4
150509;202012;352590;F;4120400;1;0;1
150511;202012;352590;A;210107;2;1;1
150589;202012;352590;Q;8650004;0;1;-1
150807;202012;352590;I;5510801;1;1;0
151131;202012;352590;G;4781400;1;0;1
151368;202012;352590;H;5212500;0;1;-1
152258;202012;352590;I;5611203;4;0;4
152386;202012;352590;J;6190699;0;1;-1
152426;202012;352590;C;1062700;0;1;-1
152598;202012;352590;M;7120100;1;1;0
152893;202012;352590;G;4511101;2;2;0
152939;202012;352590;G;4744099;0;1;-1
153136;202012;352590;M;6920601;0;1;-1
153505;202012;352590;N;7711000;2;2;0
153794;202012;352590;I;5611203;2;0;2
155734;202012;352590;I;5611203;0;1;-1
156221;202012;352590;G;4753900;2;3;-1
156222;202012;352590;G;4753900;0;1;-1
156342;202012;352590;G;4789099;0;1;-1
157543;202012;352590;G;4530703;5;1;4
157804;202012;352590;G;4781400;0;1;-1
157998;202012;352590;G;4751201;2;0;2
158413;202012;352590;G;4744001;2;0;2
158447;202012;352590;G;4686902;1;0;1
158525;202012;352590;N;8299799;2;1;1
158650;202012;352590;G;4771701;1;0;1
158752;202012;352590;G;4755502;2;0;2
158753;202012;352590;G;4755502;0;1;-1
158793;202012;352590;I;5611201;1;1;0
159071;202012;352590;C;2621300;1;18;-17
159072;202012;352590;C;2632900;46;23;23
159143;202012;352590;N;8299799;88;68;20
160212;202012;352590;Q;8630503;0;1;-1
160553;202012;352590;C;2229303;0;1;-1
160648;202012;352590;H;5212500;16;9;7
160799;202012;352590;G;4761001;1;0;1
161084;202012;352590;M;7311400;0;1;-1
161121;202012;352590;H;4930202;1;0;1
161758;202012;352590;G;4752100;1;0;1
161969;202012;352590;I;5611201;0;5;-5
162477;202012;352590;F;4321500;4;0;4
162560;202012;352590;N;7732201;2;0;2
162885;202012;352590;G;4731800;1;2;-1
162917;202012;352590;N;7830200;2;0;2
163236;202012;352590;P;8513900;0;2;-2
163328;202012;352590;C;3313999;3;0;3
164421;202012;352590;H;4930202;0;3;-3
164472;202012;352590;G;4530703;0;3;-3
164651;202012;352590;F;4399199;1;1;0
164690;202012;352590;G;4731800;0;1;-1
165514;202012;352590;Q;8630501;1;0;1
166355;202012;352590;G;4530703;0;2;-2
166805;202012;352590;G;4744001;2;1;1
167478;202012;352590;P;8512100;0;4;-4
167561;202012;352590;G;4772500;1;0;1
167808;202012;352590;N;8112500;0;1;-1
167926;202012;352590;S;9603304;0;1;-1
168060;202012;352590;F;4213800;0;1;-1
168498;202012;352590;C;2840200;0;1;-1
168510;202012;352590;G;4729699;2;6;-4
168766;202012;352590;C;2539001;0;1;-1
168931;202012;352590;H;5212500;13;9;4
169014;202012;352590;N;8111700;3;5;-2
169060;202012;352590;G;4721104;1;2;-1
169114;202012;352590;G;4771701;0;1;-1
169980;202012;352590;N;7820500;3;3;0
170024;202012;352590;G;4511101;0;1;-1
170620;202012;352590;P;8593700;0;1;-1
170795;202012;352590;F;4120400;0;1;-1
171308;202012;352590;G;4530703;0;1;-1
171503;202012;352590;M;6920601;1;0;1
171504;202012;352590;H;4930202;2;0;2
172079;202012;352590;G;4729699;6;5;1
172164;202012;352590;I;5611203;0;1;-1
172573;202012;352590;F;4110700;1;1;0
172645;202012;352590;P;8599603;1;1;0
173469;202012;352590;G;4744001;0;1;-1
173658;202012;352590;H;4930202;3;1;2
173795;202012;352590;F;4222701;4;6;-2
174030;202012;352590;G;4789099;0;1;-1
174248;202012;352590;G;4686902;3;3;0
174727;202012;352590;G;4712100;0;1;-1
174768;202012;352590;E;3832700;1;0;1
175158;202012;352590;I;5611201;6;5;1
175189;202012;352590;I;5611201;4;2;2
175198;202012;352590;I;5611201;1;1;0
175351;202012;352590;G;4759899;0;5;-5
175546;202012;352590;C;2222600;0;5;-5
175776;202012;352590;G;4781400;1;1;0
175908;202012;352590;J;6209100;1;0;1
176283;202012;352590;G;4511101;1;2;-1
177363;202012;352590;N;7740300;1;0;1
177900;202012;352590;H;4930201;0;1;-1
178226;202012;352590;G;4754701;23;10;13
178227;202012;352590;G;4754701;0;1;-1
179094;202012;352590;H;4930203;0;1;-1
179491;202012;352590;I;5611201;0;1;-1
179850;202012;352590;P;8541400;0;1;-1
179970;202012;352590;I;5611201;1;0;1
180103;202012;352590;I;5611203;1;0;1
180539;202012;352590;I;5620101;7;0;7
180970;202012;352590;G;4759899;2;0;2
181437;202012;352590;G;4789005;1;1;0
181636;202012;352590;F;4330404;0;2;-2
181637;202012;352590;F;4330404;0;1;-1
181641;202012;352590;N;7830200;25;23;2
181848;202012;352590;G;4754701;0;1;-1
182708;202012;352590;M;7112000;4;2;2
182709;202012;352590;J;6204000;5;3;2
184671;202012;352590;F;4321500;4;1;3
185004;202012;352590;I;5611201;11;6;5
185704;202012;352590;N;8011101;0;1;-1
185968;202012;352590;G;4713002;1;1;0
186025;202012;352590;I;5611201;1;1;0
186267;202012;352590;G;4530703;0;1;-1
186581;202012;352590;N;8211300;1;0;1
186888;202012;352590;I;5620101;0;2;-2
187029;202012;352590;Q;8610101;0;12;-12
187516;202012;352590;N;8219999;2;0;2
187521;202012;352590;G;4686902;3;1;2
187594;202012;352590;G;4724500;17;5;12
187595;202012;352590;G;4633801;3;1;2
187596;202012;352590;G;4724500;19;9;10
187842;202012;352590;G;4663000;0;1;-1
188273;202012;352590;P;8592901;0;1;-1
188860;202012;352590;C;2222600;0;2;-2
189157;202012;352590;C;2812700;0;1;-1
189162;202012;352590;G;4789004;1;0;1
189407;202012;352590;G;4721102;1;0;1
189471;202012;352590;J;5914600;1;0;1
189796;202012;352590;P;8599601;2;3;-1
190294;202012;352590;I;5510801;1;2;-1
190444;202012;352590;H;5250805;2;2;0
190480;202012;352590;C;2621300;0;5;-5
190706;202012;352590;G;4772500;1;1;0
190936;202012;352590;G;4691500;2;4;-2
191301;202012;352590;C;3291400;0;2;-2
191416;202012;352590;Q;8650003;1;0;1
191615;202012;352590;G;4721103;1;0;1
191719;202012;352590;G;4712100;0;2;-2
191742;202012;352590;K;6462000;0;2;-2
192163;202012;352590;F;4399103;0;2;-2
192192;202012;352590;C;2511000;0;1;-1
192297;202012;352590;G;4731800;1;1;0
193341;202012;352590;I;5611201;1;0;1
193816;202012;352590;M;6920601;0;2;-2
193972;202012;352590;I;5611203;0;1;-1
193973;202012;352590;I;5611201;0;1;-1
194556;202012;352590;M;7111100;0;1;-1
194730;202012;352590;G;4618402;4;2;2
195271;202012;352590;G;4771701;1;0;1
195367;202012;352590;R;9313100;0;6;-6
195520;202012;352590;G;4712100;0;1;-1
196649;202012;352590;G;4647801;1;1;0
197496;202012;352590;Q;8711502;1;1;0
197563;202012;352590;G;4731800;0;1;-1
197576;202012;352590;G;4782201;0;1;-1
198155;202012;352590;G;4744002;0;2;-2
198156;202012;352590;C;2539001;1;0;1
198315;202012;352590;G;4754701;1;3;-2
198666;202012;352590;N;8211300;8;5;3
199344;202012;352590;N;8220200;0;1;-1
199704;202012;352590;N;8299706;0;1;-1
199764;202012;352590;I;5510801;0;1;-1
199765;202012;352590;G;4530703;1;0;1
201390;202012;352590;G;4755501;0;1;-1
201434;202012;352590;J;6311900;0;1;-1
201579;202012;352590;H;5250804;0;2;-2
203246;202012;352590;M;7500100;2;1;1
203444;202012;352590;H;4930202;2;3;-1
203550;202012;352590;M;6920601;0;1;-1
204309;202012;352590;I;5611201;1;1;0
205171;202012;352590;C;2222600;13;18;-5
205304;202012;352590;K;6619399;0;2;-2
205309;202012;352590;F;4292802;0;2;-2
205328;202012;352590;Q;8630599;0;1;-1
205710;202012;352590;C;3314707;16;1;15
206192;202012;352590;P;8512100;0;1;-1
206387;202012;352590;G;4530703;0;1;-1
206844;202012;352590;K;6462000;1;0;1
206961;202012;352590;H;4930202;3;0;3
207958;202012;352590;G;4731800;5;3;2
208739;202012;352590;S;9609299;1;0;1
208751;202012;352590;G;4712100;3;3;0
208752;202012;352590;N;8299799;1;1;0
209044;202012;352590;G;4771701;0;1;-1
209930;202012;352590;M;6911701;1;1;0
210401;202012;352590;Q;8630502;3;1;2
210564;202012;352590;F;4321500;0;2;-2
210926;202012;352590;H;4930202;0;2;-2
211076;202012;352590;M;6920601;0;1;-1
211501;202012;352590;F;4330401;0;1;-1
211604;202012;352590;K;6462000;0;1;-1
212039;202012;352590;I;5611203;2;0;2
212137;202012;352590;G;4729699;3;0;3
213010;202012;352590;H;4930202;26;13;13
214275;202012;352590;M;7020400;1;0;1
214413;202012;352590;C;1099699;0;3;-3
215189;202012;352590;P;8599604;0;1;-1
215201;202012;352590;N;8299799;2;1;1
216076;202012;352590;G;4731800;0;1;-1
216106;202012;352590;G;4623109;2;1;1
216134;202012;352590;G;4781400;2;40;-38
216171;202012;352590;P;8513900;0;1;-1
216172;202012;352590;P;8513900;1;2;-1
216174;202012;352590;N;8130300;21;8;13
216176;202012;352590;G;4789099;5;8;-3
216809;202012;352590;G;4761003;1;0;1
217026;202012;352590;C;2840200;0;1;-1
217631;202012;352590;G;4782201;0;1;-1
217632;202012;352590;G;4781400;0;6;-6
217634;202012;352590;G;4781400;0;6;-6
217868;202012;352590;G;4633801;1;0;1
217870;202012;352590;A;132600;16;0;16
218201;202012;352590;L;6821802;1;0;1
218540;202012;352590;P;8593700;1;0;1
218858;202012;352590;C;2311700;0;1;-1
218859;202012;352590;G;4744002;0;1;-1
219074;202012;352590;I;5611203;1;1;0
219133;202012;352590;H;5223100;0;1;-1
219345;202012;352590;G;4663000;0;6;-6
219489;202012;352590;G;4751201;1;0;1
219518;202012;352590;H;5212500;15;15;0
219871;202012;352590;C;2349401;3;2;1
220291;202012;352590;Q;8630501;0;1;-1
220597;202012;352590;M;7500100;1;0;1
221713;202012;352590;F;4321500;0;2;-2
221933;202012;352590;N;8211300;0;2;-2
223330;202012;352590;C;2072000;4;4;0
223390;202012;352590;G;4781400;0;1;-1
224245;202012;352590;G;4731800;0;1;-1
224350;202012;352590;Q;8711502;1;1;0
224438;202012;352590;G;4649499;0;2;-2
225097;202012;352590;P;8513900;0;3;-3
225727;202012;352590;N;8211300;0;1;-1
225828;202012;352590;G;4649401;1;0;1
225858;202012;352590;C;2599399;2;1;1
225971;202012;352590;G;4782201;0;2;-2
225972;202012;352590;G;4782201;0;2;-2
225973;202012;352590;G;4782201;0;7;-7
226628;202012;352590;Q;8712300;1;0;1
226830;202012;352590;C;1091101;14;9;5
228213;202012;352590;N;8299799;2;0;2
228567;202012;352590;C;1733800;1;2;-1
228753;202012;352590;I;5611203;2;1;1
228767;202012;352590;I;5611203;1;0;1
228891;202012;352590;P;8513900;0;2;-2
229084;202012;352590;I;5620101;0;1;-1
229094;202012;352590;G;4721102;0;1;-1
229110;202012;352590;P;8599603;1;2;-1
229328;202012;352590;C;3314799;2;0;2
229359;202012;352590;I;5611202;0;1;-1
229459;202012;352590;P;8511200;0;1;-1
229479;202012;352590;I;5611201;2;0;2
229941;202012;352590;G;4520001;0;1;-1
229978;202012;352590;P;8592901;0;1;-1
230659;202012;352590;G;4789002;1;0;1
231195;202012;352590;G;4781400;0;1;-1
231197;202012;352590;L;6822600;0;1;-1
231294;202012;352590;F;4120400;0;1;-1
231631;202012;352590;H;5250805;0;7;-7
231672;202012;352590;N;8299799;0;1;-1
231744;202012;352590;J;6311900;2;1;1
231977;202012;352590;G;4722901;1;0;1
232128;202012;352590;J;5811500;1;2;-1
232443;202012;352590;F;4322302;3;5;-2
232652;202012;352590;L;6821802;0;1;-1
233418;202012;352590;I;5611201;1;0;1
233615;202012;352590;G;4713002;1;0;1
233726;202012;352590;G;4729699;2;0;2
233789;202012;352590;N;7820500;1;0;1
233814;202012;352590;C;1733800;1;3;-2
234027;202012;352590;F;4322301;1;0;1
234120;202012;352590;G;4530703;2;0;2
234265;202012;352590;S;9601701;1;2;-1
234787;202012;352590;G;4781400;0;2;-2
234906;202012;352590;J;6203100;1;0;1
234931;202012;352590;P;8599604;1;0;1
235056;202012;352590;M;6920601;1;0;1
235418;202012;352590;N;8112500;0;1;-1
235484;202012;352590;F;4330404;0;2;-2
236243;202012;352590;F;4399103;3;0;3
236464;202012;352590;G;4781400;13;2;11
236582;202012;352590;C;1066000;27;3;24
236973;202012;352590;G;4781400;23;21;2
236974;202012;352590;G;4781400;12;9;3
237040;202012;352590;H;4930202;76;52;24
237066;202012;352590;S;9521500;3;2;1
237172;202012;352590;P;8599604;1;0;1
237342;202012;352590;J;5813100;0;1;-1
237550;202012;352590;G;4712100;0;1;-1
237617;202012;352590;C;3250705;1;1;0
237642;202012;352590;G;4772500;2;2;0
237662;202012;352590;P;8541400;0;1;-1
238137;202012;352590;M;7490199;0;4;-4
238166;202012;352590;P;8512100;0;3;-3
238169;202012;352590;E;3821100;12;12;0
238172;202012;352590;I;5611201;1;1;0
238219;202012;352590;K;6462000;1;2;-1
238266;202012;352590;N;8111700;27;10;17
238752;202012;352590;G;4789002;3;0;3
239417;202012;352590;F;4120400;2;5;-3
239535;202012;352590;I;5611201;1;2;-1
239944;202012;352590;C;2229399;2;2;0
239988;202012;352590;G;4783101;0;1;-1
240004;202012;352590;I;5510801;0;1;-1
240032;202012;352590;G;4711302;0;1;-1
240280;202012;352590;I;5611201;11;7;4
240451;202012;352590;I;5620104;1;0;1
241255;202012;352590;G;4744099;0;3;-3
241820;202012;352590;C;3250706;4;0;4
242414;202012;352590;J;6190601;1;1;0
242417;202012;352590;N;8121400;7;2;5
242421;202012;352590;G;4520005;0;2;-2
242506;202012;352590;C;2342702;0;9;-9
242523;202012;352590;G;4744001;1;0;1
242531;202012;352590;P;8513900;1;6;-5
242810;202012;352590;M;6920601;1;1;0
242893;202012;352590;G;4782201;8;8;0
243291;202012;352590;G;4771701;2;0;2
243303;202012;352590;F;4322302;0;1;-1
243777;202012;352590;P;8511200;0;1;-1
244293;202012;352590;R;9329804;0;3;-3
245041;202012;352590;P;8511200;0;1;-1
245946;202012;352590;G;4754701;2;0;2
246619;202012;352590;G;4781400;0;1;-1
246735;202012;352590;G;4772500;1;1;0
246738;202012;352590;H;4930202;2;6;-4
247962;202012;352590;Q;8650004;3;0;3
248516;202012;352590;G;4772500;0;2;-2
248519;202012;352590;G;4772500;2;0;2
248523;202012;352590;G;4772500;1;0;1
249379;202012;352590;N;8111700;1;0;1
250069;202012;352590;G;4691500;8;8;0
251161;202012;352590;N;8211300;3;0;3
251421;202012;352590;M;7311400;1;0;1
251474;202012;352590;I;5611203;0;1;-1
251530;202012;352590;I;5611203;3;1;2
251538;202012;352590;I;5611203;1;0;1
251997;202012;352590;I;5611203;1;2;-1
252945;202012;352590;F;4330403;0;2;-2
252946;202012;352590;F;4330403;0;1;-1
253164;202012;352590;S;9602501;0;1;-1
253791;202012;352590;L;6810201;0;2;-2
254200;202012;352590;K;6612603;1;0;1
254409;202012;352590;N;7733100;0;1;-1
254412;202012;352590;N;7733100;1;1;0
255033;202012;352590;I;5611201;0;3;-3
255062;202012;352590;I;5611201;0;2;-2
255244;202012;352590;G;4619200;0;1;-1
255556;202012;352590;I;5620104;0;1;-1
255559;202012;352590;N;8299706;1;0;1
255562;202012;352590;Q;8630502;1;1;0
255731;202012;352590;G;4761003;1;0;1
256099;202012;352590;G;4689399;1;5;-4
256327;202012;352590;H;4930201;2;0;2
256863;202012;352590;G;4669999;2;3;-1
256950;202012;352590;J;6204000;0;1;-1
257551;202012;352590;H;4930202;0;1;-1
257635;202012;352590;G;4763601;0;2;-2
257716;202012;352590;G;4781400;1;0;1
257997;202012;352590;M;6920601;1;0;1
258175;202012;352590;I;5611201;0;1;-1
258371;202012;352590;I;5611203;1;2;-1
258736;202012;352590;J;6311900;1;0;1
259643;202012;352590;G;4652400;1;0;1
260445;202012;352590;C;1093701;0;1;-1
260748;202012;352590;J;6110803;1;0;1
260999;202012;352590;G;4781400;6;6;0
261318;202012;352590;P;8541400;1;1;0
261523;202012;352590;G;4772500;0;4;-4
261586;202012;352590;C;3314708;1;0;1
261852;202012;352590;F;4221905;0;1;-1
261898;202012;352590;G;4744005;1;0;1
262478;202012;352590;K;6622300;1;0;1
262848;202012;352590;G;4646001;0;1;-1
263146;202012;352590;P;8512100;0;5;-5
263642;202012;352590;C;2731700;1;1;0
264052;202012;352590;G;4789099;0;2;-2
264057;202012;352590;Q;8640205;2;2;0
264590;202012;352590;L;6810202;0;1;-1
264676;202012;352590;N;8112500;0;1;-1
264684;202012;352590;N;7911200;1;0;1
264704;202012;352590;H;5211701;18;13;5
265240;202012;352590;G;4744001;1;0;1
265813;202012;352590;G;4530704;3;3;0
266069;202012;352590;G;4789099;0;1;-1
266326;202012;352590;C;2399101;0;4;-4
266367;202012;352590;G;4530705;1;0;1
266535;202012;352590;G;4771701;1;2;-1
267069;202012;352590;N;8111700;1;0;1
267264;202012;352590;C;3314702;14;3;11
267265;202012;352590;G;4744001;0;1;-1
267378;202012;352590;I;5611203;1;0;1
267420;202012;352590;G;4754701;13;8;5
267541;202012;352590;G;4633801;0;4;-4
267614;202012;352590;P;8593700;0;1;-1
268046;202012;352590;G;4744099;0;2;-2
268057;202012;352590;C;1091101;8;5;3
268061;202012;352590;C;2599399;1;2;-1
268186;202012;352590;C;3314708;4;1;3
268739;202012;352590;C;3314710;1;0;1
269050;202012;352590;M;7112000;1;0;1
269240;202012;352590;C;1413401;0;1;-1
269307;202012;352590;H;4930202;1;1;0
269952;202012;352590;G;4759899;0;1;-1
269997;202012;352590;P;8520100;0;2;-2
270676;202012;352590;F;4313400;0;1;-1
270701;202012;352590;G;4772500;0;1;-1
271069;202012;352590;I;5620102;0;1;-1
271898;202012;352590;C;1749400;0;1;-1
272260;202012;352590;F;4120400;1;0;1
272908;202012;352590;F;4399103;0;1;-1
273046;202012;352590;G;4530703;0;1;-1
273144;202012;352590;G;4761001;2;5;-3
273578;202012;352590;M;6920601;1;0;1
274035;202012;352590;G;4724500;3;2;1
274241;202012;352590;G;4623109;2;0;2
274245;202012;352590;R;9313100;0;2;-2
274530;202012;352590;G;4763601;2;0;2
275085;202012;352590;I;5620104;1;0;1
275292;202012;352590;C;2522500;0;1;-1
275972;202012;352590;G;4772500;2;1;1
276447;202012;352590;P;8599604;0;1;-1
276567;202012;352590;G;4741500;0;1;-1
276687;202012;352590;M;7490105;0;1;-1
277591;202012;352590;G;4520001;1;0;1
277611;202012;352590;N;7810800;3;17;-14
277619;202012;352590;G;4721104;4;9;-5
277620;202012;352590;G;4637107;0;1;-1
277704;202012;352590;C;3101200;1;3;-2
277706;202012;352590;G;4754701;1;1;0
277707;202012;352590;G;4754701;6;0;6
277830;202012;352590;J;6209100;1;0;1
277908;202012;352590;I;5611201;2;1;1
278105;202012;352590;I;5611203;2;1;1
278219;202012;352590;G;4752100;2;1;1
278574;202012;352590;J;6190699;0;3;-3
278958;202012;352590;C;1053800;1;3;-2
279274;202012;352590;Q;8712300;1;2;-1
279572;202012;352590;F;4120400;5;12;-7
279791;202012;352590;G;4744005;0;1;-1
280371;202012;352590;G;4782201;2;0;2
280528;202012;352590;I;5620104;0;1;-1
280696;202012;352590;P;8511200;0;1;-1
282017;202012;352590;G;4772500;3;4;-1
282889;202012;352590;C;2229303;0;3;-3
282988;202012;352590;G;4782201;5;1;4
282998;202012;352590;I;5611201;0;2;-2
283241;202012;352590;G;4771701;0;1;-1
283582;202012;352590;H;4922102;1;0;1
283762;202012;352590;G;4781400;0;1;-1
284013;202012;352590;M;7112000;27;1;26
284339;202012;352590;N;7711000;1;0;1
284396;202012;352590;S;9529105;0;1;-1
284575;202012;352590;Q;8630503;1;1;0
285108;202012;352590;J;6209100;1;0;1
285151;202012;352590;S;9521500;2;0;2
285198;202012;352590;G;4712100;0;1;-1
285424;202012;352590;F;4120400;0;1;-1
285886;202012;352590;I;5611201;0;1;-1
285913;202012;352590;N;8111700;0;2;-2
286047;202012;352590;G;4712100;0;1;-1
286254;202012;352590;H;4930202;2;0;2
286282;202012;352590;I;5611201;0;1;-1
286303;202012;352590;G;4782201;10;8;2
286714;202012;352590;I;5620102;0;1;-1
286748;202012;352590;G;4781400;1;0;1
286777;202012;352590;G;4782201;1;0;1
286833;202012;352590;G;4782201;1;0;1
287135;202012;352590;I;5611201;1;0;1
287136;202012;352590;S;9601701;1;1;0
287166;202012;352590;N;8111700;1;1;0
287320;202012;352590;H;4930202;16;26;-10
287326;202012;352590;F;4321500;4;1;3
287466;202012;352590;H;5211701;0;1;-1
287735;202012;352590;P;8511200;0;1;-1
287736;202012;352590;I;5611203;2;0;2
288005;202012;352590;G;4755502;4;1;3
288272;202012;352590;H;4930201;0;1;-1
288427;202012;352590;P;8512100;0;3;-3
289490;202012;352590;G;4721102;3;0;3
289671;202012;352590;N;8219999;1;0;1
289685;202012;352590;H;4930202;2;2;0
289860;202012;352590;G;4781400;0;2;-2
290188;202012;352590;I;5611203;1;1;0
290464;202012;352590;C;2229302;1;1;0
290605;202012;352590;N;8112500;1;0;1
290714;202012;352590;R;9313100;1;0;1
290942;202012;352590;S;9603301;2;1;1
291486;202012;352590;L;6821802;0;1;-1
291656;202012;352590;R;9313100;1;0;1
291662;202012;352590;G;4721104;1;0;1
291729;202012;352590;H;5240199;6;0;6
291877;202012;352590;M;6911701;0;1;-1
292116;202012;352590;H;4930201;0;1;-1
292141;202012;352590;S;9602502;0;1;-1
292771;202012;352590;I;5611201;1;4;-3
292864;202012;352590;G;4789099;0;1;-1
293357;202012;352590;C;3314702;1;0;1
293453;202012;352590;M;7500100;1;0;1
293640;202012;352590;I;5611201;2;0;2
294758;202012;352590;Q;8630503;0;1;-1
295724;202012;352590;N;8121400;1;1;0
296626;202012;352590;Q;8630503;2;0;2
296630;202012;352590;G;4751201;1;0;1
296829;202012;352590;G;4729699;2;0;2
296836;202012;352590;H;5250803;4;0;4
296848;202012;352590;G;4781400;0;1;-1
296994;202012;352590;G;4763601;1;0;1
297094;202012;352590;G;4520005;0;9;-9
297685;202012;352590;N;8219999;2;0;2
297802;202012;352590;G;4721104;1;0;1
297847;202012;352590;G;4721104;3;1;2
298215;202012;352590;N;7911200;0;1;-1
298758;202012;352590;F;4120400;11;4;7
300462;202012;352590;G;4752100;0;1;-1
301183;202012;352590;F;4120400;0;1;-1
301453;202012;352590;N;8111700;1;0;1
301951;202012;352590;M;7020400;1;0;1
302638;202012;352590;G;4614100;0;1;-1
302649;202012;352590;G;4771702;4;3;1
302711;202012;352590;N;8299799;1;0;1
303560;202012;352590;G;4789099;0;1;-1
303737;202012;352590;N;8211300;1;3;-2
304461;202012;352590;Q;8630501;1;0;1
304529;202012;352590;S;9609299;3;3;0
304958;202012;352590;G;4744001;0;1;-1
305116;202012;352590;G;4752100;1;0;1
305454;202012;352590;F;4120400;3;0;3
305612;202012;352590;J;6209100;3;0;3
305667;202012;352590;H;4930201;1;2;-1
305669;202012;352590;H;4930201;2;5;-3
305851;202012;352590;G;4781400;1;0;1
306140;202012;352590;S;9602501;0;1;-1
306148;202012;352590;M;7500100;2;0;2
306811;202012;352590;I;5611201;0;1;-1
306915;202012;352590;G;4789004;1;1;0
307061;202012;352590;M;7319003;2;0;2
307062;202012;352590;M;7319003;0;1;-1
307121;202012;352590;F;4399199;4;5;-1
307429;202012;352590;G;4789099;0;1;-1
307761;202012;352590;G;4687702;1;0;1
307835;202012;352590;G;4713002;1;0;1
308202;202012;352590;G;4520005;2;2;0
308215;202012;352590;G;4731800;1;0;1
308449;202012;352590;H;4930201;1;0;1
308779;202012;352590;H;4930202;0;1;-1
309436;202012;352590;G;4782201;0;1;-1
310143;202012;352590;G;4751201;1;0;1
310457;202012;352590;G;4789004;1;0;1
310484;202012;352590;C;2823200;1;0;1
310570;202012;352590;N;8011101;1;1;0
311146;202012;352590;C;3314713;0;1;-1
311259;202012;352590;N;8211300;0;1;-1
311359;202012;352590;G;4774100;0;1;-1
311474;202012;352590;L;6822600;1;1;0
312249;202012;352590;G;4781400;1;1;0
312325;202012;352590;P;8593700;0;1;-1
312552;202012;352590;F;4399103;1;1;0
312797;202012;352590;H;4930202;11;1;10
313034;202012;352590;N;8111700;1;0;1
313083;202012;352590;G;4781400;0;1;-1
313381;202012;352590;N;7912100;0;3;-3
313527;202012;352590;N;7911200;1;1;0
314279;202012;352590;G;4772500;0;1;-1
314280;202012;352590;G;4772500;0;2;-2
315568;202012;352590;C;1013901;0;4;-4
315719;202012;352590;G;4752100;0;1;-1
315832;202012;352590;P;8593700;0;1;-1
315887;202012;352590;N;8219999;0;1;-1
316188;202012;352590;P;8599605;1;2;-1
316394;202012;352590;G;4781400;2;1;1
316724;202012;352590;I;5611203;2;0;2
316822;202012;352590;H;5229002;1;1;0
318594;202012;352590;G;4754701;1;0;1
319317;202012;352590;C;2222600;1;2;-1
319757;202012;352590;G;4530703;2;1;1
320078;202012;352590;M;7119701;1;3;-2
321321;202012;352590;I;5611201;3;0;3
321354;202012;352590;R;9313100;0;1;-1
321459;202012;352590;N;8130300;0;2;-2
321703;202012;352590;N;8291100;3;1;2
321800;202012;352590;C;2532201;2;0;2
321951;202012;352590;N;8112500;0;1;-1
322389;202012;352590;P;8512100;0;1;-1
322404;202012;352590;N;8220200;97;28;69
323064;202012;352590;F;4399103;0;10;-10
323462;202012;352590;G;4781400;0;1;-1
323760;202012;352590;G;4753900;5;1;4
324250;202012;352590;P;8593700;0;1;-1
325225;202012;352590;G;4789001;1;0;1
326843;202012;352590;I;5611201;0;1;-1
326928;202012;352590;G;4774100;1;1;0
327394;202012;352590;M;7119703;0;2;-2
327790;202012;352590;P;8599604;0;1;-1
328018;202012;352590;I;5611203;0;1;-1
328584;202012;352590;G;4761001;0;1;-1
328755;202012;352590;I;5620104;0;1;-1
329050;202012;352590;G;4722901;1;1;0
329133;202012;352590;I;5611201;2;2;0
329703;202012;352590;P;8593700;0;1;-1
329930;202012;352590;G;4520002;1;0;1
329980;202012;352590;N;8130300;3;4;-1
330088;202012;352590;G;4652400;1;1;0
330089;202012;352590;G;4752100;1;0;1
330091;202012;352590;G;4752100;1;0;1
330310;202012;352590;F;4321500;0;5;-5
330405;202012;352590;F;4120400;58;34;24
331606;202012;352590;S;9491000;0;2;-2
331994;202012;352590;F;4330405;0;1;-1
332678;202012;352590;G;4713002;0;2;-2
332889;202012;352590;I;5611201;0;1;-1
332998;202012;352590;G;4530705;0;1;-1
333001;202012;352590;H;4930201;1;2;-1
333073;202012;352590;G;4721102;0;1;-1
333142;202012;352590;M;7112000;3;2;1
333180;202012;352590;G;4721102;2;1;1
333740;202012;352590;G;4774100;2;1;1
334175;202012;352590;G;4781400;1;1;0
334568;202012;352590;G;4789002;0;1;-1
334694;202012;352590;G;4754701;1;0;1
336175;202012;352590;H;4930202;5;6;-1
336344;202012;352590;Q;8712300;2;2;0
336807;202012;352590;Q;8630502;0;1;-1
337072;202012;352590;Q;8630503;1;0;1
337073;202012;352590;H;5223100;1;0;1
337184;202012;352590;C;2222600;2;0;2
338706;202012;352590;H;4930201;0;1;-1
339594;202012;352590;G;4721102;0;1;-1
339601;202012;352590;L;6810202;1;1;0
339911;202012;352590;H;4930201;0;1;-1
340153;202012;352590;S;9602502;1;1;0
340224;202012;352590;G;4530703;0;1;-1
340297;202012;352590;M;7112000;3;0;3
340668;202012;352590;N;8211300;0;1;-1
341120;202012;352590;C;3321000;1;0;1
341999;202012;352590;G;4781400;13;9;4
342389;202012;352590;G;4712100;1;0;1
342780;202012;352590;I;5611203;5;3;2
342801;202012;352590;G;4781400;0;2;-2
342942;202012;352590;N;8111700;0;1;-1
342950;202012;352590;N;7911200;1;0;1
343207;202012;352590;G;4731800;1;3;-2
345648;202012;352590;G;4772500;0;1;-1
345891;202012;352590;G;4669999;3;3;0
346445;202012;352590;S;9511800;1;1;0
347011;202012;352590;G;4672900;0;1;-1
347557;202012;352590;G;4754701;2;0;2
349833;202012;352590;G;4789099;0;1;-1
349970;202012;352590;I;5611201;1;0;1
349975;202012;352590;G;4721102;0;1;-1
350478;202012;352590;H;4930202;9;14;-5
350654;202012;352590;G;4729699;1;1;0
351357;202012;352590;G;4672900;0;1;-1
351455;202012;352590;N;8121400;2;2;0
351726;202012;352590;G;4763601;0;1;-1
351787;202012;352590;G;4712100;1;0;1
351968;202012;352590;N;8130300;0;1;-1
352064;202012;352590;F;4399199;2;1;1
352256;202012;352590;I;5611203;1;2;-1
353150;202012;352590;H;4930202;2;3;-1
353229;202012;352590;G;4781400;1;0;1
353727;202012;352590;H;5223100;0;1;-1
353747;202012;352590;M;6920601;0;7;-7
354431;202012;352590;G;4530703;2;0;2
354741;202012;352590;G;4789002;0;1;-1
354773;202012;352590;Q;8630504;0;1;-1
355276;202012;352590;G;4645101;3;5;-2
355665;202012;352590;C;1099699;1;0;1
356114;202012;352590;I;5611201;1;0;1
356403;202012;352590;G;4772500;1;0;1
356735;202012;352590;G;4789001;1;0;1
357170;202012;352590;G;4721102;0;1;-1
357454;202012;352590;N;8121400;3;0;3
357586;202012;352590;L;6822600;1;0;1
357882;202012;352590;G;4789099;2;0;2
357883;202012;352590;G;4789099;1;1;0
358049;202012;352590;I;5611201;3;2;1
358415;202012;352590;G;4744001;0;1;-1
358935;202012;352590;M;7112000;0;1;-1
359016;202012;352590;I;5611203;1;0;1
359294;202012;352590;H;5212500;8;7;1
359386;202012;352590;G;4731800;2;2;0
359474;202012;352590;C;1412601;3;2;1
359604;202012;352590;F;4321500;1;0;1
359647;202012;352590;G;4713001;6;5;1
360115;202012;352590;P;8512100;0;1;-1
360195;202012;352590;N;8219999;1;0;1
360277;202012;352590;C;2950600;0;2;-2
360347;202012;352590;G;4511101;0;1;-1
360551;202012;352590;M;7119701;2;0;2
361884;202012;352590;C;1042200;0;7;-7
361973;202012;352590;G;4754701;1;2;-1
362267;202012;352590;G;4731800;0;1;-1
362435;202012;352590;R;9313100;1;1;0
362625;202012;352590;G;4713002;0;1;-1
362816;202012;352590;M;7020400;1;1;0
362861;202012;352590;P;8599604;0;2;-2
363062;202012;352590;N;8211300;0;1;-1
363152;202012;352590;P;8512100;0;3;-3
363270;202012;352590;F;4120400;0;1;-1
363365;202012;352590;G;4729699;3;2;1
363483;202012;352590;G;4520001;1;0;1
363942;202012;352590;M;7319002;1;0;1
363999;202012;352590;I;5611201;0;1;-1
364205;202012;352590;G;4781400;1;0;1
364278;202012;352590;S;9602502;0;1;-1
364320;202012;352590;Q;8630502;0;1;-1
364388;202012;352590;N;8111700;4;0;4
365026;202012;352590;F;4291000;0;1;-1
365044;202012;352590;R;9321200;1;0;1
366192;202012;352590;F;4120400;1;0;1
366193;202012;352590;G;4789099;0;1;-1
366334;202012;352590;N;8112500;2;1;1
366450;202012;352590;I;5620101;25;11;14
366452;202012;352590;I;5620101;1;1;0
366453;202012;352590;I;5620101;6;7;-1
366454;202012;352590;I;5620101;2;0;2
366457;202012;352590;I;5620101;1;1;0
366748;202012;352590;G;4742300;0;1;-1
367384;202012;352590;H;5229002;0;1;-1
368409;202012;352590;G;4646001;1;1;0
368594;202012;352590;H;5211701;2;4;-2
369253;202012;352590;M;7490104;1;0;1
369591;202012;352590;H;4930202;1;0;1
369717;202012;352590;G;4754701;0;1;-1
369907;202012;352590;N;8220200;352;163;189
369995;202012;352590;G;4782201;0;1;-1
370146;202012;352590;N;8299799;0;1;-1
370182;202012;352590;G;4781400;1;0;1
370183;202012;352590;G;4781400;1;1;0
370312;202012;352590;C;1113502;1;0;1
370397;202012;352590;J;6209100;18;5;13
370832;202012;352590;H;4930201;1;0;1
371050;202012;352590;G;4783101;1;1;0
371306;202012;352590;I;5611201;0;1;-1
371396;202012;352590;C;2229399;0;3;-3
371524;202012;352590;N;7911200;0;1;-1
372385;202012;352590;H;4930202;2;2;0
372628;202012;352590;I;5620104;0;1;-1
373471;202012;352590;F;4221904;3;4;-1
373627;202012;352590;P;8513900;0;1;-1
375420;202012;352590;N;8299799;21;12;9
375486;202012;352590;C;3321000;1;2;-1
375500;202012;352590;N;8111700;3;5;-2
375857;202012;352590;H;4930202;7;4;3
376088;202012;352590;G;4530703;0;2;-2
376276;202012;352590;F;4313400;0;1;-1
376973;202012;352590;G;4711302;0;1;-1
377685;202012;352590;P;8599604;6;17;-11
378709;202012;352590;G;4639701;7;12;-5
379140;202012;352590;N;8111700;4;4;0
379617;202012;352590;C;3313999;1;0;1
379716;202012;352590;C;1095300;2;13;-11
380333;202012;352590;G;4712100;2;2;0
380719;202012;352590;G;4753900;3;4;-1
381058;202012;352590;N;8291100;0;1;-1
381496;202012;352590;H;4930202;1;0;1
381997;202012;352590;G;4759899;0;1;-1
382273;202012;352590;G;4771701;0;1;-1
382312;202012;352590;I;5611202;0;1;-1
382657;202012;352590;H;4930201;0;1;-1
383195;202012;352590;C;2943300;0;2;-2
383467;202012;352590;J;6209100;2;1;1
383538;202012;352590;G;4744001;1;0;1
383828;202012;352590;M;7112000;0;1;-1
383970;202012;352590;I;5611201;0;1;-1
383976;202012;352590;N;8211300;0;1;-1
384343;202012;352590;G;4731800;0;1;-1
384377;202012;352590;F;4312600;0;1;-1
384469;202012;352590;H;4930201;0;1;-1
384505;202012;352590;G;4789001;1;0;1
384708;202012;352590;I;5611203;2;2;0
384710;202012;352590;I;5611203;3;5;-2
384711;202012;352590;I;5611203;0;1;-1
384712;202012;352590;I;5611203;6;4;2
384714;202012;352590;I;5611203;4;1;3
385877;202012;352590;M;6920601;0;1;-1
386175;202012;352590;G;4757100;0;1;-1
386225;202012;352590;C;3314707;8;1;7
386288;202012;352590;G;4781400;1;0;1
386350;202012;352590;G;4721103;0;2;-2
386546;202012;352590;J;6204000;0;1;-1
387947;202012;352590;J;6319400;0;1;-1
388308;202012;352590;G;4782201;0;1;-1
388315;202012;352590;Q;8711502;2;1;1
389324;202012;352590;I;5611201;0;1;-1
389870;202012;352590;G;4530705;0;1;-1
390084;202012;352590;N;8211300;0;1;-1
390526;202012;352590;I;5611203;1;0;1
391003;202012;352590;G;4744099;2;0;2
392030;202012;352590;F;4330404;0;2;-2
392119;202012;352590;M;7112000;0;1;-1
393029;202012;352590;G;4781400;3;1;2
393482;202012;352590;I;5611201;1;1;0
393845;202012;352590;P;8593700;0;1;-1
394816;202012;352590;G;4759899;0;1;-1
394873;202012;352590;S;9601701;0;1;-1
395335;202012;352590;G;4781400;1;0;1
395475;202012;352590;G;4744099;3;2;1
395537;202012;352590;H;5212500;0;1;-1
396455;202012;352590;C;2542000;0;1;-1
396553;202012;352590;S;9602501;1;0;1
396794;202012;352590;P;8511200;0;1;-1
396907;202012;352590;G;4781400;2;2;0
397412;202012;352590;G;4789004;1;0;1
397422;202012;352590;M;6911701;0;1;-1
397578;202012;352590;I;5590699;0;1;-1
397800;202012;352590;F;4120400;2;0;2
397834;202012;352590;G;4646001;0;2;-2
397952;202012;352590;H;4930202;1;0;1
398213;202012;352590;G;4759899;1;0;1
398795;202012;352590;C;1069400;1;2;-1
400182;202012;352590;G;4789099;1;0;1
400351;202012;352590;G;4744005;1;0;1
400524;202012;352590;Q;8630503;1;0;1
400724;202012;352590;I;5611203;1;1;0
400725;202012;352590;I;5611203;1;1;0
400807;202012;352590;G;4729699;0;1;-1
400808;202012;352590;G;4729699;0;1;-1
400848;202012;352590;Q;8640202;1;1;0
401114;202012;352590;S;9603301;0;1;-1
401140;202012;352590;H;5250804;7;1;6
401394;202012;352590;G;4774100;0;1;-1
401510;202012;352590;C;1821100;1;1;0
401531;202012;352590;N;7740300;0;1;-1
401857;202012;352590;N;8111700;0;2;-2
401948;202012;352590;N;8219901;1;1;0
402038;202012;352590;I;5611201;1;0;1
402138;202012;352590;G;4759899;1;0;1
402402;202012;352590;G;4724500;1;0;1
402614;202012;352590;G;4729602;6;0;6
402709;202012;352590;F;4221902;0;1;-1
403003;202012;352590;G;4713002;1;0;1
403030;202012;352590;G;4721103;2;2;0
403155;202012;352590;I;5611201;1;0;1
404333;202012;352590;I;5611203;3;5;-2
404395;202012;352590;G;4520006;0;1;-1
404537;202012;352590;N;8111700;1;0;1
404752;202012;352590;G;4721102;2;1;1
405074;202012;352590;G;4752100;2;1;1
405996;202012;352590;M;7319003;0;3;-3
406083;202012;352590;F;4120400;0;1;-1
406898;202012;352590;C;3314713;0;1;-1
407137;202012;352590;S;9430800;1;0;1
407613;202012;352590;C;2071100;0;1;-1
407843;202012;352590;G;4771701;1;0;1
407915;202012;352590;M;6920601;0;1;-1
408005;202012;352590;L;6822600;0;1;-1
408036;202012;352590;G;4781400;3;0;3
408289;202012;352590;F;4322301;0;1;-1
408467;202012;352590;F;4330403;0;7;-7
408470;202012;352590;F;4292801;3;1;2
408807;202012;352590;H;4930202;0;2;-2
409567;202012;352590;C;3101200;0;1;-1
409848;202012;352590;I;5611201;4;0;4
410235;202012;352590;G;4731800;1;0;1
410299;202012;352590;R;9321200;7;1;6
410484;202012;352590;N;8299799;0;1;-1
410757;202012;352590;G;4781400;1;0;1
411290;202012;352590;H;4930202;0;3;-3
411375;202012;352590;Q;8630504;1;0;1
411471;202012;352590;K;6462000;4;3;1
411574;202012;352590;G;4789004;0;1;-1
411893;202012;352590;G;4789004;1;1;0
411962;202012;352590;N;8122200;0;1;-1
413010;202012;352590;N;8121400;0;2;-2
413302;202012;352590;I;5611201;1;0;1
413499;202012;352590;R;9313100;0;1;-1
413914;202012;352590;F;4120400;1;0;1
414325;202012;352590;F;4330404;1;0;1
414326;202012;352590;F;4330404;0;3;-3
414398;202012;352590;G;4754701;1;0;1
414840;202012;352590;C;2511000;1;4;-3
415151;202012;352590;G;4687702;0;5;-5
415579;202012;352590;I;5611201;2;2;0
416585;202012;352590;G;4729602;0;1;-1
416747;202012;352590;Q;8640202;2;2;0
416992;202012;352590;H;5229002;0;1;-1
417033;202012;352590;G;4721102;1;1;0
417096;202012;352590;N;7820500;23;2;21
417169;202012;352590;F;4399101;2;0;2
418438;202012;352590;F;4120400;0;1;-1
418548;202012;352590;I;5611203;0;1;-1
419616;202012;352590;F;4120400;0;14;-14
419734;202012;352590;F;4330404;1;1;0
420532;202012;352590;G;4511102;0;1;-1
420860;202012;352590;N;7739099;1;0;1
421735;202012;352590;M;7112000;0;1;-1
422378;202012;352590;N;8121400;0;2;-2
422807;202012;352590;K;6622300;0;2;-2
422908;202012;352590;R;9321200;0;1;-1
423217;202012;352590;G;4755503;0;2;-2
423757;202012;352590;I;5611203;0;1;-1
423762;202012;352590;G;4783101;1;0;1
423861;202012;352590;G;4520002;1;0;1
424154;202012;352590;C;3314707;0;1;-1
424240;202012;352590;Q;8640202;0;2;-2
424297;202012;352590;Q;8630504;3;1;2
424420;202012;352590;I;5620104;1;1;0
424522;202012;352590;G;4729699;2;0;2
425428;202012;352590;S;9602501;0;1;-1
426420;202012;352590;N;8111700;1;2;-1
426501;202012;352590;I;5620104;1;0;1
426736;202012;352590;J;6110803;3;5;-2
426909;202012;352590;G;4729699;1;0;1
427120;202012;352590;I;5620104;0;2;-2
427198;202012;352590;G;4721104;0;1;-1
427577;202012;352590;I;5620101;0;1;-1
427581;202012;352590;I;5620101;3;1;2
427685;202012;352590;F;4120400;5;9;-4
427865;202012;352590;G;4789099;1;0;1
428871;202012;352590;P;8512100;0;5;-5
429012;202012;352590;H;4930202;0;1;-1
429055;202012;352590;H;5212500;1;14;-13
429346;202012;352590;C;1053800;0;2;-2
429513;202012;352590;G;4789099;0;1;-1
429646;202012;352590;C;2512800;0;1;-1
429921;202012;352590;G;4781400;0;1;-1
430407;202012;352590;I;5611203;0;2;-2
430469;202012;352590;F;4391600;0;1;-1
430717;202012;352590;I;5620101;1;1;0
430718;202012;352590;I;5620101;1;0;1
431056;202012;352590;R;9313100;0;1;-1
431317;202012;352590;M;7112000;24;10;14
431633;202012;352590;G;4679699;1;0;1
431660;202012;352590;G;4712100;1;0;1
432137;202012;352590;G;4789099;0;1;-1
432309;202012;352590;J;6319400;0;1;-1
432385;202012;352590;G;4781400;0;1;-1
432985;202012;352590;G;4782201;0;3;-3
433610;202012;352590;G;4772500;2;0;2
433684;202012;352590;I;5611203;1;1;0
433869;202012;352590;S;9602502;2;0;2
434538;202012;352590;I;5611203;1;0;1
434720;202012;352590;G;4721104;1;0;1
434981;202012;352590;M;7112000;2;1;1
435158;202012;352590;G;4789099;4;1;3
435192;202012;352590;G;4781400;3;2;1
435567;202012;352590;F;4399199;0;2;-2
435669;202012;352590;H;4930201;1;0;1
436172;202012;352590;I;5611203;1;0;1
436173;202012;352590;I;5611203;0;1;-1
436255;202012;352590;G;4782202;0;1;-1
436433;202012;352590;S;9609208;3;2;1
436938;202012;352590;H;5112901;2;0;2
438149;202012;352590;N;8111700;0;2;-2
438277;202012;352590;N;8291100;0;7;-7
438421;202012;352590;N;8211300;1;1;0
438692;202012;352590;Q;8630503;0;1;-1
439028;202012;352590;F;4120400;0;3;-3
439273;202012;352590;I;5611201;3;0;3
439277;202012;352590;M;7112000;0;1;-1
439557;202012;352590;P;8512100;0;3;-3
440263;202012;352590;G;4744099;0;1;-1
440287;202012;352590;G;4511101;1;0;1
441256;202012;352590;Q;8630501;1;2;-1
441581;202012;352590;G;4530705;2;1;1
441893;202012;352590;F;4321500;5;0;5
441942;202012;352590;I;5611203;0;1;-1
442106;202012;352590;G;4723700;1;0;1
442537;202012;352590;J;6110803;2;1;1
442969;202012;352590;Q;8630502;1;1;0
442985;202012;352590;P;8512100;0;4;-4
442998;202012;352590;N;8291100;1;1;0
443067;202012;352590;G;4520001;0;1;-1
444019;202012;352590;S;9601703;11;13;-2
444601;202012;352590;C;3314799;2;5;-3
445740;202012;352590;S;9602501;0;2;-2
446313;202012;352590;C;1091102;0;1;-1
446585;202012;352590;M;7020400;0;2;-2
447057;202012;352590;S;9601701;0;2;-2
447137;202012;352590;J;6202300;1;0;1
447237;202012;352590;H;4930202;0;1;-1
448083;202012;352590;P;8512100;0;2;-2
448221;202012;352590;I;5611201;1;0;1
448222;202012;352590;I;5611201;1;0;1
448332;202012;352590;M;7112000;0;2;-2
448769;202012;352590;G;4771701;1;1;0
449245;202012;352590;M;7112000;1;0;1
449405;202012;352590;H;4930202;1;0;1
449704;202012;352590;I;5611201;0;3;-3
449864;202012;352590;F;4299599;0;1;-1
449921;202012;352590;I;5620101;1;2;-1
450012;202012;352590;G;4781400;0;1;-1
450039;202012;352590;G;4711301;5;5;0
450373;202012;352590;F;4321500;0;2;-2
450776;202012;352590;G;4511102;0;1;-1
450815;202012;352590;I;5611201;3;1;2
451721;202012;352590;I;5620104;0;2;-2
451738;202012;352590;N;8111700;2;0;2
451765;202012;352590;G;4783101;1;1;0
452190;202012;352590;N;8291100;2;0;2
452476;202012;352590;M;7119701;0;1;-1
452937;202012;352590;G;4711302;1;1;0
453232;202012;352590;I;5611201;0;3;-3
453524;202012;352590;R;9313100;1;0;1
453920;202012;352590;Q;8640299;1;0;1
454179;202012;352590;H;4930202;7;0;7
454682;202012;352590;G;4713002;0;1;-1
454776;202012;352590;G;4520005;1;1;0
454782;202012;352590;C;1099699;0;1;-1
455525;202012;352590;G;4781400;0;1;-1
455588;202012;352590;G;4781400;3;4;-1
455931;202012;352590;P;8513900;0;1;-1
456711;202012;352590;H;5320202;13;5;8
457251;202012;352590;F;4321500;1;2;-1
457570;202012;352590;L;6821802;2;0;2
457644;202012;352590;G;4530702;0;1;-1
457672;202012;352590;P;8593700;5;0;5
457965;202012;352590;G;4782201;2;0;2
458525;202012;352590;J;6209100;0;1;-1
459224;202012;352590;H;4930201;1;1;0
459402;202012;352590;N;8111700;0;2;-2
459526;202012;352590;N;7810800;3;2;1
459726;202012;352590;N;8121400;1;0;1
459727;202012;352590;N;8121400;0;1;-1
459800;202012;352590;I;5620104;0;2;-2
460049;202012;352590;G;4789001;3;1;2
460340;202012;352590;F;4299599;2;1;1
460625;202012;352590;G;4639701;53;13;40
460714;202012;352590;C;2539000;1;0;1
460957;202012;352590;P;8599699;1;0;1
461194;202012;352590;N;7739099;32;8;24
461538;202012;352590;G;4637199;4;2;2
462154;202012;352590;G;4761003;3;0;3
462549;202012;352590;I;5620103;2;0;2
462835;202012;352590;S;9602502;0;1;-1
463411;202012;352590;P;8599604;2;1;1
464047;202012;352590;M;7119701;1;0;1
464443;202012;352590;Q;8630503;0;1;-1
464772;202012;352590;K;6622300;0;1;-1
465177;202012;352590;G;4729699;0;1;-1
465699;202012;352590;N;7732201;0;3;-3
466067;202012;352590;I;5611203;0;1;-1
466170;202012;352590;G;4721104;2;0;2
466519;202012;352590;C;2222600;1;1;0
467040;202012;352590;H;5229099;1;0;1
467250;202012;352590;G;4774100;1;0;1
467534;202012;352590;F;4399199;2;0;2
467593;202012;352590;G;4722902;0;1;-1
467819;202012;352590;H;5223100;5;4;1
468044;202012;352590;G;4724500;1;1;0
468579;202012;352590;I;5620104;0;1;-1
468715;202012;352590;G;4729699;0;1;-1
468841;202012;352590;K;6619302;4;0;4
468911;202012;352590;I;5611203;0;1;-1
468964;202012;352590;N;8111700;0;1;-1
469126;202012;352590;C;1413401;1;0;1
469417;202012;352590;S;9499500;0;10;-10
470103;202012;352590;I;5611203;0;1;-1
470750;202012;352590;G;4789002;0;4;-4
470889;202012;352590;G;4781400;2;0;2
470925;202012;352590;I;5611201;1;0;1
471087;202012;352590;N;8211300;0;7;-7
471571;202012;352590;G;4511102;0;1;-1
471743;202012;352590;G;4781400;3;4;-1
472069;202012;352590;G;4621400;1;0;1
472406;202012;352590;G;4742300;0;3;-3
472514;202012;352590;G;4530703;1;0;1
473853;202012;352590;G;4712100;2;0;2
474438;202012;352590;G;4771701;0;1;-1
474687;202012;352590;C;2061400;0;1;-1
474785;202012;352590;N;8219999;1;0;1
474917;202012;352590;P;8512100;0;2;-2
475179;202012;352590;M;7112000;7;1;6
477545;202012;352590;P;8520100;0;10;-10
478211;202012;352590;G;4774100;1;1;0
478285;202012;352590;G;4789099;0;1;-1
478477;202012;352590;N;8211300;3;0;3
478780;202012;352590;I;5611201;0;1;-1
479421;202012;352590;I;5611203;1;0;1
479712;202012;352590;S;9601701;2;1;1
479926;202012;352590;N;8219999;0;1;-1
480634;202012;352590;H;4930202;1;1;0
481186;202012;352590;N;8111700;2;0;2
481537;202012;352590;A;163600;0;67;-67
481572;202012;352590;H;4930202;0;1;-1
481649;202012;352590;G;4772500;1;0;1
481972;202012;352590;N;8219999;1;0;1
482049;202012;352590;C;3314707;0;1;-1
482224;202012;352590;N;8299799;3;0;3
483000;202012;352590;H;4930201;4;0;4
483200;202012;352590;G;4520006;1;0;1
483210;202012;352590;I;5611201;1;0;1
483356;202012;352590;G;4754701;0;1;-1
484343;202012;352590;N;8230001;0;3;-3
484423;202012;352590;G;4711302;11;18;-7
484683;202012;352590;N;7722500;1;3;-2
485196;202012;352590;G;4711302;2;7;-5
486213;202012;352590;G;4752100;1;0;1
486222;202012;352590;I;5611201;1;0;1
486261;202012;352590;I;5611201;0;1;-1
486390;202012;352590;G;4753900;1;0;1
486576;202012;352590;G;4753900;91;39;52
486577;202012;352590;G;4753900;3;3;0
486578;202012;352590;G;4753900;1;1;0
486579;202012;352590;G;4753900;0;1;-1
487005;202012;352590;G;4753900;21;52;-31
487081;202012;352590;G;4753900;0;1;-1
487628;202012;352590;G;4712100;0;1;-1
487629;202012;352590;G;4712100;2;1;1
487698;202012;352590;J;6201501;2;1;1
487890;202012;352590;I;5620104;0;1;-1
488245;202012;352590;C;1812100;0;2;-2
489090;202012;352590;I;5611201;1;0;1
489121;202012;352590;H;4930202;0;261;-261
489563;202012;352590;G;4781400;19;7;12
489663;202012;352590;G;4781400;12;6;6
489963;202012;352590;H;4930202;1;0;1
490273;202012;352590;A;210107;0;1;-1
490285;202012;352590;G;4781400;0;1;-1
490630;202012;352590;G;4744005;1;0;1
490792;202012;352590;H;4930202;0;2;-2
490885;202012;352590;I;5611201;0;1;-1
491221;202012;352590;C;2539001;2;0;2
491305;202012;352590;G;4781400;4;0;4
491432;202012;352590;F;4330404;0;1;-1
491485;202012;352590;N;8020001;0;1;-1
491576;202012;352590;I;5611201;0;2;-2
492505;202012;352590;N;8219999;0;1;-1
492523;202012;352590;M;7112000;1;0;1
493045;202012;352590;C;1091102;1;0;1
494355;202012;352590;C;3321000;2;2;0
494378;202012;352590;C;1013901;2;0;2
494931;202012;352590;C;2812700;0;12;-12
495149;202012;352590;C;2062200;2;0;2
496783;202012;352590;G;4637199;0;1;-1
496880;202012;352590;P;8599603;0;2;-2
496927;202012;352590;P;8513900;0;2;-2
496967;202012;352590;I;5611201;0;1;-1
497171;202012;352590;I;5611203;0;1;-1
497411;202012;352590;I;5611203;0;1;-1
497630;202012;352590;F;4110700;1;0;1
498899;202012;352590;P;8512100;0;5;-5
500078;202012;352590;Q;8711502;5;2;3
500451;202012;352590;G;4752100;0;1;-1
500763;202012;352590;G;4744001;0;2;-2
500911;202012;352590;G;4782201;0;2;-2
502913;202012;352590;I;5611201;1;3;-2
503703;202012;352590;F;4299599;1;2;-1
504095;202012;352590;G;4731800;1;0;1
504748;202012;352590;M;6911701;1;0;1
504851;202012;352590;G;4763602;6;4;2
505041;202012;352590;Q;8640202;6;0;6
505956;202012;352590;G;4785799;1;0;1
506635;202012;352590;G;4511102;1;0;1
507047;202012;352590;H;5229099;0;6;-6
507854;202012;352590;G;4781400;1;3;-2
507890;202012;352590;Q;8630504;1;0;1
508358;202012;352590;H;5211702;1;0;1
508664;202012;352590;C;1721400;1;2;-1
508760;202012;352590;G;4771701;1;0;1
509951;202012;352590;G;4669999;3;3;0
509953;202012;352590;G;4669999;1;1;0
510013;202012;352590;G;4729602;1;1;0
510124;202012;352590;I;5620104;1;2;-1
510429;202012;352590;M;7112000;0;3;-3
510631;202012;352590;I;5611201;1;1;0
511373;202012;352590;I;5611203;3;2;1
511409;202012;352590;I;5611203;1;0;1
512118;202012;352590;C;3299003;1;2;-1
512363;202012;352590;N;8211300;2;0;2
512479;202012;352590;G;4772500;1;0;1
512798;202012;352590;G;4759899;3;0;3
513810;202012;352590;G;4771701;2;1;1
514521;202012;352590;N;8230001;1;0;1
514782;202012;352590;G;4763602;1;1;0
515205;202012;352590;C;1091102;0;1;-1
515230;202012;352590;I;5620101;4;1;3
515881;202012;352590;G;4771701;2;1;1
515900;202012;352590;N;8230001;7;9;-2
516194;202012;352590;N;8211300;8;3;5
516286;202012;352590;G;4530703;0;1;-1
516942;202012;352590;C;3092000;2;0;2
516954;202012;352590;C;3314799;2;0;2
516955;202012;352590;G;4774100;2;2;0
516957;202012;352590;G;4774100;6;6;0
516959;202012;352590;G;4774100;6;4;2
517364;202012;352590;G;4721102;2;0;2
518030;202012;352590;I;5611201;0;2;-2
518645;202012;352590;R;9329899;2;3;-1
519274;202012;352590;I;5611203;1;0;1
519285;202012;352590;G;4731800;2;2;0
519309;202012;352590;R;9313100;4;2;2
519955;202012;352590;N;8211300;2;1;1
520038;202012;352590;R;9319199;0;1;-1
521068;202012;352590;P;8513900;0;1;-1
521301;202012;352590;I;5620104;1;0;1
521722;202012;352590;G;4744099;1;0;1
522582;202012;352590;H;5320201;1;1;0
525051;202012;352590;G;4633801;2;0;2
525216;202012;352590;S;9602502;1;0;1
526192;202012;352590;J;6203100;2;1;1
526245;202012;352590;F;4329199;14;3;11
526286;202012;352590;I;5611201;2;1;1
527007;202012;352590;G;4781400;1;1;0
527067;202012;352590;N;8121400;0;1;-1
527126;202012;352590;N;8111700;1;4;-3
527144;202012;352590;C;1091102;1;0;1
527207;202012;352590;I;5620104;2;0;2
527313;202012;352590;G;4713002;2;0;2
527936;202012;352590;N;8291100;5;3;2
527978;202012;352590;G;4729699;1;0;1
529449;202012;352590;G;4723700;1;0;1
529527;202012;352590;H;4930202;0;42;-42
529528;202012;352590;G;4761003;0;1;-1
529826;202012;352590;G;4781400;0;1;-1
529947;202012;352590;Q;8711502;1;1;0
531701;202012;352590;H;4930202;1;0;1
532340;202012;352590;H;4930202;1;2;-1
532980;202012;352590;M;7319002;9;5;4
533323;202012;352590;I;5620104;0;1;-1
533491;202012;352590;C;3329501;0;1;-1
533739;202012;352590;G;4782201;4;0;4
534544;202012;352590;N;8111700;10;2;8
534663;202012;352590;F;4120400;0;2;-2
534683;202012;352590;G;4751201;1;0;1
534857;202012;352590;G;4723700;1;0;1
535133;202012;352590;I;5611201;0;3;-3
535737;202012;352590;G;4781400;5;0;5
536830;202012;352590;G;4781400;1;0;1
536991;202012;352590;G;4789099;1;0;1
537365;202012;352590;I;5611203;1;1;0
537603;202012;352590;H;5320201;0;1;-1
538434;202012;352590;R;9313100;4;0;4
538574;202012;352590;N;7732201;1;0;1
538602;202012;352590;G;4781400;1;0;1
538623;202012;352590;N;8211300;2;0;2
538891;202012;352590;G;4729699;2;0;2
539211;202012;352590;N;8291100;1;0;1
539457;202012;352590;I;5611201;1;0;1
539952;202012;352590;G;4729602;2;0;2
541716;202012;352590;G;4781400;2;0;2
544048;202012;352590;M;7490104;8;1;7
544206;202012;352590;H;5320202;3;0;3
544263;202012;352590;G;4686902;8;1;7
544318;202012;352590;N;8211300;2;0;2
544365;202012;352590;S;9602502;2;0;2
544402;202012;352590;J;6209100;13;4;9
544576;202012;352590;S;9602502;3;0;3
544777;202012;352590;I;5611201;1;3;-2
545124;202012;352590;Q;8630503;1;0;1
545303;202012;352590;G;4520002;1;1;0
545380;202012;352590;C;1091102;3;0;3
545440;202012;352590;G;4789001;1;0;1
545854;202012;352590;I;5611203;0;1;-1
546778;202012;352590;G;4782201;1;0;1
547209;202012;352590;P;8599604;2;0;2
547258;202012;352590;P;8532500;0;1;-1
547698;202012;352590;F;4222701;0;1;-1
547699;202012;352590;F;4222701;0;1;-1
547845;202012;352590;G;4789099;0;1;-1
547857;202012;352590;G;4713001;1;1;0
547873;202012;352590;I;5611201;2;0;2
549075;202012;352590;N;8299706;3;0;3
549083;202012;352590;F;4110700;1;0;1
550012;202012;352590;G;4729699;0;1;-1
551299;202012;352590;G;4755501;1;0;1
551723;202012;352590;I;5611203;4;0;4
551795;202012;352590;I;5611201;0;2;-2
552032;202012;352590;G;4520001;1;0;1
553037;202012;352590;G;4772500;4;0;4
553304;202012;352590;I;5611203;3;1;2
553477;202012;352590;G;4713002;1;0;1
553526;202012;352590;G;4635499;3;0;3
553813;202012;352590;H;5250804;13;1;12
553856;202012;352590;S;9602502;2;0;2
554346;202012;352590;G;4689302;1;0;1
554909;202012;352590;G;4520005;1;0;1
555932;202012;352590;J;6141800;0;1;-1
556878;202012;352590;H;4930202;1;0;1
558797;202012;352590;I;5611203;4;5;-1
558898;202012;352590;C;1062700;2;5;-3
558899;202012;352590;C;1062700;0;4;-4
559468;202012;352590;C;1813099;1;1;0
559685;202012;352590;H;5222200;1;0;1
559872;202012;352590;G;4647801;1;0;1
560039;202012;352590;C;2091600;0;2;-2
560122;202012;352590;S;9412099;0;1;-1
560614;202012;352590;G;4753900;1;0;1
560626;202012;352590;G;4753900;1;0;1
560680;202012;352590;H;4930202;3;1;2
560687;202012;352590;F;4120400;5;7;-2
560688;202012;352590;N;8299706;0;1;-1
560853;202012;352590;G;4772500;2;2;0
560873;202012;352590;C;2019399;3;5;-2
560936;202012;352590;C;2599399;0;3;-3
560937;202012;352590;C;2599399;1;17;-16
561081;202012;352590;C;2710402;24;10;14
561789;202012;352590;G;4744005;3;1;2
561790;202012;352590;S;9430800;2;2;0
561791;202012;352590;S;9412099;1;0;1
561792;202012;352590;C;2592602;4;2;2
561794;202012;352590;M;6920601;1;0;1
561797;202012;352590;K;6550200;15;25;-10
561813;202012;352590;K;6550200;1;2;-1
561866;202012;352590;K;6550200;10;0;10
561895;202012;352590;G;4789002;0;1;-1
561896;202012;352590;Q;8650004;2;0;2
561897;202012;352590;M;6920601;0;1;-1
561898;202012;352590;S;9420100;0;1;-1
561899;202012;352590;G;4755502;1;0;1
562044;202012;352590;C;2013402;1;11;-10
562045;202012;352590;C;2013402;2;0;2
562559;202012;352590;I;5611201;2;0;2
562710;202012;352590;G;4781400;12;0;12
562874;202012;352590;G;4781400;6;1;5
563173;202012;352590;F;4120400;0;1;-1
563312;202012;352590;G;4782201;3;3;0
563314;202012;352590;G;4782201;5;3;2
563317;202012;352590;G;4782201;3;1;2
563320;202012;352590;G;4782201;1;1;0
563321;202012;352590;G;4782201;3;7;-4
563322;202012;352590;G;4782201;1;0;1
563409;202012;352590;G;4711301;10;8;2
563526;202012;352590;G;4731800;3;1;2
563665;202012;352590;G;4771701;1;1;0
563891;202012;352590;C;2821601;2;2;0
563901;202012;352590;G;4672900;1;0;1
563904;202012;352590;O;8411600;24;8;16
563905;202012;352590;G;4722901;0;1;-1
564274;202012;352590;G;4782201;4;4;0
564508;202012;352590;C;3250705;0;4;-4
564656;202012;352590;C;2063100;2;6;-4
564666;202012;352590;C;2651500;0;1;-1
564730;202012;352590;G;4781400;7;2;5
565113;202012;352590;G;4744002;1;3;-2
565128;202012;352590;H;4930202;0;2;-2
565129;202012;352590;G;4639701;1;3;-2
565149;202012;352590;G;4754701;1;1;0
565150;202012;352590;N;8299706;0;1;-1
565151;202012;352590;F;4313400;0;5;-5
565152;202012;352590;H;4929902;0;1;-1
565215;202012;352590;G;4781400;15;14;1
565319;202012;352590;N;8111700;5;2;3
565361;202012;352590;M;6920601;0;1;-1
565362;202012;352590;C;2342702;1;0;1
565388;202012;352590;H;4930202;1;0;1
565604;202012;352590;G;4781400;2;1;1
565982;202012;352590;G;4530703;0;1;-1
566062;202012;352590;G;4711302;0;2;-2
566443;202012;352590;G;4711302;2;2;0
566728;202012;352590;Q;8640202;1;0;1
566731;202012;352590;Q;8690999;1;1;0
566742;202012;352590;Q;8640299;1;0;1
566748;202012;352590;Q;8640202;7;7;0
567008;202012;352590;G;4789002;1;0;1
567009;202012;352590;G;4637107;1;0;1
567279;202012;352590;G;4713001;1;0;1
567576;202012;352590;G;4713001;0;1;-1
568521;202012;352590;G;4774100;1;1;0
568538;202012;352590;H;4921301;0;3;-3
568780;202012;352590;G;4731800;0;2;-2
569330;202012;352590;H;5211799;0;2;-2
569415;202012;352590;Q;8640205;4;4;0
569467;202012;352590;C;2229399;0;2;-2
569624;202012;352590;S;9430800;1;0;1
569710;202012;352590;G;4781400;1;0;1
569758;202012;352590;G;4741500;1;0;1
570133;202012;352590;I;5620101;0;2;-2
570403;202012;352590;I;5620101;0;1;-1
570417;202012;352590;I;5620101;0;1;-1
570512;202012;352590;I;5620101;1;0;1
570640;202012;352590;G;4772500;1;0;1
570654;202012;352590;P;8599601;0;1;-1
570655;202012;352590;C;1813099;1;1;0
570656;202012;352590;M;6920601;1;3;-2
570657;202012;352590;I;5611203;0;1;-1
570658;202012;352590;G;4530703;1;1;0
570746;202012;352590;P;8599699;0;19;-19
570772;202012;352590;G;4755503;0;1;-1
570832;202012;352590;G;4761003;1;0;1
571076;202012;352590;C;1330800;21;20;1
571079;202012;352590;F;4313400;1;2;-1
571151;202012;352590;C;1813099;0;1;-1
571393;202012;352590;K;6550200;2;1;1
571398;202012;352590;K;6550200;0;1;-1
571399;202012;352590;K;6550200;13;11;2
571573;202012;352590;G;4731800;0;1;-1
571596;202012;352590;H;4921301;1;6;-5
571602;202012;352590;C;1122401;2;1;1
571603;202012;352590;C;1081302;1;1;0
571604;202012;352590;M;6920601;0;1;-1
571605;202012;352590;C;1112700;1;0;1
571607;202012;352590;G;4783101;1;0;1
571608;202012;352590;G;4744099;1;0;1
571609;202012;352590;C;1112700;1;0;1
571610;202012;352590;K;6463800;1;0;1
571611;202012;352590;G;4530703;2;2;0
571613;202012;352590;C;1011201;1;0;1
571614;202012;352590;G;4731800;2;0;2
571617;202012;352590;P;8513900;5;20;-15
571618;202012;352590;G;4511101;1;0;1
571621;202012;352590;R;9312300;0;6;-6
571626;202012;352590;C;2219600;10;12;-2
571629;202012;352590;C;1099601;3;0;3
571630;202012;352590;G;4744001;0;1;-1
571631;202012;352590;C;1629301;5;6;-1
571633;202012;352590;G;4729699;1;0;1
571635;202012;352590;K;6622300;7;2;5
571640;202012;352590;G;4530703;0;1;-1
571644;202012;352590;G;4511104;1;1;0
571645;202012;352590;G;4530705;1;0;1
571646;202012;352590;C;2212900;1;1;0
571648;202012;352590;H;4929902;3;2;1
571649;202012;352590;G;4712100;2;0;2
571651;202012;352590;Q;8610101;11;40;-29
571653;202012;352590;G;4541203;1;0;1
571654;202012;352590;G;4771701;1;0;1
571659;202012;352590;G;4731800;1;1;0
571660;202012;352590;G;4711302;0;1;-1
571661;202012;352590;G;4711302;2;0;2
571663;202012;352590;G;4711302;80;10;70
571666;202012;352590;G;4711302;1;1;0
571668;202012;352590;G;4711302;2;1;1
571670;202012;352590;G;4731800;1;0;1
571671;202012;352590;G;4711302;7;4;3
571672;202012;352590;G;4711302;1;1;0
571673;202012;352590;G;4711302;11;9;2
571674;202012;352590;G;4711302;3;5;-2
571676;202012;352590;G;4711302;8;7;1
571678;202012;352590;G;4711302;11;5;6
571680;202012;352590;G;4711302;1;1;0
571682;202012;352590;G;4711302;7;3;4
571683;202012;352590;G;4711302;5;3;2
571684;202012;352590;G;4711302;12;7;5
571685;202012;352590;H;4921301;1;4;-3
571686;202012;352590;C;1311100;18;18;0
571687;202012;352590;C;2229301;4;41;-37
571688;202012;352590;C;2229301;2;41;-39
571689;202012;352590;C;2229301;1;47;-46
571690;202012;352590;C;2229301;0;1;-1
571691;202012;352590;C;2229301;1;20;-19
571694;202012;352590;Q;8730102;14;0;14
571695;202012;352590;Q;8730102;5;0;5
571701;202012;352590;Q;8800600;0;1;-1
571704;202012;352590;G;4511101;3;1;2
571711;202012;352590;S;9430800;0;1;-1
571712;202012;352590;G;4721104;0;1;-1
571718;202012;352590;Q;8610101;3;2;1
571721;202012;352590;Q;8610101;16;21;-5
571722;202012;352590;C;2342702;5;1;4
571724;202012;352590;P;8511200;0;1;-1
571731;202012;352590;Q;8711502;6;7;-1
571742;202012;352590;G;4711302;10;7;3
571743;202012;352590;G;4711302;4;5;-1
571744;202012;352590;G;4711302;12;1;11
571745;202012;352590;G;4711302;11;2;9
571747;202012;352590;G;4711302;8;2;6
571749;202012;352590;M;6920601;3;0;3
571750;202012;352590;S;9420100;9;0;9
571757;202012;352590;S;9420100;4;0;4
571758;202012;352590;S;9491000;0;1;-1
571759;202012;352590;S;9491000;0;1;-1
571761;202012;352590;S;9491000;0;1;-1
571762;202012;352590;S;9491000;0;1;-1
571763;202012;352590;S;9491000;1;1;0
571764;202012;352590;S;9491000;0;1;-1
571765;202012;352590;S;9491000;1;0;1
571767;202012;352590;S;9491000;1;1;0
571768;202012;352590;S;9491000;0;1;-1
571772;202012;352590;G;4633801;4;3;1
571774;202012;352590;H;4929902;2;0;2
571776;202012;352590;P;8531700;0;1;-1
571781;202012;352590;S;9430800;0;1;-1
571836;202012;352590;C;1053800;1;2;-1
572017;202012;352590;N;8211300;2;1;1
572073;202012;352590;G;4759899;1;0;1
572080;202012;352590;P;8513900;0;4;-4
572083;202012;352590;G;4541203;0;1;-1
572103;202012;352590;C;2071100;0;7;-7
572386;202012;352590;C;1013901;0;3;-3
572809;202012;352590;Q;8640202;2;1;1
572810;202012;352590;Q;8640202;2;1;1
572811;202012;352590;Q;8640202;0;2;-2
572812;202012;352590;Q;8640202;1;0;1
572814;202012;352590;Q;8640205;0;1;-1
572815;202012;352590;Q;8650004;0;10;-10
572816;202012;352590;Q;8640202;3;1;2
572817;202012;352590;H;4930202;0;2;-2
572845;202012;352590;Q;8610101;6;8;-2
572881;202012;352590;P;8520100;0;3;-3
572882;202012;352590;S;9430800;1;1;0
572883;202012;352590;S;9499500;2;1;1
572893;202012;352590;G;4647801;0;2;-2
572962;202012;352590;C;1622699;0;1;-1
572993;202012;352590;H;5112901;2;0;2
573044;202012;352590;G;4771701;0;1;-1
573114;202012;352590;C;3250707;2;7;-5
573186;202012;352590;C;2342702;6;6;0
573199;202012;352590;G;4661300;15;6;9
573365;202012;352590;P;8512100;0;3;-3
573385;202012;352590;N;8112500;1;0;1
573386;202012;352590;N;7820500;3;0;3
573428;202012;352590;G;4639701;3;3;0
573442;202012;352590;G;4744099;0;3;-3
573469;202012;352590;H;4930202;5;3;2
573488;202012;352590;G;4782201;14;9;5
573489;202012;352590;G;4782201;28;23;5
573639;202012;352590;H;4930202;3;4;-1
573703;202012;352590;G;4771702;13;8;5
573803;202012;352590;G;4755502;1;1;0
573808;202012;352590;I;5611201;0;1;-1
573905;202012;352590;G;4530703;1;0;1
573921;202012;352590;G;4530701;0;1;-1
574044;202012;352590;G;4721102;2;2;0
574073;202012;352590;C;1031700;3;9;-6
574414;202012;352590;G;4789004;3;2;1
574648;202012;352590;G;4669999;0;5;-5
574737;202012;352590;G;4789004;0;1;-1
575089;202012;352590;G;4663000;1;0;1
575090;202012;352590;G;4663000;1;0;1
575332;202012;352590;C;2222600;4;0;4
575466;202012;352590;H;4930201;1;0;1
575729;202012;352590;Q;8640203;3;2;1
575761;202012;352590;G;4530705;0;1;-1
575785;202012;352590;R;9313100;0;1;-1
575786;202012;352590;Q;8711501;1;0;1
575789;202012;352590;M;7112000;1;0;1
575790;202012;352590;S;9420100;0;1;-1
575791;202012;352590;P;8513900;0;6;-6
575793;202012;352590;P;8512100;0;1;-1
575794;202012;352590;N;8112500;0;1;-1
575912;202012;352590;G;4712100;4;1;3
575933;202012;352590;F;4329103;0;1;-1
576447;202012;352590;G;4520001;1;0;1
576500;202012;352590;G;4744002;0;1;-1
576535;202012;352590;G;4712100;2;0;2
576536;202012;352590;G;4712100;0;1;-1
576714;202012;352590;G;4744005;2;0;2
576774;202012;352590;G;4530703;1;0;1
576775;202012;352590;L;6821801;1;0;1
576776;202012;352590;Q;8630504;0;1;-1
576777;202012;352590;R;9313100;1;0;1
576837;202012;352590;G;4511101;7;3;4
576843;202012;352590;I;5620101;2;0;2
576859;202012;352590;G;4687702;0;2;-2
576921;202012;352590;C;1093702;0;2;-2
576962;202012;352590;F;4322301;0;1;-1
577028;202012;352590;G;4530703;0;1;-1
577237;202012;352590;G;4789007;1;0;1
577349;202012;352590;F;4399199;0;1;-1
577445;202012;352590;H;4923002;0;1;-1
577944;202012;352590;F;4313400;0;2;-2
578084;202012;352590;G;4649499;0;1;-1
578167;202012;352590;G;4661300;5;0;5
578259;202012;352590;C;2449199;0;1;-1
578308;202012;352590;H;4930203;0;1;-1
578416;202012;352590;G;4763604;1;0;1
578453;202012;352590;M;7210000;0;2;-2
578624;202012;352590;I;5510803;0;2;-2
578847;202012;352590;G;4781400;0;1;-1
578929;202012;352590;H;5223100;0;1;-1
579160;202012;352590;G;4753900;2;0;2
579188;202012;352590;G;4753900;1;2;-1
579342;202012;352590;K;6550200;0;1;-1
579343;202012;352590;Q;8630502;2;3;-1
579344;202012;352590;Q;8610102;1;0;1
579345;202012;352590;Q;8621601;1;0;1
579346;202012;352590;Q;8610101;10;6;4
579437;202012;352590;H;4930202;1;0;1
579563;202012;352590;G;4761003;1;0;1
579595;202012;352590;G;4520001;0;1;-1
579747;202012;352590;F;4321500;0;1;-1
579985;202012;352590;G;4731800;0;1;-1
580209;202012;352590;G;4530703;1;0;1
580213;202012;352590;G;4774100;1;0;1
580499;202012;352590;G;4721103;1;0;1
580558;202012;352590;H;4930202;0;2;-2
580604;202012;352590;G;4530703;1;0;1
580677;202012;352590;K;6493000;0;1;-1
580795;202012;352590;C;2099199;4;7;-3
580867;202012;352590;C;2539002;2;2;0
580872;202012;352590;C;2592602;4;3;1
580907;202012;352590;G;4781400;0;1;-1
580959;202012;352590;H;4930202;0;4;-4
580993;202012;352590;G;4771701;1;0;1
581107;202012;352590;K;6493000;0;1;-1
581263;202012;352590;K;6422100;0;1;-1
581309;202012;352590;J;6204000;1;1;0
581346;202012;352590;N;8299706;1;1;0
581449;202012;352590;I;5611201;0;1;-1
581534;202012;352590;I;5611201;1;2;-1
581545;202012;352590;G;4781400;1;0;1
581604;202012;352590;I;5611203;2;1;1
581654;202012;352590;N;8121400;0;1;-1
581657;202012;352590;H;5223100;1;1;0
581658;202012;352590;H;5223100;0;1;-1
581659;202012;352590;N;8112500;0;2;-2
581660;202012;352590;P;8512100;0;1;-1
581818;202012;352590;G;4761003;0;1;-1
581885;202012;352590;G;4763601;1;0;1
581930;202012;352590;F;4221902;1;2;-1
581981;202012;352590;H;4929902;52;3;49
582002;202012;352590;I;5611201;2;1;1
582003;202012;352590;I;5611201;0;1;-1
582056;202012;352590;G;4763601;12;10;2
582358;202012;352590;G;4635402;3;6;-3
582395;202012;352590;G;4731800;0;1;-1
582450;202012;352590;C;2229399;9;7;2
582476;202012;352590;H;4930202;1;5;-4
582518;202012;352590;N;8112500;0;1;-1
582519;202012;352590;Q;8640205;1;1;0
582557;202012;352590;P;8512100;0;7;-7
582558;202012;352590;P;8512100;0;2;-2
582570;202012;352590;N;8112500;1;0;1
582622;202012;352590;G;4781400;0;1;-1
582684;202012;352590;C;2944100;13;21;-8
582721;202012;352590;C;1629301;2;0;2
582967;202012;352590;K;6422100;0;1;-1
583079;202012;352590;G;4520001;2;0;2
583100;202012;352590;F;4292802;2;19;-17
583209;202012;352590;H;4930202;1;1;0
583240;202012;352590;G;4721102;1;1;0
583340;202012;352590;E;3839401;0;1;-1
583487;202012;352590;G;4731800;1;0;1
583524;202012;352590;N;7732201;1;0;1
583542;202012;352590;G;4741500;1;0;1
583638;202012;352590;G;4789004;1;0;1
583707;202012;352590;G;4633802;0;1;-1
583733;202012;352590;G;4731800;4;1;3
583740;202012;352590;G;4731800;1;0;1
583762;202012;352590;C;1314600;2;1;1
584590;202012;352590;M;7210000;1;8;-7
584722;202012;352590;C;2522500;9;6;3
584994;202012;352590;Q;8610101;2;5;-3
585036;202012;352590;C;2014200;2;0;2
585135;202012;352590;C;1412601;0;1;-1
585150;202012;352590;C;2812700;0;1;-1
585389;202012;352590;K;6422100;0;1;-1
585935;202012;352590;K;6422100;0;1;-1
586020;202012;352590;K;6422100;0;1;-1
586176;202012;352590;K;6422100;0;1;-1
586258;202012;352590;K;6422100;1;0;1
586313;202012;352590;C;2222600;0;7;-7
586320;202012;352590;G;4744005;0;1;-1
586577;202012;352590;G;4511104;1;3;-2
586617;202012;352590;C;2539000;1;0;1
586665;202012;352590;B;810099;1;1;0
586666;202012;352590;C;2330302;2;1;1
586758;202012;352590;P;8513900;0;2;-2
586759;202012;352590;P;8511200;0;2;-2
586979;202012;352590;C;1099603;2;0;2
587128;202012;352590;Q;8800600;0;1;-1
587213;202012;352590;C;3104700;1;0;1
587224;202012;352590;P;8513900;0;3;-3
587226;202012;352590;Q;8711502;0;1;-1
587228;202012;352590;P;8513900;0;9;-9
587352;202012;352590;Q;8640212;1;0;1
587392;202012;352590;S;9491000;0;16;-16
587430;202012;352590;C;2599399;1;1;0
587659;202012;352590;H;4922102;2;0;2
587660;202012;352590;H;4922102;2;0;2
587727;202012;352590;C;2949299;0;1;-1
587728;202012;352590;C;2949299;1;2;-1
587794;202012;352590;G;4713001;0;1;-1
588044;202012;352590;G;4713004;3;4;-1
588248;202012;352590;C;2591800;7;4;3
588299;202012;352590;G;4635402;3;3;0
588307;202012;352590;C;1122401;6;7;-1
588374;202012;352590;G;4781400;0;3;-3
588442;202012;352590;G;4781400;1;1;0
588634;202012;352590;C;1721400;2;5;-3
588680;202012;352590;C;3299002;0;4;-4
588739;202012;352590;G;4711302;6;3;3
589263;202012;352590;G;4771701;1;0;1
589523;202012;352590;G;4771701;0;1;-1
589601;202012;352590;G;4771701;1;2;-1
589735;202012;352590;C;2949299;15;6;9
590085;202012;352590;N;8211300;10;5;5
590239;202012;352590;C;1411801;2;24;-22
590433;202012;352590;G;4771701;1;0;1
590544;202012;352590;G;4771701;3;0;3
590578;202012;352590;G;4771701;0;1;-1
590718;202012;352590;G;4771701;1;2;-1
590852;202012;352590;G;4771701;1;2;-1
590862;202012;352590;G;4771701;1;0;1
590913;202012;352590;G;4771701;0;1;-1
590929;202012;352590;G;4771701;2;0;2
591127;202012;352590;G;4771701;1;0;1
591216;202012;352590;G;4771701;3;0;3
591234;202012;352590;G;4771701;1;0;1
591334;202012;352590;G;4771701;2;0;2
591585;202012;352590;Q;8800600;16;7;9
591625;202012;352590;Q;8800600;0;2;-2
591666;202012;352590;G;4635402;0;1;-1
591904;202012;352590;N;8112500;1;0;1
591907;202012;352590;N;8121400;59;53;6
591991;202012;352590;G;4743100;0;2;-2
592023;202012;352590;G;4782202;1;0;1
592024;202012;352590;G;4782202;1;2;-1
592765;202012;352590;G;4744005;0;1;-1
592827;202012;352590;G;4759899;1;1;0
592955;202012;352590;C;2592601;1;0;1
593019;202012;352590;G;4637107;0;1;-1
593062;202012;352590;F;4321500;8;3;5
593424;202012;352590;I;5611203;0;1;-1
593802;202012;352590;G;4789002;6;4;2
593817;202012;352590;C;2229301;0;1;-1
593969;202012;352590;G;4744099;1;0;1
594943;202012;352590;J;6204000;0;2;-2
594949;202012;352590;J;6209100;1;1;0
594960;202012;352590;Q;8660700;4;6;-2
595047;202012;352590;G;4771701;0;1;-1
595059;202012;352590;H;4930202;1;1;0
595080;202012;352590;G;4731800;2;2;0
595081;202012;352590;P;8513900;0;2;-2
595532;202012;352590;L;6821802;0;1;-1
595746;202012;352590;F;4120400;1;1;0
595749;202012;352590;C;3314710;7;7;0
595802;202012;352590;G;4731800;1;0;1
596538;202012;352590;G;4731800;1;1;0
596581;202012;352590;G;4530703;1;0;1
596752;202012;352590;G;4663000;0;1;-1
596788;202012;352590;F;4330401;0;2;-2
597083;202012;352590;G;4711302;39;27;12
597121;202012;352590;C;1099699;0;2;-2
597258;202012;352590;G;4783101;1;0;1
597327;202012;352590;G;4783101;2;0;2
597839;202012;352590;G;4789099;0;1;-1
597861;202012;352590;G;4684201;0;1;-1
597913;202012;352590;N;7739099;3;7;-4
597933;202012;352590;I;5611203;6;2;4
597934;202012;352590;I;5611203;4;4;0
598055;202012;352590;G;4789099;1;0;1
598536;202012;352590;N;8111700;29;16;13
598549;202012;352590;H;5223100;1;0;1
598550;202012;352590;H;5223100;0;1;-1
598551;202012;352590;P;8512100;0;3;-3
598552;202012;352590;N;8112500;0;2;-2
598553;202012;352590;N;8112500;1;1;0
598554;202012;352590;Q;8690999;2;1;1
598563;202012;352590;P;8513900;0;1;-1
598564;202012;352590;N;8112500;2;0;2
598566;202012;352590;N;8112500;1;0;1
598567;202012;352590;Q;8630501;1;1;0
598569;202012;352590;N;8121400;0;1;-1
598570;202012;352590;Q;8640207;3;3;0
598636;202012;352590;G;4771701;3;2;1
598665;202012;352590;J;6311900;0;1;-1
598710;202012;352590;G;4744005;2;0;2
598750;202012;352590;G;4530703;0;1;-1
598875;202012;352590;G;4520001;1;0;1
598885;202012;352590;C;2014200;3;5;-2
598909;202012;352590;G;4711302;2;0;2
598910;202012;352590;C;1013901;2;0;2
598911;202012;352590;G;4722901;2;1;1
598977;202012;352590;F;4120400;14;9;5
599110;202012;352590;F;4120400;4;4;0
599208;202012;352590;G;4729699;5;5;0
599318;202012;352590;G;4789099;1;1;0
599366;202012;352590;C;2229399;7;0;7
599547;202012;352590;I;5620101;0;1;-1
599548;202012;352590;I;5620101;0;3;-3
599558;202012;352590;I;5620101;0;1;-1
599573;202012;352590;I;5620101;1;1;0
599574;202012;352590;I;5620101;1;1;0
599610;202012;352590;I;5620101;3;0;3
599797;202012;352590;N;8112500;1;0;1
599918;202012;352590;G;4530703;0;3;-3
599943;202012;352590;G;4744005;2;0;2
599981;202012;352590;G;4623199;1;0;1
599992;202012;352590;H;4930202;0;1;-1
600120;202012;352590;G;4789001;0;3;-3
600169;202012;352590;G;4721102;1;0;1
600364;202012;352590;G;4761003;0;1;-1
601017;202012;352590;G;4530703;0;1;-1
601031;202012;352590;G;4530703;0;1;-1
601118;202012;352590;G;4771701;1;0;1
601130;202012;352590;J;6203100;0;1;-1
601177;202012;352590;G;4751201;0;1;-1
601282;202012;352590;C;2543800;1;4;-3
601307;202012;352590;C;2330302;2;3;-1
601452;202012;352590;G;4722901;1;0;1
601585;202012;352590;I;5611201;1;0;1
601615;202012;352590;G;4771702;2;2;0
603229;202012;352590;G;4511101;1;0;1
603374;202012;352590;C;2229301;25;26;-1
603622;202012;352590;F;4110700;1;1;0
603697;202012;352590;N;7739099;2;2;0
603710;202012;352590;G;4782202;1;0;1
604043;202012;352590;G;4741500;2;1;1
604044;202012;352590;G;4741500;1;0;1
604046;202012;352590;G;4741500;0;1;-1
604048;202012;352590;G;4741500;0;1;-1
604084;202012;352590;G;4744005;1;1;0
604971;202012;352590;C;3299099;3;1;2
605216;202012;352590;G;4781400;0;2;-2
605239;202012;352590;C;2822402;2;1;1
605409;202012;352590;F;4299599;0;1;-1
605444;202012;352590;G;4789099;1;0;1
605460;202012;352590;G;4731800;1;0;1
605461;202012;352590;G;4731800;0;1;-1
605477;202012;352590;C;2099199;1;3;-2
605478;202012;352590;G;4692300;4;4;0
605610;202012;352590;G;4520005;17;2;15
605723;202012;352590;G;4744001;0;1;-1
605774;202012;352590;J;5813100;1;1;0
605838;202012;352590;G;4743100;0;2;-2
606287;202012;352590;G;4635402;15;9;6
607424;202012;352590;H;5310502;1;2;-1
607478;202012;352590;H;5310502;1;0;1
607871;202012;352590;C;1330800;2;1;1
607908;202012;352590;R;9313100;0;1;-1
608072;202012;352590;G;4771701;0;1;-1
608144;202012;352590;I;5510801;0;1;-1
608163;202012;352590;N;7820500;1;15;-14
608164;202012;352590;I;5611201;0;3;-3
609021;202012;352590;G;4711301;17;16;1
609641;202012;352590;C;2349401;24;10;14
609647;202012;352590;N;8211300;4;3;1
610195;202012;352590;H;4930202;7;4;3
611239;202012;352590;G;4672900;5;5;0
611264;202012;352590;H;4930202;0;1;-1
611921;202012;352590;C;2812700;1;0;1
612600;202012;352590;H;4930203;5;2;3
614466;202012;352590;G;4781400;1;0;1
615150;202012;352590;G;4530703;4;1;3
615604;202012;352590;G;4711301;1;2;-1
617778;202012;352590;I;5510801;2;2;0
620354;202012;352590;K;6424703;1;1;0
620356;202012;352590;K;6424703;4;0;4
620858;202012;352590;H;4930202;17;3;14
621256;202012;352590;G;4639701;0;1;-1
622156;202012;352590;G;4679604;3;6;-3
622662;202012;352590;C;3314710;34;21;13
623650;202012;352590;G;4783101;0;1;-1
627331;202012;352590;G;4661300;4;0;4
628488;202012;352590;C;2330399;0;2;-2
629504;202012;352590;H;4930202;2;5;-3
630895;202012;352590;C;1733800;14;3;11
630896;202012;352590;C;1733800;6;1;5
632175;202012;352590;K;6422100;0;1;-1
632176;202012;352590;K;6422100;0;1;-1
632211;202012;352590;K;6422100;0;1;-1
635847;202012;352590;G;4781400;1;1;0
635956;202012;352590;G;4781400;1;2;-1
638558;202012;352590;I;5620101;2;0;2
640052;202012;352590;C;1733800;3;10;-7
640234;202012;352590;G;4759801;0;1;-1
640545;202012;352590;I;5620101;0;3;-3
640565;202012;352590;G;4771702;0;1;-1
640721;202012;352590;C;2829199;1;0;1
640758;202012;352590;C;2599399;0;1;-1
642261;202012;352590;C;2813500;20;31;-11
642262;202012;352590;C;2349401;13;35;-22
654914;202012;352590;Q;8630504;1;0;1
659389;202012;352590;Q;8630503;1;0;1
14;202008;352590;K;6422100;0;1;-1
389;202008;352590;G;4789099;1;0;1
409;202008;352590;G;4751201;1;0;1
1167;202008;352590;Q;8640202;1;0;1
1563;202008;352590;G;4752100;1;2;-1
2086;202008;352590;G;4772500;0;1;-1
2301;202008;352590;C;2599399;29;5;24
2336;202008;352590;G;4712100;0;1;-1
2429;202008;352590;L;6810202;1;0;1
2982;202008;352590;C;2812700;0;3;-3
3069;202008;352590;C;1091101;0;1;-1
3401;202008;352590;C;2222600;2;2;0
3403;202008;352590;C;2222600;1;1;0
3520;202008;352590;C;2949299;1;7;-6
3674;202008;352590;I;5611203;1;0;1
4164;202008;352590;N;8219901;0;1;-1
4322;202008;352590;C;2040100;19;10;9
4429;202008;352590;N;7739099;3;1;2
4507;202008;352590;N;7810800;41;15;26
4702;202008;352590;K;6622300;3;1;2
5229;202008;352590;G;4789099;3;1;2
5230;202008;352590;C;2512800;1;1;0
5660;202008;352590;C;1732000;3;0;3
5798;202008;352590;K;6436100;0;1;-1
5975;202008;352590;G;4757100;0;1;-1
5997;202008;352590;C;2829199;1;1;0
6135;202008;352590;G;4753900;6;19;-13
6141;202008;352590;G;4753900;0;2;-2
6658;202008;352590;C;2229303;2;1;1
7542;202008;352590;G;4721102;1;0;1
7747;202008;352590;P;8599601;1;1;0
8015;202008;352590;G;4672900;1;1;0
8704;202008;352590;M;6920601;0;1;-1
9071;202008;352590;G;4789099;1;0;1
9660;202008;352590;N;8299706;1;1;0
9921;202008;352590;P;8599601;1;0;1
10140;202008;352590;G;4783101;0;1;-1
10321;202008;352590;H;5211799;7;10;-3
11050;202008;352590;G;4530703;0;1;-1
11074;202008;352590;I;5611203;0;1;-1
11169;202008;352590;Q;8610101;3;7;-4
11464;202008;352590;G;4633801;2;1;1
11726;202008;352590;C;2342702;13;0;13
12267;202008;352590;J;6203100;1;1;0
12364;202008;352590;G;4771702;1;0;1
12366;202008;352590;H;4929902;4;3;1
12528;202008;352590;S;9601703;3;4;-1
12532;202008;352590;S;9601703;25;28;-3
12782;202008;352590;C;1413401;0;1;-1
13086;202008;352590;G;4530703;0;1;-1
13131;202008;352590;M;6920601;0;1;-1
13454;202008;352590;G;4616800;1;0;1
13688;202008;352590;J;6319400;0;14;-14
14695;202008;352590;Q;8640299;2;0;2
14899;202008;352590;H;5229002;0;1;-1
15633;202008;352590;M;6920601;0;1;-1
16435;202008;352590;I;5611203;0;1;-1
16516;202008;352590;C;3240099;1;0;1
16589;202008;352590;C;2731700;2;5;-3
16695;202008;352590;G;4693100;5;7;-2
16758;202008;352590;G;4511101;4;2;2
16897;202008;352590;L;6821801;1;0;1
16903;202008;352590;N;8230001;0;1;-1
17242;202008;352590;H;5223100;0;1;-1
17278;202008;352590;I;5611201;0;2;-2
17318;202008;352590;G;4742300;3;1;2
17388;202008;352590;G;4644301;9;19;-10
17452;202008;352590;M;7112000;0;1;-1
17515;202008;352590;I;5611201;0;3;-3
17713;202008;352590;K;6622300;2;0;2
17714;202008;352590;K;6622300;0;2;-2
17976;202008;352590;H;5250804;1;2;-1
18144;202008;352590;G;4771701;1;0;1
18182;202008;352590;N;8292000;0;1;-1
18192;202008;352590;G;4754701;1;0;1
18239;202008;352590;G;4752100;0;1;-1
18713;202008;352590;N;8299701;7;5;2
19525;202008;352590;C;2099199;0;2;-2
19834;202008;352590;G;4724500;2;0;2
19932;202008;352590;G;4712100;0;1;-1
20330;202008;352590;C;2229302;0;7;-7
20383;202008;352590;G;4781400;1;1;0
20520;202008;352590;G;4689399;0;3;-3
21149;202008;352590;C;2822402;1;1;0
21172;202008;352590;G;4652400;3;0;3
21390;202008;352590;I;5611203;0;4;-4
21905;202008;352590;H;4930203;22;9;13
22037;202008;352590;G;4772500;1;1;0
22148;202008;352590;I;5510803;0;1;-1
22191;202008;352590;N;8112500;1;1;0
22192;202008;352590;M;6920601;1;1;0
22198;202008;352590;F;4329104;5;0;5
22497;202008;352590;G;4751201;2;0;2
23035;202008;352590;Q;8630502;1;0;1
23202;202008;352590;Q;8630503;1;0;1
23425;202008;352590;G;4649499;0;1;-1
23533;202008;352590;M;6920601;0;1;-1
23620;202008;352590;N;8299706;0;1;-1
24221;202008;352590;F;4399199;1;3;-2
24496;202008;352590;H;4930202;3;2;1
24618;202008;352590;G;4639701;0;2;-2
24672;202008;352590;C;1062700;0;3;-3
24729;202008;352590;M;6920601;1;1;0
25103;202008;352590;G;4789099;0;1;-1
25317;202008;352590;C;1081302;0;3;-3
25787;202008;352590;M;6920601;2;1;1
25816;202008;352590;G;4755502;0;1;-1
25846;202008;352590;H;5250804;0;2;-2
26264;202008;352590;C;3250705;2;0;2
26476;202008;352590;G;4755502;0;1;-1
26605;202008;352590;C;3101200;8;2;6
27393;202008;352590;P;8512100;1;2;-1
27465;202008;352590;N;8211300;9;11;-2
27466;202008;352590;G;4634601;16;4;12
27589;202008;352590;G;4724500;1;0;1
27590;202008;352590;G;4712100;0;1;-1
27809;202008;352590;G;4530703;0;1;-1
28065;202008;352590;C;2219600;3;2;1
28135;202008;352590;G;4712100;1;2;-1
28244;202008;352590;C;2222600;0;2;-2
28980;202008;352590;N;7911200;0;1;-1
29059;202008;352590;I;5611201;0;1;-1
29751;202008;352590;I;5611201;0;1;-1
30202;202008;352590;G;4530701;4;2;2
30357;202008;352590;G;4712100;2;0;2
30660;202008;352590;G;4530702;2;1;1
30667;202008;352590;H;5223100;0;1;-1
30774;202008;352590;C;2539001;0;1;-1
30886;202008;352590;G;4687703;1;0;1
31070;202008;352590;C;2599399;0;1;-1
31325;202008;352590;C;2640000;3;0;3
31427;202008;352590;C;2399102;0;1;-1
31502;202008;352590;G;4744005;1;0;1
31503;202008;352590;G;4744005;1;0;1
32046;202008;352590;G;4731800;0;1;-1
32074;202008;352590;H;4930202;1;0;1
32080;202008;352590;S;9602501;0;1;-1
32479;202008;352590;F;4313400;1;9;-8
33019;202008;352590;C;2539000;1;0;1
33067;202008;352590;G;4731800;1;0;1
33491;202008;352590;M;6920601;0;1;-1
33551;202008;352590;G;4649403;0;1;-1
33764;202008;352590;G;4639701;1;3;-2
33781;202008;352590;C;2539001;1;0;1
33927;202008;352590;S;9430800;0;2;-2
34225;202008;352590;C;2511000;0;1;-1
34393;202008;352590;G;4751201;2;0;2
34696;202008;352590;P;8512100;0;1;-1
35216;202008;352590;G;4763602;0;1;-1
35575;202008;352590;C;1081302;5;4;1
35577;202008;352590;G;4789001;0;1;-1
35844;202008;352590;N;8011101;2;8;-6
36024;202008;352590;P;8599601;0;1;-1
36505;202008;352590;G;4731800;1;1;0
37484;202008;352590;C;1340501;1;0;1
37593;202008;352590;F;4120400;0;1;-1
37615;202008;352590;G;4721102;0;1;-1
37661;202008;352590;M;6920601;0;2;-2
37675;202008;352590;G;4511101;0;2;-2
37701;202008;352590;H;5221400;3;11;-8
37789;202008;352590;C;2941700;1;0;1
37795;202008;352590;R;9313100;0;2;-2
38529;202008;352590;G;4784900;0;1;-1
38631;202008;352590;G;4731800;0;1;-1
38633;202008;352590;G;4754701;1;0;1
38644;202008;352590;G;4619200;1;0;1
38998;202008;352590;C;2751100;4;2;2
39437;202008;352590;G;4673700;0;1;-1
40277;202008;352590;C;1099604;0;1;-1
40893;202008;352590;P;8532500;1;1;0
41021;202008;352590;H;4930202;1;1;0
41240;202008;352590;P;8513900;0;1;-1
41647;202008;352590;M;6920601;1;0;1
42290;202008;352590;N;7820500;1;1;0
42621;202008;352590;G;4511101;0;2;-2
42640;202008;352590;Q;8640205;1;0;1
42730;202008;352590;G;4511102;2;1;1
43460;202008;352590;C;2091600;0;3;-3
43627;202008;352590;G;4772500;0;1;-1
43847;202008;352590;F;4211101;0;1;-1
44132;202008;352590;C;1053800;1;0;1
44210;202008;352590;H;4930202;16;8;8
44243;202008;352590;Q;8800600;1;0;1
44296;202008;352590;G;4721102;0;1;-1
44602;202008;352590;H;5211799;6;3;3
44775;202008;352590;N;8211300;4;3;1
45113;202008;352590;C;3312102;3;0;3
45677;202008;352590;H;4930202;0;1;-1
46178;202008;352590;C;1013901;27;23;4
46238;202008;352590;G;4722901;1;1;0
46862;202008;352590;H;5223100;2;1;1
46906;202008;352590;P;8599602;0;3;-3
47071;202008;352590;L;6821802;1;1;0
47142;202008;352590;G;4781400;0;2;-2
47287;202008;352590;G;4789099;0;2;-2
48132;202008;352590;G;4713001;2;0;2
49128;202008;352590;H;4930202;7;4;3
49502;202008;352590;G;4789099;1;0;1
49601;202008;352590;N;8121400;18;12;6
49667;202008;352590;N;8291100;0;2;-2
49891;202008;352590;G;4771702;0;1;-1
49921;202008;352590;C;2222600;15;5;10
50360;202008;352590;G;4752100;0;1;-1
50602;202008;352590;G;4724500;0;1;-1
51192;202008;352590;G;4639701;1;2;-1
51522;202008;352590;G;4744002;0;1;-1
51786;202008;352590;F;4330499;1;1;0
52055;202008;352590;Q;8640299;1;0;1
52780;202008;352590;I;5612100;0;1;-1
52837;202008;352590;H;5229002;1;1;0
53213;202008;352590;G;4754701;0;1;-1
53244;202008;352590;G;4646001;2;2;0
53750;202008;352590;I;5620101;0;1;-1
53753;202008;352590;I;5620101;0;1;-1
53769;202008;352590;Q;8720401;4;1;3
53775;202008;352590;C;1623400;0;1;-1
53847;202008;352590;S;9491000;1;0;1
54000;202008;352590;H;4930203;1;0;1
55185;202008;352590;I;5611201;1;0;1
55367;202008;352590;F;4120400;0;1;-1
55368;202008;352590;F;4120400;0;1;-1
55670;202008;352590;P;8513900;0;1;-1
56219;202008;352590;K;6622300;0;1;-1
56314;202008;352590;C;2814301;1;2;-1
56446;202008;352590;G;4744099;2;3;-1
56498;202008;352590;G;4781400;0;1;-1
57396;202008;352590;G;4711302;0;1;-1
57849;202008;352590;F;4391600;0;2;-2
58701;202008;352590;G;4520005;2;0;2
58865;202008;352590;C;2539002;3;0;3
59629;202008;352590;I;5611203;0;1;-1
59946;202008;352590;C;1093702;1;2;-1
60297;202008;352590;N;7820500;427;198;229
61542;202008;352590;Q;8800600;0;1;-1
61692;202008;352590;G;4751201;1;0;1
62071;202008;352590;H;4930202;0;1;-1
62345;202008;352590;P;8599699;0;3;-3
62472;202008;352590;C;2829199;1;2;-1
62637;202008;352590;K;6622300;1;0;1
62679;202008;352590;N;7820500;299;414;-115
63534;202008;352590;G;4754701;0;1;-1
63535;202008;352590;G;4754701;1;0;1
63565;202008;352590;P;8512100;0;1;-1
64202;202008;352590;Q;8630502;2;0;2
64264;202008;352590;J;6190601;2;1;1
65152;202008;352590;G;4774100;1;0;1
65174;202008;352590;N;8129000;40;35;5
65226;202008;352590;G;4744005;2;0;2
65275;202008;352590;C;2222600;0;3;-3
65651;202008;352590;G;4721104;0;1;-1
65742;202008;352590;I;5611201;0;1;-1
65874;202008;352590;I;5611203;0;1;-1
65950;202008;352590;H;4930202;4;0;4
65951;202008;352590;H;4930202;5;5;0
66192;202008;352590;H;5120000;2;0;2
66816;202008;352590;G;4744005;6;1;5
66869;202008;352590;I;5611203;0;2;-2
66870;202008;352590;G;4637106;2;3;-1
67329;202008;352590;G;4663000;1;0;1
67645;202008;352590;Q;8630503;0;1;-1
68128;202008;352590;I;5510803;0;2;-2
68764;202008;352590;S;9430800;0;1;-1
68896;202008;352590;I;5620103;1;1;0
69023;202008;352590;G;4771701;0;1;-1
69381;202008;352590;N;8211300;0;1;-1
69452;202008;352590;J;6203100;0;1;-1
69594;202008;352590;N;8291100;3;1;2
70037;202008;352590;G;4530703;3;3;0
70405;202008;352590;G;4672900;0;4;-4
70488;202008;352590;I;5611201;6;4;2
70491;202008;352590;I;5611201;2;1;1
70700;202008;352590;N;8299799;0;4;-4
70701;202008;352590;N;8299799;0;1;-1
70747;202008;352590;Q;8711502;2;0;2
70983;202008;352590;J;6203100;4;0;4
71150;202008;352590;N;7820500;1;1;0
71539;202008;352590;F;4120400;2;0;2
71585;202008;352590;F;4120400;10;0;10
71810;202008;352590;D;3514000;2;0;2
71878;202008;352590;G;4639701;0;1;-1
71980;202008;352590;Q;8650004;0;1;-1
73060;202008;352590;H;4930201;1;0;1
73331;202008;352590;C;2029100;2;0;2
73565;202008;352590;H;5112901;2;0;2
74063;202008;352590;G;4771701;1;0;1
74406;202008;352590;I;5510803;0;1;-1
74548;202008;352590;P;8532500;0;6;-6
74647;202008;352590;P;8599699;1;2;-1
75093;202008;352590;G;4541202;1;0;1
75446;202008;352590;C;3314707;1;0;1
76627;202008;352590;C;3314721;3;0;3
76882;202008;352590;C;1412601;0;1;-1
76996;202008;352590;G;4511101;1;0;1
77183;202008;352590;N;7711000;2;0;2
77204;202008;352590;N;7711000;1;0;1
77362;202008;352590;F;4299599;2;0;2
77364;202008;352590;F;4299599;47;3;44
77755;202008;352590;F;4222701;0;1;-1
77773;202008;352590;Q;8640210;1;2;-1
77774;202008;352590;Q;8640210;1;0;1
77958;202008;352590;M;6920601;0;1;-1
78290;202008;352590;G;4639701;9;7;2
78385;202008;352590;G;4729699;1;0;1
78715;202008;352590;G;4781400;0;1;-1
78805;202008;352590;G;4731800;1;1;0
79346;202008;352590;I;5611201;1;2;-1
79974;202008;352590;N;8299799;2;5;-3
82348;202008;352590;N;7732201;1;0;1
82479;202008;352590;H;5250804;10;13;-3
82699;202008;352590;G;4789002;1;1;0
82902;202008;352590;R;9329802;0;2;-2
82988;202008;352590;G;4761003;0;1;-1
84112;202008;352590;N;8230001;0;1;-1
84512;202008;352590;G;4789001;0;1;-1
84515;202008;352590;C;2399199;0;1;-1
84990;202008;352590;Q;8630504;0;1;-1
85509;202008;352590;C;2651500;1;0;1
85686;202008;352590;Q;8650099;9;10;-1
85903;202008;352590;C;2949299;1;2;-1
85975;202008;352590;G;4753900;3;0;3
86389;202008;352590;I;5611201;0;2;-2
87431;202008;352590;N;8299706;1;2;-1
87956;202008;352590;H;4930201;3;3;0
88258;202008;352590;N;7810800;0;1;-1
88888;202008;352590;C;2222600;4;2;2
88973;202008;352590;G;4724500;7;0;7
89545;202008;352590;H;4929901;1;0;1
89851;202008;352590;I;5611201;0;1;-1
90187;202008;352590;G;4511101;0;2;-2
90606;202008;352590;I;5611201;0;3;-3
91290;202008;352590;G;4672900;1;0;1
91467;202008;352590;C;1412601;2;0;2
91519;202008;352590;F;4299599;0;4;-4
91611;202008;352590;C;2229303;1;1;0
92138;202008;352590;G;4520002;0;1;-1
92217;202008;352590;S;9430800;3;4;-1
93029;202008;352590;C;2063100;1;0;1
93100;202008;352590;S;9601701;0;1;-1
93536;202008;352590;G;4729699;0;2;-2
93713;202008;352590;N;8299706;2;0;2
93827;202008;352590;H;5240199;1;0;1
94401;202008;352590;N;8112500;0;1;-1
94561;202008;352590;N;7711000;0;1;-1
95006;202008;352590;I;5611203;0;1;-1
95012;202008;352590;G;4781400;1;0;1
95396;202008;352590;J;5914600;0;1;-1
95436;202008;352590;C;2829199;0;1;-1
95446;202008;352590;G;4744002;3;0;3
95459;202008;352590;G;4751201;0;1;-1
95472;202008;352590;G;4530703;4;0;4
95485;202008;352590;F;4110700;0;2;-2
95492;202008;352590;C;2950600;0;1;-1
95751;202008;352590;H;4930202;2;4;-2
95920;202008;352590;G;4731800;1;0;1
95922;202008;352590;G;4782201;0;1;-1
95945;202008;352590;F;4313400;4;3;1
96197;202008;352590;I;5611203;0;1;-1
96198;202008;352590;I;5611203;0;1;-1
96364;202008;352590;F;4313400;1;13;-12
96520;202008;352590;G;4511101;7;4;3
96833;202008;352590;F;4330404;0;1;-1
97043;202008;352590;H;4929902;1;0;1
97213;202008;352590;G;4520001;1;0;1
97214;202008;352590;I;5611201;0;1;-1
98270;202008;352590;J;6201501;0;3;-3
98802;202008;352590;G;4687703;1;1;0
99076;202008;352590;N;8112500;1;1;0
99501;202008;352590;N;7820500;130;108;22
99726;202008;352590;C;2869100;1;0;1
99817;202008;352590;I;5620101;1;0;1
100108;202008;352590;R;9313100;0;1;-1
100323;202008;352590;C;2592601;1;1;0
100470;202008;352590;Q;8712300;3;1;2
100532;202008;352590;N;8299799;0;1;-1
100884;202008;352590;H;5240199;0;1;-1
101064;202008;352590;J;6202300;2;2;0
101603;202008;352590;G;4755502;4;1;3
101607;202008;352590;G;4783101;0;1;-1
101611;202008;352590;C;2599399;0;3;-3
101698;202008;352590;P;8599604;1;0;1
102098;202008;352590;Q;8650099;1;0;1
102311;202008;352590;G;4731800;1;0;1
102362;202008;352590;G;4781400;0;1;-1
102481;202008;352590;G;4744002;1;0;1
102790;202008;352590;M;7311400;0;1;-1
102896;202008;352590;I;5620103;0;1;-1
103067;202008;352590;S;9521500;1;1;0
103309;202008;352590;G;4712100;1;0;1
103788;202008;352590;P;8511200;1;0;1
104396;202008;352590;G;4774100;1;0;1
104659;202008;352590;N;8299799;2;3;-1
104851;202008;352590;C;2222600;1;2;-1
105011;202008;352590;N;8299799;3;0;3
106148;202008;352590;G;4711302;7;8;-1
106178;202008;352590;G;4774100;0;1;-1
106283;202008;352590;G;4753900;0;1;-1
106388;202008;352590;G;4649499;2;2;0
106445;202008;352590;M;6920601;1;0;1
106741;202008;352590;G;4751201;1;0;1
107597;202008;352590;G;4759899;0;1;-1
108081;202008;352590;C;2825900;2;0;2
108133;202008;352590;G;4772500;0;1;-1
108830;202008;352590;G;4741500;1;0;1
109074;202008;352590;C;2399101;2;0;2
109509;202008;352590;G;4759899;0;1;-1
109510;202008;352590;G;4759899;0;1;-1
109511;202008;352590;G;4759899;0;2;-2
109519;202008;352590;G;4649499;5;6;-1
109555;202008;352590;M;6920601;1;0;1
109606;202008;352590;G;4761001;0;1;-1
109746;202008;352590;G;4520001;1;0;1
110130;202008;352590;G;4781400;0;1;-1
110182;202008;352590;G;4744002;0;1;-1
110223;202008;352590;S;9601701;0;2;-2
110325;202008;352590;H;4930203;2;0;2
110347;202008;352590;N;8299799;1;1;0
110365;202008;352590;G;4712100;0;1;-1
110414;202008;352590;N;8299799;0;5;-5
110683;202008;352590;C;1099699;0;1;-1
110801;202008;352590;C;1099699;8;3;5
111809;202008;352590;G;4711302;3;4;-1
111946;202008;352590;G;4711301;17;9;8
112125;202008;352590;G;4711302;1;0;1
112166;202008;352590;G;4511102;1;0;1
112653;202008;352590;I;5611201;0;2;-2
112657;202008;352590;I;5611201;0;1;-1
112665;202008;352590;I;5611203;2;0;2
112913;202008;352590;P;8531700;4;7;-3
113876;202008;352590;G;4789002;0;1;-1
114009;202008;352590;C;2591800;2;0;2
114654;202008;352590;G;4761001;1;0;1
114761;202008;352590;G;4530703;0;3;-3
114967;202008;352590;G;4744005;0;1;-1
115339;202008;352590;P;8512100;0;1;-1
115975;202008;352590;F;4120400;0;1;-1
116329;202008;352590;G;4789001;1;0;1
116388;202008;352590;F;4313400;3;16;-13
116726;202008;352590;G;4781400;0;1;-1
117059;202008;352590;C;1013902;1;0;1
117227;202008;352590;G;4669999;1;0;1
117478;202008;352590;G;4789099;1;0;1
117635;202008;352590;R;9313100;0;1;-1
118226;202008;352590;G;4712100;1;2;-1
118389;202008;352590;G;4789002;1;0;1
118722;202008;352590;G;4763602;1;2;-1
119027;202008;352590;H;4930202;15;3;12
119961;202008;352590;J;6209100;2;0;2
120806;202008;352590;J;5829800;0;1;-1
121223;202008;352590;G;4731800;3;2;1
121257;202008;352590;N;8299799;0;3;-3
121904;202008;352590;G;4781400;1;0;1
122012;202008;352590;G;4652400;0;10;-10
122414;202008;352590;H;5250804;3;0;3
122964;202008;352590;G;4520001;0;1;-1
123007;202008;352590;G;4711302;9;15;-6
124094;202008;352590;Q;8800600;1;0;1
124454;202008;352590;G;4763603;1;0;1
124455;202008;352590;G;4763603;1;0;1
124930;202008;352590;N;8011101;1;17;-16
125047;202008;352590;G;4789004;0;1;-1
125507;202008;352590;G;4771701;1;0;1
125646;202008;352590;K;6424703;1;0;1
125650;202008;352590;K;6424703;1;0;1
125707;202008;352590;N;8291100;1;0;1
126519;202008;352590;N;8211300;2;1;1
126734;202008;352590;K;6622300;0;1;-1
126814;202008;352590;G;4530703;1;2;-1
127228;202008;352590;G;4781400;3;2;1
127679;202008;352590;G;4530703;0;1;-1
127719;202008;352590;C;2790299;15;3;12
127738;202008;352590;M;7500100;3;1;2
128284;202008;352590;N;8219999;0;1;-1
128295;202008;352590;K;6619302;0;2;-2
128301;202008;352590;H;4930202;0;1;-1
128549;202008;352590;E;3701100;1;1;0
128603;202008;352590;C;1053800;4;2;2
128705;202008;352590;Q;8630502;0;1;-1
128733;202008;352590;Q;8630501;1;0;1
129115;202008;352590;G;4633801;16;5;11
129412;202008;352590;G;4781400;0;1;-1
129640;202008;352590;I;5611201;0;1;-1
130268;202008;352590;P;8599605;0;1;-1
130372;202008;352590;P;8513900;0;1;-1
130373;202008;352590;M;7120100;0;1;-1
130631;202008;352590;C;2622100;0;1;-1
130994;202008;352590;F;4321500;1;1;0
131120;202008;352590;N;8111700;5;5;0
131489;202008;352590;C;2710403;1;0;1
131647;202008;352590;F;4299599;0;4;-4
131662;202008;352590;F;4299599;2;1;1
131900;202008;352590;C;2071100;1;1;0
132580;202008;352590;N;7723300;0;1;-1
132581;202008;352590;S;9430800;1;4;-3
133161;202008;352590;G;4771701;1;1;0
133162;202008;352590;G;4771701;1;0;1
133163;202008;352590;G;4771701;0;1;-1
133894;202008;352590;G;4652400;2;0;2
134772;202008;352590;H;4930202;0;1;-1
135437;202008;352590;G;4741500;3;0;3
135438;202008;352590;G;4741500;3;0;3
135439;202008;352590;G;4741500;1;0;1
135459;202008;352590;G;4731800;2;0;2
135688;202008;352590;C;2029100;16;15;1
135715;202008;352590;G;4635402;0;1;-1
135744;202008;352590;G;4744002;1;0;1
136162;202008;352590;H;4930202;0;1;-1
137027;202008;352590;H;4930202;1;7;-6
137167;202008;352590;G;4789005;0;1;-1
137303;202008;352590;N;8219999;1;0;1
137444;202008;352590;R;9313100;0;1;-1
138298;202008;352590;C;1062700;0;1;-1
138438;202008;352590;I;5611203;1;0;1
138845;202008;352590;P;8511200;0;1;-1
138919;202008;352590;G;4722901;1;0;1
139290;202008;352590;N;8230001;1;0;1
139434;202008;352590;J;6201501;0;1;-1
140161;202008;352590;J;6201500;1;0;1
140267;202008;352590;G;4771702;0;1;-1
140370;202008;352590;J;6203100;9;0;9
141308;202008;352590;C;1053800;5;3;2
141728;202008;352590;G;4754702;0;1;-1
142655;202008;352590;F;4313400;0;1;-1
142662;202008;352590;C;1099601;1;4;-3
142742;202008;352590;I;5611201;0;1;-1
142768;202008;352590;P;8512100;0;3;-3
143003;202008;352590;C;1042200;5;0;5
143131;202008;352590;P;8513900;0;1;-1
143563;202008;352590;H;4930202;1;1;0
143720;202008;352590;I;5611201;0;1;-1
143813;202008;352590;G;4789001;1;0;1
144109;202008;352590;H;5212500;1;0;1
144590;202008;352590;K;6619399;0;1;-1
145085;202008;352590;J;6190699;2;0;2
145130;202008;352590;C;1062700;4;0;4
145296;202008;352590;M;7120100;1;1;0
145379;202008;352590;A;133499;1;1;0
145612;202008;352590;G;4511101;2;0;2
145828;202008;352590;M;6920601;0;1;-1
145914;202008;352590;M;7112000;1;1;0
146181;202008;352590;N;7711000;1;0;1
146415;202008;352590;I;5611203;2;0;2
147102;202008;352590;I;5611201;0;1;-1
147334;202008;352590;G;4649401;1;0;1
147418;202008;352590;J;5813100;1;0;1
147437;202008;352590;G;4782201;0;1;-1
148283;202008;352590;K;6622300;1;0;1
148626;202008;352590;G;4530703;0;1;-1
148816;202008;352590;G;4753900;3;6;-3
148817;202008;352590;G;4753900;2;1;1
149497;202008;352590;P;8512100;0;6;-6
149615;202008;352590;G;4639701;0;1;-1
149881;202008;352590;G;4744001;1;0;1
150111;202008;352590;G;4530703;1;1;0
150590;202008;352590;G;4751201;0;1;-1
150618;202008;352590;S;9512600;0;1;-1
151100;202008;352590;N;8299799;1;1;0
151212;202008;352590;G;4771701;1;0;1
151607;202008;352590;C;2621300;0;32;-32
151608;202008;352590;C;2632900;29;51;-22
151663;202008;352590;N;8299799;53;67;-14
152203;202008;352590;P;8512100;0;2;-2
152966;202008;352590;C;2229303;0;1;-1
153049;202008;352590;H;5212500;5;6;-1
153374;202008;352590;H;4930201;0;1;-1
153375;202008;352590;P;8511200;0;1;-1
153492;202008;352590;G;4729699;0;1;-1
153945;202008;352590;H;5112901;1;0;1
154080;202008;352590;G;4752100;1;0;1
154362;202008;352590;G;4759801;0;1;-1
154415;202008;352590;G;4731800;1;1;0
155126;202008;352590;G;4789004;0;1;-1
155208;202008;352590;G;4731800;1;0;1
155509;202008;352590;P;8513900;1;0;1
155867;202008;352590;G;4687703;0;1;-1
156059;202008;352590;J;6201501;3;0;3
156681;202008;352590;H;4930202;1;1;0
156945;202008;352590;G;4731800;0;1;-1
157694;202008;352590;C;2512800;0;1;-1
159008;202008;352590;G;4744001;1;0;1
159737;202008;352590;G;4771701;1;0;1
159923;202008;352590;G;4781400;0;1;-1
160081;202008;352590;S;9603304;0;1;-1
160208;202008;352590;F;4213800;10;1;9
160662;202008;352590;G;4729699;0;3;-3
160901;202008;352590;G;4663000;1;0;1
161074;202008;352590;H;5212500;15;23;-8
161165;202008;352590;N;8111700;23;2;21
161209;202008;352590;G;4721104;0;1;-1
161562;202008;352590;G;4789001;0;1;-1
161649;202008;352590;H;5211799;0;1;-1
162107;202008;352590;N;7820500;6;1;5
162156;202008;352590;G;4511101;1;0;1
162875;202008;352590;C;2093200;2;0;2
163572;202008;352590;M;6920601;2;1;1
163573;202008;352590;H;4930202;0;2;-2
164111;202008;352590;G;4729699;0;1;-1
164192;202008;352590;I;5611203;1;0;1
164193;202008;352590;F;4120400;14;0;14
164391;202008;352590;G;4744003;0;1;-1
164640;202008;352590;P;8599603;1;0;1
165339;202008;352590;C;3101200;0;1;-1
165571;202008;352590;H;4930202;2;0;2
165696;202008;352590;F;4222701;2;1;1
165931;202008;352590;G;4789099;0;3;-3
166144;202008;352590;G;4686902;3;2;1
166462;202008;352590;G;4743100;1;1;0
166605;202008;352590;Q;8711502;2;2;0
167280;202008;352590;C;2222600;1;0;1
168013;202008;352590;G;4511101;4;1;3
168770;202008;352590;G;4789099;1;2;-1
169494;202008;352590;G;4530703;1;0;1
169527;202008;352590;N;8111700;1;0;1
169882;202008;352590;G;4754701;23;1;22
169884;202008;352590;G;4754701;2;0;2
169889;202008;352590;G;4754701;1;0;1
170314;202008;352590;H;4930201;0;1;-1
170464;202008;352590;G;4530703;0;1;-1
171461;202008;352590;P;8541400;0;1;-1
171471;202008;352590;I;5611201;0;2;-2
171496;202008;352590;G;4731800;0;1;-1
171540;202008;352590;N;8211300;1;0;1
173141;202008;352590;F;4330404;4;1;3
173143;202008;352590;N;7830200;10;20;-10
173349;202008;352590;G;4754701;1;0;1
173799;202008;352590;S;9521500;1;1;0
174150;202008;352590;M;7112000;2;1;1
174151;202008;352590;J;6204000;5;3;2
174504;202008;352590;L;6810201;1;1;0
175316;202008;352590;G;4520001;1;0;1
175603;202008;352590;G;4771701;2;1;1
175841;202008;352590;C;1830003;1;0;1
176060;202008;352590;F;4321500;1;1;0
176133;202008;352590;G;4689399;0;1;-1
176289;202008;352590;G;4722901;0;1;-1
176376;202008;352590;I;5611201;7;2;5
177061;202008;352590;N;8111700;48;13;35
177326;202008;352590;G;4713002;0;1;-1
177374;202008;352590;I;5611201;1;0;1
177535;202008;352590;G;4771704;0;1;-1
177608;202008;352590;G;4711302;0;2;-2
177778;202008;352590;M;6920601;0;1;-1
178393;202008;352590;Q;8610101;13;10;3
178431;202008;352590;M;7319002;1;0;1
178842;202008;352590;G;4686902;1;0;1
178900;202008;352590;G;4724500;9;11;-2
178901;202008;352590;G;4633801;2;2;0
178902;202008;352590;G;4724500;17;11;6
179066;202008;352590;G;4781400;0;1;-1
179143;202008;352590;G;4663000;1;0;1
180132;202008;352590;N;8112500;1;1;0
180174;202008;352590;C;2222600;0;1;-1
180394;202008;352590;P;8593700;0;2;-2
180490;202008;352590;C;2812700;1;0;1
180706;202008;352590;G;4721102;0;1;-1
180906;202008;352590;C;1112700;1;0;1
180968;202008;352590;I;5611201;0;2;-2
181140;202008;352590;P;8599601;0;1;-1
181551;202008;352590;G;4781400;0;1;-1
181738;202008;352590;H;5250805;3;0;3
181782;202008;352590;C;2621300;0;3;-3
182234;202008;352590;G;4691500;5;8;-3
182603;202008;352590;C;3291400;0;1;-1
183480;202008;352590;C;2511000;4;24;-20
183814;202008;352590;Q;8630503;0;1;-1
184220;202008;352590;C;1352900;2;0;2
184272;202008;352590;G;4541205;0;1;-1
184338;202008;352590;N;7732201;0;1;-1
184342;202008;352590;I;5620104;0;1;-1
184434;202008;352590;I;5611201;0;1;-1
184920;202008;352590;M;6920601;1;4;-3
185054;202008;352590;I;5611201;1;1;0
185384;202008;352590;N;8299799;2;0;2
185534;202008;352590;G;4520005;1;1;0
185675;202008;352590;C;3329501;0;1;-1
186136;202008;352590;G;4774100;0;1;-1
186330;202008;352590;G;4771701;0;1;-1
186500;202008;352590;I;5611201;0;1;-1
186582;202008;352590;G;4712100;1;1;0
187715;202008;352590;G;4511101;1;1;0
187889;202008;352590;F;4391600;3;0;3
187983;202008;352590;H;5211701;0;1;-1
188101;202008;352590;G;4781400;0;1;-1
188577;202008;352590;G;4731800;0;1;-1
188598;202008;352590;G;4782201;1;0;1
188599;202008;352590;I;5611201;0;6;-6
188674;202008;352590;G;4713002;0;1;-1
188858;202008;352590;G;4520004;0;1;-1
188940;202008;352590;Q;8640210;1;0;1
189644;202008;352590;N;8211300;5;1;4
189902;202008;352590;G;4789004;0;1;-1
190311;202008;352590;N;8220200;0;1;-1
190654;202008;352590;N;8299706;0;1;-1
190740;202008;352590;H;5240199;1;1;0
190906;202008;352590;S;9499500;0;5;-5
191793;202008;352590;M;7112000;0;1;-1
192166;202008;352590;P;8599601;1;0;1
192545;202008;352590;G;4744003;1;0;1
194332;202008;352590;H;4930202;0;3;-3
194433;202008;352590;M;6920601;1;0;1
195182;202008;352590;I;5611201;1;0;1
195976;202008;352590;C;2222600;15;5;10
196202;202008;352590;I;5620102;0;1;-1
196508;202008;352590;C;3314707;3;0;3
196691;202008;352590;S;9602502;1;0;1
198665;202008;352590;G;4731800;0;2;-2
199444;202008;352590;G;4712100;2;2;0
199445;202008;352590;N;8299799;3;2;1
199791;202008;352590;G;4511101;0;1;-1
201027;202008;352590;Q;8630502;0;1;-1
201170;202008;352590;F;4321500;4;3;1
201247;202008;352590;G;4645103;1;0;1
201519;202008;352590;H;4930202;2;0;2
201649;202008;352590;M;6920601;3;1;2
202098;202008;352590;F;4330401;1;0;1
202789;202008;352590;C;3313901;0;2;-2
203247;202008;352590;C;2822402;0;1;-1
203568;202008;352590;H;4930202;8;10;-2
203742;202008;352590;F;4213800;3;0;3
203819;202008;352590;C;1099699;1;2;-1
205748;202008;352590;P;8599604;2;0;2
205780;202008;352590;G;4712100;1;1;0
205815;202008;352590;G;4669999;1;1;0
206608;202008;352590;G;4623109;3;4;-1
206629;202008;352590;G;4781400;4;64;-60
206638;202008;352590;G;4511104;1;0;1
206662;202008;352590;N;8130300;12;17;-5
206663;202008;352590;G;4789099;0;2;-2
206885;202008;352590;Q;8630501;0;1;-1
207263;202008;352590;G;4761003;0;1;-1
207464;202008;352590;C;2840200;1;0;1
207823;202008;352590;I;5611203;0;2;-2
208120;202008;352590;G;4781400;1;0;1
208121;202008;352590;G;4781400;0;1;-1
208350;202008;352590;G;4633801;0;1;-1
208353;202008;352590;A;132600;1;0;1
208646;202008;352590;N;8299799;0;2;-2
208706;202008;352590;L;6821802;1;0;1
209040;202008;352590;P;8593700;0;1;-1
209051;202008;352590;N;8299799;1;2;-1
209351;202008;352590;C;2311700;1;3;-2
209609;202008;352590;I;5611203;0;1;-1
209985;202008;352590;H;5212500;16;9;7
210311;202008;352590;C;3314721;0;1;-1
210343;202008;352590;C;2349401;2;1;1
210782;202008;352590;Q;8630501;1;0;1
210872;202008;352590;G;4789005;0;1;-1
211081;202008;352590;M;7500100;0;1;-1
212056;202008;352590;G;4773300;0;1;-1
212172;202008;352590;F;4321500;2;1;1
212401;202008;352590;N;8211300;0;1;-1
212403;202008;352590;Q;8630501;0;1;-1
212460;202008;352590;Q;8630506;0;1;-1
213206;202008;352590;C;1412601;1;0;1
213295;202008;352590;L;6821802;2;0;2
213800;202008;352590;C;2072000;1;0;1
213838;202008;352590;N;8011101;1;0;1
214424;202008;352590;G;4723700;0;1;-1
214752;202008;352590;G;4731800;1;0;1
214854;202008;352590;Q;8711502;0;1;-1
214950;202008;352590;G;4649499;6;0;6
215303;202008;352590;I;5611201;2;0;2
215304;202008;352590;I;5611201;0;1;-1
215449;202008;352590;G;4772500;0;26;-26
215555;202008;352590;P;8513900;1;1;0
216259;202008;352590;G;4649401;0;1;-1
216284;202008;352590;C;2599399;2;3;-1
216342;202008;352590;J;6209100;0;1;-1
216403;202008;352590;G;4713002;0;1;-1
216575;202008;352590;C;3101200;1;0;1
216985;202008;352590;Q;8712300;0;2;-2
217204;202008;352590;C;1091101;4;4;0
218065;202008;352590;G;4784900;1;0;1
218910;202008;352590;C;1733800;2;2;0
219196;202008;352590;G;4789004;0;1;-1
219352;202008;352590;I;5620101;1;1;0
219376;202008;352590;P;8599603;1;1;0
219402;202008;352590;H;4930202;1;0;1
219586;202008;352590;C;3314799;2;0;2
219741;202008;352590;P;8511200;0;2;-2
219754;202008;352590;I;5611201;0;1;-1
220453;202008;352590;G;4731800;0;1;-1
221556;202008;352590;F;4120400;7;1;6
221872;202008;352590;H;5250805;0;1;-1
221995;202008;352590;J;6311900;1;0;1
222045;202008;352590;I;5611201;0;1;-1
222375;202008;352590;J;5811500;1;1;0
222436;202008;352590;M;6920601;1;1;0
222714;202008;352590;F;4322302;0;1;-1
222925;202008;352590;P;8512100;1;0;1
223103;202008;352590;G;4743100;1;0;1
223255;202008;352590;C;3314710;0;1;-1
223640;202008;352590;I;5611202;0;1;-1
223938;202008;352590;G;4511102;0;1;-1
224147;202008;352590;C;1733800;8;0;8
224363;202008;352590;F;4322301;1;0;1
224589;202008;352590;S;9601701;1;1;0
224645;202008;352590;G;4530703;1;1;0
225087;202008;352590;G;4781400;5;0;5
225754;202008;352590;F;4330404;0;2;-2
226727;202008;352590;I;5611201;0;1;-1
226795;202008;352590;G;4781400;0;2;-2
226918;202008;352590;C;1066000;35;10;25
227258;202008;352590;I;5611203;0;1;-1
227282;202008;352590;G;4634601;0;1;-1
227288;202008;352590;G;4781400;4;2;2
227345;202008;352590;H;4930202;17;2;15
227373;202008;352590;S;9521500;1;2;-1
227674;202008;352590;N;8011101;1;0;1
227892;202008;352590;G;4712100;0;1;-1
227957;202008;352590;C;3250705;1;0;1
227964;202008;352590;I;5611203;0;1;-1
228484;202008;352590;M;7490199;0;1;-1
228512;202008;352590;E;3821100;15;19;-4
228514;202008;352590;I;5611201;2;1;1
228556;202008;352590;K;6462000;2;4;-2
228603;202008;352590;N;8111700;18;8;10
228893;202008;352590;H;4930202;0;1;-1
228932;202008;352590;G;4729602;1;0;1
229067;202008;352590;G;4789002;0;1;-1
229674;202008;352590;F;4120400;2;5;-3
230052;202008;352590;M;7112000;4;0;4
230214;202008;352590;G;4783101;1;0;1
230263;202008;352590;G;4711302;1;0;1
230496;202008;352590;I;5611201;4;2;2
230858;202008;352590;G;4712100;0;1;-1
231101;202008;352590;G;4754701;1;0;1
231274;202008;352590;H;4923002;0;1;-1
231681;202008;352590;Q;8800600;1;0;1
231802;202008;352590;N;8111700;1;0;1
232083;202008;352590;G;4755503;1;0;1
232551;202008;352590;J;6190601;0;1;-1
232557;202008;352590;G;4520005;4;1;3
232652;202008;352590;C;2342702;8;0;8
232672;202008;352590;G;4744001;1;1;0
233138;202008;352590;F;4120400;0;1;-1
233467;202008;352590;G;4771701;1;0;1
233478;202008;352590;F;4322302;1;0;1
233608;202008;352590;S;9602501;1;0;1
234111;202008;352590;L;6821801;1;1;0
234145;202008;352590;C;3314704;1;0;1
234461;202008;352590;M;7490199;1;0;1
234491;202008;352590;R;9329804;0;1;-1
234738;202008;352590;M;6920601;2;1;1
236132;202008;352590;G;4754701;1;2;-1
236436;202008;352590;P;8511200;0;2;-2
236441;202008;352590;G;4743100;4;0;4
236896;202008;352590;H;4930202;1;1;0
238581;202008;352590;Q;8630504;0;1;-1
238949;202008;352590;C;1020101;0;2;-2
239119;202008;352590;P;8592901;0;1;-1
239306;202008;352590;G;4530703;0;1;-1
239437;202008;352590;G;4543900;0;1;-1
240374;202008;352590;G;4691500;5;9;-4
240782;202008;352590;G;4743100;1;0;1
241448;202008;352590;G;4637199;2;1;1
241684;202008;352590;M;7311400;0;1;-1
241781;202008;352590;I;5611203;0;3;-3
241788;202008;352590;I;5611203;0;1;-1
242148;202008;352590;I;5611203;7;3;4
242305;202008;352590;C;1091102;1;1;0
242539;202008;352590;G;4687702;0;1;-1
242703;202008;352590;C;3314704;1;0;1
243074;202008;352590;F;4330403;3;0;3
243076;202008;352590;F;4330499;0;1;-1
243916;202008;352590;L;6810201;0;5;-5
244115;202008;352590;F;4330404;1;0;1
244548;202008;352590;G;4637199;1;0;1
244654;202008;352590;N;8299706;0;1;-1
245139;202008;352590;I;5611201;0;2;-2
245161;202008;352590;I;5611201;2;0;2
245325;202008;352590;G;4619200;2;2;0
245649;202008;352590;I;5620104;3;1;2
245655;202008;352590;Q;8630502;0;1;-1
246226;202008;352590;G;4689399;1;1;0
246471;202008;352590;H;4930201;2;0;2
246715;202008;352590;G;4772500;1;0;1
246891;202008;352590;F;4399101;1;0;1
247018;202008;352590;G;4669999;4;5;-1
247750;202008;352590;G;4763601;6;2;4
247773;202008;352590;H;4930201;1;0;1
247862;202008;352590;C;3321000;1;1;0
248233;202008;352590;P;8512100;0;1;-1
248234;202008;352590;P;8512100;0;2;-2
248444;202008;352590;I;5611203;0;1;-1
248780;202008;352590;M;6920601;1;0;1
248784;202008;352590;J;6311900;2;1;1
249872;202008;352590;L;6810201;0;1;-1
251403;202008;352590;P;8541400;0;1;-1
251595;202008;352590;G;4772500;1;1;0
251737;202008;352590;G;4530703;1;1;0
251910;202008;352590;F;4221905;0;1;-1
251960;202008;352590;G;4744005;1;0;1
252096;202008;352590;M;6920601;1;1;0
252271;202008;352590;C;2229399;0;1;-1
252352;202008;352590;F;4399103;0;2;-2
252450;202008;352590;G;4784900;1;0;1
252558;202008;352590;K;6619399;0;1;-1
252559;202008;352590;K;6622300;1;0;1
252765;202008;352590;C;3314719;1;0;1
252767;202008;352590;G;4763603;0;1;-1
253628;202008;352590;C;2731700;0;23;-23
253831;202008;352590;C;2532201;0;4;-4
253864;202008;352590;H;4930201;0;1;-1
254059;202008;352590;G;4789099;1;2;-1
254063;202008;352590;Q;8640205;1;0;1
254129;202008;352590;I;5611201;1;0;1
254671;202008;352590;N;8112500;1;0;1
254698;202008;352590;H;5211701;44;23;21
254981;202008;352590;E;3812200;0;1;-1
255191;202008;352590;G;4744001;1;0;1
255727;202008;352590;G;4530704;1;1;0
255791;202008;352590;G;4753900;1;0;1
256202;202008;352590;C;2399101;4;1;3
256415;202008;352590;G;4771701;1;0;1
256636;202008;352590;G;4520005;2;0;2
256745;202008;352590;M;7119704;0;1;-1
257101;202008;352590;G;4744001;0;1;-1
257255;202008;352590;G;4754701;70;14;56
257314;202008;352590;N;8112500;1;0;1
257390;202008;352590;C;1094500;1;0;1
257909;202008;352590;G;4744099;0;2;-2
257910;202008;352590;N;8299799;0;1;-1
257915;202008;352590;G;4771702;0;1;-1
257917;202008;352590;C;1091101;4;4;0
257921;202008;352590;C;2599399;2;5;-3
258058;202008;352590;C;3314708;3;3;0
259109;202008;352590;C;1413401;0;1;-1
259180;202008;352590;H;4930202;0;3;-3
259791;202008;352590;G;4759899;2;0;2
259828;202008;352590;P;8520100;2;1;1
260391;202008;352590;F;4399103;1;0;1
260549;202008;352590;F;4313400;0;1;-1
261419;202008;352590;G;4771701;1;0;1
262419;202008;352590;F;4330402;1;0;1
262877;202008;352590;G;4761001;0;2;-2
263315;202008;352590;M;6920601;1;0;1
263714;202008;352590;G;4724500;1;2;-1
263854;202008;352590;I;5611201;0;1;-1
263943;202008;352590;R;9313100;0;1;-1
264286;202008;352590;F;4322303;0;1;-1
264946;202008;352590;C;2522500;0;1;-1
265533;202008;352590;C;1052000;1;0;1
265631;202008;352590;G;4772500;2;0;2
266201;202008;352590;G;4741500;1;0;1
266296;202008;352590;M;7490105;1;0;1
267009;202008;352590;G;4774100;2;0;2
267222;202008;352590;M;6920601;0;1;-1
267232;202008;352590;G;4520001;1;1;0
267259;202008;352590;G;4721104;4;2;2
267260;202008;352590;G;4637107;3;2;1
267329;202008;352590;C;3101200;2;2;0
267331;202008;352590;G;4754701;0;3;-3
267449;202008;352590;J;6209100;2;0;2
267522;202008;352590;I;5611201;0;4;-4
267658;202008;352590;C;3321000;2;0;2
267659;202008;352590;C;3321000;0;2;-2
267726;202008;352590;I;5611203;0;1;-1
268383;202008;352590;Q;8800600;0;1;-1
268530;202008;352590;C;1053800;0;6;-6
268847;202008;352590;Q;8712300;3;3;0
269153;202008;352590;F;4120400;0;2;-2
269345;202008;352590;G;4744099;4;9;-5
269674;202008;352590;N;7732201;1;1;0
269907;202008;352590;I;5611202;0;1;-1
269949;202008;352590;C;2542000;1;0;1
270016;202008;352590;M;6920601;1;0;1
272408;202008;352590;G;4782201;1;1;0
272739;202008;352590;H;5212500;0;1;-1
273194;202008;352590;G;4520002;1;0;1
273358;202008;352590;G;4712100;1;0;1
273477;202008;352590;N;7711000;0;1;-1
273551;202008;352590;S;9529105;1;0;1
273722;202008;352590;Q;8630503;1;1;0
273853;202008;352590;I;5611201;0;1;-1
273855;202008;352590;C;3101200;0;1;-1
274285;202008;352590;S;9521500;1;0;1
274308;202008;352590;H;5320202;0;1;-1
274334;202008;352590;G;4712100;2;1;1
274530;202008;352590;F;4120400;1;0;1
274631;202008;352590;P;8511200;1;0;1
274746;202008;352590;M;7311400;1;0;1
274967;202008;352590;G;4781400;0;1;-1
275004;202008;352590;N;8111700;0;1;-1
275108;202008;352590;I;5611201;0;2;-2
275489;202008;352590;M;7420001;0;1;-1
276061;202008;352590;G;4774100;0;1;-1
276184;202008;352590;I;5611203;0;1;-1
276270;202008;352590;S;9602501;0;1;-1
276423;202008;352590;H;4930202;20;13;7
276554;202008;352590;H;5211701;2;2;0
277089;202008;352590;G;4755502;0;1;-1
277331;202008;352590;H;4930201;1;0;1
277333;202008;352590;Q;8650004;1;0;1
277902;202008;352590;P;8511200;0;1;-1
278717;202008;352590;N;8219999;1;1;0
278911;202008;352590;G;4781400;1;0;1
279051;202008;352590;G;4771701;1;1;0
279739;202008;352590;I;5611201;0;1;-1
279980;202008;352590;S;9603301;2;1;1
280104;202008;352590;H;4930202;1;0;1
280466;202008;352590;L;6821802;0;1;-1
280622;202008;352590;C;1093701;0;1;-1
281042;202008;352590;M;6920601;1;1;0
281613;202008;352590;M;7500100;1;0;1
281640;202008;352590;I;5611201;0;1;-1
281733;202008;352590;G;4744005;0;1;-1
282565;202008;352590;S;9602502;0;1;-1
283149;202008;352590;G;4712100;0;2;-2
283389;202008;352590;H;4930202;0;1;-1
284474;202008;352590;N;8121400;2;1;1
284852;202008;352590;R;9313100;1;1;0
285366;202008;352590;Q;8630503;1;0;1
285373;202008;352590;G;4751201;2;2;0
285581;202008;352590;G;4729699;0;1;-1
285863;202008;352590;G;4520005;20;6;14
286162;202008;352590;M;7120100;1;0;1
286441;202008;352590;N;8219999;2;1;1
286879;202008;352590;N;7911200;1;0;1
287045;202008;352590;M;7490105;1;0;1
287404;202008;352590;F;4120400;7;4;3
287618;202008;352590;M;7319003;0;1;-1
287621;202008;352590;H;4930202;0;1;-1
288130;202008;352590;H;4930202;0;3;-3
288461;202008;352590;G;4789004;0;1;-1
288493;202008;352590;F;4120400;2;0;2
288927;202008;352590;G;4541201;1;0;1
289828;202008;352590;F;4120400;2;1;1
289876;202008;352590;C;3250701;3;0;3
290909;202008;352590;G;4712100;0;1;-1
291247;202008;352590;G;4771702;3;1;2
291330;202008;352590;N;8299799;4;3;1
292120;202008;352590;G;4789099;1;0;1
292289;202008;352590;N;8211300;1;0;1
292953;202008;352590;Q;8630501;0;1;-1
293170;202008;352590;M;6920601;0;1;-1
293298;202008;352590;M;6920601;1;0;1
293649;202008;352590;G;4752100;0;3;-3
293989;202008;352590;F;4120400;2;1;1
294184;202008;352590;H;4930201;0;12;-12
294186;202008;352590;H;4930201;1;1;0
294201;202008;352590;H;4930202;0;2;-2
294508;202008;352590;I;5611201;1;2;-1
295013;202008;352590;G;4783102;0;1;-1
295318;202008;352590;I;5611201;0;1;-1
295551;202008;352590;M;7319003;1;0;1
295602;202008;352590;F;4399199;2;1;1
295776;202008;352590;Q;8711502;1;1;0
295794;202008;352590;G;4781400;0;1;-1
296675;202008;352590;H;4930203;1;0;1
296932;202008;352590;H;4930201;2;0;2
297515;202008;352590;G;4744001;1;0;1
298064;202008;352590;I;5611201;1;0;1
298369;202008;352590;S;9602501;0;1;-1
298610;202008;352590;G;4789001;0;1;-1
298910;202008;352590;G;4789004;1;1;0
298940;202008;352590;C;2823200;0;1;-1
299032;202008;352590;N;8011101;6;1;5
299760;202008;352590;G;4774100;2;0;2
299871;202008;352590;L;6822600;4;3;1
300579;202008;352590;F;4399199;1;0;1
300631;202008;352590;G;4781400;2;0;2
300918;202008;352590;F;4399103;2;0;2
301167;202008;352590;H;4930202;2;3;-1
301415;202008;352590;N;8111700;2;0;2
301747;202008;352590;N;7912100;0;1;-1
302535;202008;352590;G;4724500;1;3;-2
303371;202008;352590;S;9511800;1;0;1
303724;202008;352590;G;4723700;0;1;-1
304100;202008;352590;F;4321500;0;2;-2
304189;202008;352590;P;8593700;1;0;1
304243;202008;352590;N;8219999;1;0;1
305065;202008;352590;I;5611203;2;1;1
305169;202008;352590;H;5229002;1;1;0
305432;202008;352590;I;5611203;1;1;0
307508;202008;352590;C;2222600;2;2;0
308054;202008;352590;R;9001902;0;1;-1
308263;202008;352590;M;7119701;0;1;-1
308736;202008;352590;G;4771701;2;1;1
309524;202008;352590;G;4520001;0;1;-1
310532;202008;352590;F;4330402;2;0;2
310637;202008;352590;N;8220200;65;96;-31
310666;202008;352590;M;7490104;0;1;-1
311308;202008;352590;F;4399103;8;12;-4
311414;202008;352590;M;6920601;0;1;-1
312319;202008;352590;J;6202300;0;1;-1
312909;202008;352590;I;5611201;0;2;-2
312979;202008;352590;H;4930202;1;0;1
313159;202008;352590;S;9602501;0;1;-1
313248;202008;352590;F;4313400;0;2;-2
313962;202008;352590;S;9602502;0;1;-1
314064;202008;352590;M;6920601;1;0;1
314808;202008;352590;P;8541400;0;1;-1
315166;202008;352590;I;5611201;0;1;-1
315288;202008;352590;J;6204000;0;2;-2
315697;202008;352590;M;7119703;2;0;2
316849;202008;352590;G;4761001;2;0;2
317633;202008;352590;I;5611203;0;1;-1
318007;202008;352590;P;8593700;2;1;1
318258;202008;352590;G;4520002;1;0;1
318309;202008;352590;N;8130300;11;1;10
318403;202008;352590;G;4652400;9;4;5
318404;202008;352590;G;4752100;0;1;-1
318405;202008;352590;G;4752100;1;0;1
318532;202008;352590;F;4321500;2;0;2
318627;202008;352590;F;4120400;45;11;34
318900;202008;352590;C;2222600;5;0;5
319008;202008;352590;G;4751201;1;0;1
320148;202008;352590;F;4330405;8;1;7
320461;202008;352590;G;4530703;0;1;-1
321098;202008;352590;H;4930201;0;2;-2
321187;202008;352590;G;4721102;0;2;-2
321308;202008;352590;G;4721102;0;1;-1
322097;202008;352590;I;5620104;0;1;-1
323435;202008;352590;S;9511800;1;0;1
323443;202008;352590;M;7319003;1;2;-1
323760;202008;352590;H;4930202;0;3;-3
324334;202008;352590;H;4930202;8;8;0
324473;202008;352590;Q;8712300;9;7;2
326214;202008;352590;I;5611203;1;0;1
326818;202008;352590;H;4930201;1;0;1
326883;202008;352590;P;8550302;0;2;-2
327711;202008;352590;L;6810202;0;2;-2
327949;202008;352590;N;8111700;1;2;-1
328230;202008;352590;S;9602502;0;1;-1
329152;202008;352590;G;4663000;1;1;0
329600;202008;352590;P;8512100;0;1;-1
330872;202008;352590;G;4781400;1;0;1
331246;202008;352590;G;4731800;1;1;0
331925;202008;352590;I;5611201;0;1;-1
332019;202008;352590;G;4781400;0;2;-2
332058;202008;352590;C;2949299;0;2;-2
333029;202008;352590;G;4713002;1;0;1
333560;202008;352590;J;6204000;0;1;-1
333776;202008;352590;G;4669999;4;2;2
334973;202008;352590;J;6311900;0;1;-1
335388;202008;352590;G;4754701;1;1;0
336877;202008;352590;N;8211300;1;0;1
337666;202008;352590;G;4789099;0;2;-2
337818;202008;352590;I;5611201;0;2;-2
338319;202008;352590;H;4930202;4;6;-2
339170;202008;352590;L;6810202;0;1;-1
339293;202008;352590;N;8121400;1;4;-3
339323;202008;352590;S;9512600;1;0;1
339436;202008;352590;G;4789001;1;1;0
339537;202008;352590;G;4763601;1;1;0
339804;202008;352590;N;8130300;1;0;1
339885;202008;352590;F;4399199;1;1;0
340170;202008;352590;G;4789003;1;0;1
340754;202008;352590;I;5611203;0;1;-1
340897;202008;352590;H;4930202;1;1;0
340984;202008;352590;G;4781400;0;1;-1
341453;202008;352590;P;8511200;0;1;-1
341802;202008;352590;N;8299799;0;2;-2
342524;202008;352590;Q;8630504;2;1;1
342984;202008;352590;G;4645101;0;1;-1
344624;202008;352590;G;4722901;1;0;1
344813;202008;352590;G;4721102;0;2;-2
345275;202008;352590;L;6822600;0;1;-1
345454;202008;352590;N;8299799;1;0;1
345699;202008;352590;G;4729699;1;0;1
345745;202008;352590;I;5611201;0;2;-2
345855;202008;352590;S;9602502;2;1;1
346145;202008;352590;M;6920601;1;0;1
346427;202008;352590;G;4744099;1;0;1
346639;202008;352590;M;7112000;1;3;-2
346805;202008;352590;S;9609208;1;0;1
346978;202008;352590;H;5212500;4;11;-7
347083;202008;352590;G;4731800;0;1;-1
347160;202008;352590;C;1412601;1;10;-9
347471;202008;352590;P;8599603;0;1;-1
347968;202008;352590;C;2950600;1;0;1
348027;202008;352590;G;4511101;0;1;-1
348165;202008;352590;M;7119701;0;1;-1
348208;202008;352590;G;4744001;0;2;-2
348471;202008;352590;F;4330403;5;1;4
348734;202008;352590;G;4511101;1;0;1
348953;202008;352590;F;4120400;0;1;-1
349474;202008;352590;Q;8630504;1;0;1
349495;202008;352590;C;3314719;1;1;0
349812;202008;352590;G;4731800;1;0;1
349965;202008;352590;R;9313100;1;0;1
350329;202008;352590;M;7020400;0;1;-1
350379;202008;352590;P;8599604;1;1;0
350392;202008;352590;N;8211300;1;0;1
350585;202008;352590;N;8211300;1;0;1
350586;202008;352590;L;6821801;1;0;1
350665;202008;352590;M;7120100;1;0;1
350930;202008;352590;G;4729699;25;7;18
351029;202008;352590;F;4313400;1;0;1
351599;202008;352590;I;5611201;1;1;0
352434;202008;352590;H;4930202;1;0;1
352555;202008;352590;F;4291000;3;3;0
352988;202008;352590;G;4679699;0;2;-2
353635;202008;352590;G;4789099;1;0;1
353709;202008;352590;F;4120400;1;0;1
353952;202008;352590;I;5620101;6;2;4
353954;202008;352590;I;5620101;3;4;-1
353955;202008;352590;I;5620101;3;3;0
353956;202008;352590;I;5620101;1;0;1
354221;202008;352590;G;4742300;0;2;-2
354823;202008;352590;S;9529105;1;0;1
354864;202008;352590;G;4753900;1;2;-1
354955;202008;352590;C;3314708;2;0;2
355498;202008;352590;S;9521500;2;0;2
355897;202008;352590;G;4646001;0;2;-2
356104;202008;352590;H;5211701;4;4;0
356566;202008;352590;P;8512100;0;3;-3
356721;202008;352590;M;7490104;1;0;1
357188;202008;352590;G;4754701;0;1;-1
357393;202008;352590;N;8220200;85;97;-12
357479;202008;352590;G;4729699;0;1;-1
357858;202008;352590;J;6209100;2;3;-1
358182;202008;352590;N;8219901;0;2;-2
358492;202008;352590;G;4783101;0;3;-3
358738;202008;352590;I;5611201;2;0;2
358827;202008;352590;C;2229399;0;1;-1
359521;202008;352590;G;4772500;0;4;-4
359753;202008;352590;H;4930202;4;0;4
359833;202008;352590;I;5620104;0;1;-1
360525;202008;352590;F;4120400;1;0;1
360752;202008;352590;Q;8630502;1;0;1
360828;202008;352590;F;4221904;5;4;1
360889;202008;352590;I;5611201;0;1;-1
360986;202008;352590;P;8513900;6;0;6
362503;202008;352590;G;4679603;3;1;2
362758;202008;352590;N;8299799;11;7;4
362822;202008;352590;N;8111700;8;6;2
362912;202008;352590;P;8511200;0;2;-2
362961;202008;352590;G;4754703;1;0;1
363090;202008;352590;G;4633801;0;1;-1
363195;202008;352590;H;4930202;1;3;-2
363423;202008;352590;F;4110700;0;1;-1
363427;202008;352590;G;4530703;2;0;2
363741;202008;352590;G;4753900;1;1;0
364265;202008;352590;G;4711302;2;1;1
364638;202008;352590;C;2391503;1;0;1
364640;202008;352590;G;4753900;0;1;-1
364941;202008;352590;P;8599604;7;6;1
365972;202008;352590;G;4639701;14;5;9
366350;202008;352590;N;8111700;0;2;-2
366600;202008;352590;M;6911701;0;1;-1
366669;202008;352590;F;4330499;0;1;-1
366821;202008;352590;N;8299799;1;0;1
366827;202008;352590;C;3313999;2;0;2
366828;202008;352590;C;3313999;0;1;-1
366913;202008;352590;C;1095300;4;6;-2
367526;202008;352590;J;5813100;0;3;-3
367847;202008;352590;G;4753900;4;6;-2
368167;202008;352590;N;8291100;1;1;0
369108;202008;352590;G;4759899;0;1;-1
369423;202008;352590;G;4757100;1;0;1
369729;202008;352590;H;4930201;3;0;3
369803;202008;352590;N;8219999;1;0;1
370288;202008;352590;C;2943300;1;0;1
370527;202008;352590;J;6209100;1;1;0
371032;202008;352590;I;5611201;1;0;1
371415;202008;352590;F;4312600;1;0;1
371596;202008;352590;Q;8630503;0;1;-1
371679;202008;352590;G;4712100;0;1;-1
371755;202008;352590;I;5611203;0;1;-1
371757;202008;352590;I;5611203;0;1;-1
371758;202008;352590;I;5611203;0;1;-1
371760;202008;352590;I;5611203;0;5;-5
372916;202008;352590;G;4789099;1;0;1
373302;202008;352590;G;4781400;2;0;2
373679;202008;352590;G;4729699;0;2;-2
373771;202008;352590;Q;8630503;0;2;-2
375271;202008;352590;Q;8711502;2;3;-1
375893;202008;352590;Q;8630506;0;1;-1
376925;202008;352590;N;8211300;0;1;-1
377734;202008;352590;N;8112500;1;1;0
377791;202008;352590;C;2943300;1;1;0
377825;202008;352590;G;4724500;1;0;1
378742;202008;352590;I;5611201;0;1;-1
378887;202008;352590;M;6920601;1;0;1
378946;202008;352590;F;4330404;0;2;-2
379340;202008;352590;I;5611203;0;4;-4
379622;202008;352590;P;8599603;1;0;1
379732;202008;352590;G;4633801;0;1;-1
379902;202008;352590;G;4781400;1;0;1
380372;202008;352590;I;5611201;6;0;6
380650;202008;352590;P;8593700;0;1;-1
380744;202008;352590;M;6911701;0;1;-1
381721;202008;352590;G;4759899;2;0;2
382228;202008;352590;G;4781400;0;1;-1
382417;202008;352590;H;5212500;1;12;-11
382459;202008;352590;I;5611201;0;2;-2
383274;202008;352590;C;2542000;0;1;-1
384181;202008;352590;G;4789004;0;1;-1
384460;202008;352590;C;3299003;1;0;1
384850;202008;352590;G;4773300;0;1;-1
385567;202008;352590;C;1069400;5;1;4
385970;202008;352590;G;4530703;0;1;-1
386099;202008;352590;G;4530703;1;0;1
386876;202008;352590;G;4789099;0;1;-1
387061;202008;352590;G;4744005;0;1;-1
387762;202008;352590;G;4789099;0;2;-2
387872;202008;352590;H;5250804;5;5;0
388098;202008;352590;G;4774100;1;0;1
388219;202008;352590;C;1821100;1;0;1
388619;202008;352590;K;6622300;0;2;-2
388634;202008;352590;J;6202300;1;1;0
388750;202008;352590;I;5611201;0;1;-1
388757;202008;352590;H;5223100;1;1;0
389875;202008;352590;S;9511800;2;0;2
390154;202008;352590;R;9313100;3;1;2
390434;202008;352590;G;4721104;1;0;1
391006;202008;352590;G;4520006;1;1;0
391153;202008;352590;N;8111700;3;1;2
391664;202008;352590;H;4930201;1;0;1
392552;202008;352590;M;7319003;6;0;6
393253;202008;352590;G;4723700;1;0;1
393440;202008;352590;Q;8630503;0;1;-1
393446;202008;352590;C;3313901;4;0;4
393553;202008;352590;J;6319400;0;1;-1
393642;202008;352590;A;121101;0;1;-1
394149;202008;352590;C;2071100;0;1;-1
394378;202008;352590;I;5611203;1;0;1
394972;202008;352590;F;4330403;1;4;-3
394974;202008;352590;F;4292801;2;2;0
395291;202008;352590;H;4930202;3;1;2
395483;202008;352590;S;9601701;1;1;0
395612;202008;352590;G;4729699;2;1;1
395859;202008;352590;I;5611201;0;1;-1
395900;202008;352590;Q;8630503;0;1;-1
396583;202008;352590;N;8211300;1;0;1
396949;202008;352590;N;8299799;0;1;-1
397721;202008;352590;H;4930202;6;3;3
397885;202008;352590;K;6462000;2;4;-2
397988;202008;352590;G;4789004;1;0;1
398294;202008;352590;G;4789004;1;0;1
399599;202008;352590;M;7112000;2;0;2
399901;202008;352590;R;9313100;1;0;1
400986;202008;352590;G;4722901;0;1;-1
401511;202008;352590;G;4687702;0;1;-1
401552;202008;352590;N;8111700;1;1;0
401593;202008;352590;G;4713001;2;0;2
401907;202008;352590;I;5611201;0;1;-1
402819;202008;352590;Q;8630501;1;0;1
403063;202008;352590;Q;8640202;5;1;4
403075;202008;352590;G;4711302;0;1;-1
403412;202008;352590;N;7820500;1;0;1
403461;202008;352590;F;4399101;0;2;-2
404112;202008;352590;N;8121400;1;0;1
404358;202008;352590;N;8219999;0;2;-2
404387;202008;352590;N;7729299;0;3;-3
405926;202008;352590;F;4330404;0;1;-1
406132;202008;352590;I;5611203;0;1;-1
407102;202008;352590;N;7739099;3;2;1
407446;202008;352590;P;8599604;0;2;-2
407625;202008;352590;I;5611203;0;1;-1
407977;202008;352590;M;7112000;0;1;-1
408218;202008;352590;G;4633801;1;0;1
408651;202008;352590;N;8121400;0;1;-1
409057;202008;352590;H;5240101;0;1;-1
409250;202008;352590;S;9602502;0;1;-1
410486;202008;352590;Q;8640202;1;0;1
410548;202008;352590;Q;8630504;3;1;2
410888;202008;352590;Q;8630504;1;1;0
411635;202008;352590;S;9602501;0;1;-1
411730;202008;352590;I;5620102;0;1;-1
412601;202008;352590;I;5620104;1;0;1
412615;202008;352590;N;8111700;0;2;-2
413113;202008;352590;G;4729699;0;1;-1
413295;202008;352590;I;5620104;0;1;-1
413815;202008;352590;F;4120400;9;5;4
413965;202008;352590;G;4789099;1;0;1
415053;202008;352590;F;4322302;0;1;-1
415088;202008;352590;H;5212500;8;15;-7
415364;202008;352590;C;1053800;7;5;2
415545;202008;352590;G;4752100;1;0;1
415547;202008;352590;G;4729699;1;0;1
415689;202008;352590;S;9511800;1;0;1
416442;202008;352590;I;5611203;0;1;-1
416514;202008;352590;F;4391600;0;3;-3
416768;202008;352590;G;4530705;0;1;-1
416968;202008;352590;C;1091102;1;0;1
417699;202008;352590;G;4712100;0;1;-1
417785;202008;352590;I;5611201;0;1;-1
417880;202008;352590;G;4712100;1;0;1
418054;202008;352590;S;9603304;3;0;3
418174;202008;352590;G;4789099;3;0;3
418175;202008;352590;G;4789099;0;1;-1
418226;202008;352590;G;4744002;1;0;1
418776;202008;352590;F;4399103;0;1;-1
418969;202008;352590;G;4782201;1;0;1
419560;202008;352590;G;4772500;7;0;7
419624;202008;352590;I;5611203;0;2;-2
421097;202008;352590;G;4789099;5;2;3
421136;202008;352590;G;4781400;2;0;2
421137;202008;352590;G;4781400;0;1;-1
421516;202008;352590;F;4399199;1;0;1
421640;202008;352590;H;4930201;0;1;-1
421706;202008;352590;G;4781400;0;2;-2
422160;202008;352590;J;6209100;0;1;-1
422534;202008;352590;G;4721102;1;2;-1
423583;202008;352590;I;5611201;1;0;1
423819;202008;352590;H;5211799;0;4;-4
424208;202008;352590;N;8291100;4;5;-1
424333;202008;352590;N;8211300;1;0;1
424524;202008;352590;K;6491300;0;1;-1
424841;202008;352590;G;4789004;1;1;0
425157;202008;352590;I;5611201;0;1;-1
426126;202008;352590;G;4511101;2;0;2
426178;202008;352590;S;9499500;1;0;1
426589;202008;352590;H;4930202;1;0;1
427113;202008;352590;N;8299799;1;1;0
427320;202008;352590;P;8511200;0;2;-2
427372;202008;352590;G;4530705;1;0;1
427503;202008;352590;S;9601701;0;1;-1
427506;202008;352590;G;4721104;0;1;-1
427550;202008;352590;G;4772500;0;1;-1
427678;202008;352590;F;4321500;0;1;-1
427724;202008;352590;I;5611203;0;1;-1
427890;202008;352590;G;4723700;1;0;1
428303;202008;352590;J;6110803;1;0;1
428717;202008;352590;N;8291100;1;0;1
429672;202008;352590;S;9601703;9;5;4
430239;202008;352590;C;3314799;0;2;-2
431457;202008;352590;N;8211300;0;1;-1
431821;202008;352590;G;4781400;0;1;-1
432196;202008;352590;G;4784900;1;0;1
433629;202008;352590;P;8512100;1;0;1
433764;202008;352590;I;5611201;0;1;-1
433765;202008;352590;I;5611201;1;0;1
433851;202008;352590;M;7112000;8;1;7
435295;202008;352590;G;4520001;2;0;2
435303;202008;352590;F;4299599;0;3;-3
435459;202008;352590;G;4711301;9;9;0
435607;202008;352590;L;6821802;0;1;-1
435792;202008;352590;F;4321500;2;1;1
436002;202008;352590;G;4781400;0;2;-2
436299;202008;352590;I;5611201;0;2;-2
437135;202008;352590;I;5620104;1;0;1
438091;202008;352590;G;4691500;1;0;1
438294;202008;352590;G;4711302;2;0;2
438840;202008;352590;R;9313100;0;2;-2
439158;202008;352590;S;9511800;0;1;-1
439260;202008;352590;Q;8640299;1;0;1
439537;202008;352590;E;3811400;2;0;2
440848;202008;352590;G;4781400;0;2;-2
440918;202008;352590;G;4781400;2;2;0
441283;202008;352590;P;8513900;1;0;1
441404;202008;352590;C;1412602;0;1;-1
441536;202008;352590;M;7112000;0;1;-1
442011;202008;352590;H;5320202;0;1;-1
442254;202008;352590;G;4530703;1;0;1
442859;202008;352590;G;4530702;2;1;1
442886;202008;352590;P;8593700;1;2;-1
443779;202008;352590;J;6209100;1;0;1
444717;202008;352590;N;7810800;6;4;2
444927;202008;352590;N;8121400;0;1;-1
445553;202008;352590;F;4299599;0;2;-2
446414;202008;352590;N;7739099;3;4;-1
446514;202008;352590;G;4752100;1;1;0
446583;202008;352590;G;4713002;0;1;-1
446705;202008;352590;G;4637199;3;1;2
446709;202008;352590;N;7739099;0;1;-1
448000;202008;352590;S;9602502;0;2;-2
448506;202008;352590;P;8599604;3;1;2
448801;202008;352590;G;4771701;1;0;1
449492;202008;352590;Q;8630503;3;0;3
449786;202008;352590;K;6622300;1;0;1
450694;202008;352590;N;7732201;2;2;0
450817;202008;352590;N;8111700;0;1;-1
451340;202008;352590;H;4930201;0;1;-1
451429;202008;352590;C;2222600;3;2;1
451494;202008;352590;M;7319002;0;2;-2
451938;202008;352590;H;5229099;0;3;-3
452485;202008;352590;G;4722902;1;0;1
452703;202008;352590;H;5223100;3;3;0
452921;202008;352590;G;4641901;1;0;1
453465;202008;352590;I;5620104;1;0;1
453773;202008;352590;I;5611203;0;1;-1
453977;202008;352590;C;1413401;1;0;1
454251;202008;352590;G;4781400;0;1;-1
455271;202008;352590;G;4713002;2;0;2
455496;202008;352590;G;4789002;1;0;1
455796;202008;352590;N;8211300;0;1;-1
457024;202008;352590;G;4742300;1;0;1
457055;202008;352590;G;4763602;0;1;-1
457559;202008;352590;M;7319002;1;0;1
459104;202008;352590;G;4742300;1;0;1
459427;202008;352590;G;4711302;0;1;-1
459788;202008;352590;S;9602501;1;0;1
459957;202008;352590;I;5620103;0;6;-6
459958;202008;352590;I;5620103;0;3;-3
459959;202008;352590;I;5620103;0;2;-2
460519;202008;352590;R;9313100;0;1;-1
461946;202008;352590;P;8520100;0;1;-1
462309;202008;352590;G;4752100;1;1;0
462429;202008;352590;H;4930202;8;6;2
463163;202008;352590;I;5611201;0;1;-1
463165;202008;352590;I;5611201;0;1;-1
463701;202008;352590;I;5611201;2;0;2
464013;202008;352590;I;5620103;0;1;-1
464094;202008;352590;F;4313400;3;0;3
464107;202008;352590;G;4530703;0;1;-1
465065;202008;352590;H;4930202;2;2;0
465330;202008;352590;N;7911200;0;1;-1
465634;202008;352590;N;8111700;7;1;6
465998;202008;352590;A;163600;240;13;227
466035;202008;352590;H;4930202;2;2;0
466424;202008;352590;N;8219999;1;0;1
466512;202008;352590;C;3314707;1;0;1
467525;202008;352590;H;4930201;3;0;3
467685;202008;352590;M;7119701;1;0;1
467840;202008;352590;G;4754701;2;0;2
468252;202008;352590;N;8211300;2;0;2
468841;202008;352590;N;8230001;1;1;0
468917;202008;352590;G;4711302;0;1;-1
469060;202008;352590;N;7722500;0;2;-2
469921;202008;352590;I;5611201;0;2;-2
470016;202008;352590;G;4753900;0;1;-1
470165;202008;352590;G;4753900;30;49;-19
470166;202008;352590;G;4753900;0;2;-2
470167;202008;352590;G;4753900;0;1;-1
470471;202008;352590;G;4753900;8;5;3
470524;202008;352590;G;4753900;0;1;-1
471003;202008;352590;G;4712100;2;2;0
471004;202008;352590;G;4712100;4;0;4
471285;202008;352590;I;5620104;1;0;1
471960;202008;352590;C;1013901;4;1;3
472404;202008;352590;H;4930202;15;20;-5
473164;202008;352590;H;4930202;2;0;2
473876;202008;352590;G;4752100;1;1;0
474126;202008;352590;I;5611201;2;2;0
474475;202008;352590;G;4781400;2;0;2
474616;202008;352590;F;4330404;1;1;0
475267;202008;352590;F;4330404;0;1;-1
475357;202008;352590;G;4684299;2;0;2
475735;202008;352590;G;4520002;1;0;1
476906;202008;352590;F;4292801;0;1;-1
477469;202008;352590;C;3321000;0;2;-2
478004;202008;352590;C;2812700;0;29;-29
478830;202008;352590;H;4930201;0;1;-1
479462;202008;352590;G;4729699;0;1;-1
479930;202008;352590;G;4723700;0;1;-1
479959;202008;352590;P;8599603;0;1;-1
480010;202008;352590;P;8513900;0;1;-1
480049;202008;352590;I;5611201;0;3;-3
480234;202008;352590;I;5611203;0;1;-1
480248;202008;352590;C;3312103;2;0;2
481860;202008;352590;I;5620103;0;1;-1
481884;202008;352590;P;8512100;0;1;-1
482499;202008;352590;G;4774100;1;0;1
482767;202008;352590;Q;8630504;1;2;-1
483353;202008;352590;G;4752100;1;0;1
483707;202008;352590;G;4520001;1;1;0
486178;202008;352590;G;4712100;0;1;-1
486210;202008;352590;G;4687703;1;0;1
486485;202008;352590;F;4299599;0;1;-1
486667;202008;352590;P;8532500;1;0;1
486778;202008;352590;N;8112500;1;0;1
487078;202008;352590;N;8020001;3;0;3
488647;202008;352590;G;4785799;4;1;3
489464;202008;352590;I;5611201;2;0;2
489608;202008;352590;H;5229099;20;6;14
490080;202008;352590;C;1096100;1;0;1
490144;202008;352590;P;8593700;0;1;-1
490433;202008;352590;Q;8630504;2;0;2
491246;202008;352590;G;4771701;1;0;1
491327;202008;352590;G;4789004;1;0;1
491545;202008;352590;F;4120400;7;0;7
492358;202008;352590;I;5611202;0;1;-1
492410;202008;352590;G;4669999;3;1;2
492424;202008;352590;F;4399101;1;0;1
492469;202008;352590;G;4729602;3;2;1
492900;202008;352590;M;7112000;3;0;3
493089;202008;352590;I;5611201;0;1;-1
493444;202008;352590;S;9602501;0;1;-1
493705;202008;352590;H;4930202;2;2;0
493768;202008;352590;I;5611203;0;1;-1
493779;202008;352590;F;4321500;0;1;-1
494482;202008;352590;C;3299003;1;0;1
494643;202008;352590;C;2599302;8;7;1
494795;202008;352590;G;4772500;0;1;-1
495493;202008;352590;I;5611201;0;1;-1
496023;202008;352590;G;4782201;3;0;3
496105;202008;352590;G;4771701;1;0;1
496375;202008;352590;I;5620104;1;0;1
496526;202008;352590;G;4761001;1;0;1
496838;202008;352590;N;8230001;0;1;-1
497182;202008;352590;Q;8630504;1;0;1
497451;202008;352590;C;1091102;1;0;1
497480;202008;352590;I;5620101;0;2;-2
497954;202008;352590;J;6190602;1;0;1
498070;202008;352590;G;4771701;1;1;0
498089;202008;352590;N;8230001;19;0;19
498994;202008;352590;I;5611201;0;1;-1
499049;202008;352590;C;3314799;1;0;1
499050;202008;352590;G;4774100;2;0;2
499111;202008;352590;G;4781400;1;1;0
499408;202008;352590;G;4721102;0;1;-1
500034;202008;352590;I;5611201;1;1;0
500370;202008;352590;G;4635402;0;1;-1
500506;202008;352590;G;4774100;2;0;2
501855;202008;352590;N;8211300;2;2;0
501934;202008;352590;R;9319199;12;0;12
502476;202008;352590;N;7810800;0;1;-1
503310;202008;352590;I;5611201;0;1;-1
503527;202008;352590;G;4744099;1;0;1
504279;202008;352590;H;5320201;0;1;-1
506320;202008;352590;G;4781400;1;0;1
506518;202008;352590;S;9601701;1;0;1
506813;202008;352590;N;7739002;1;0;1
507080;202008;352590;K;6492100;2;0;2
507747;202008;352590;J;6203100;1;0;1
507850;202008;352590;I;5611201;10;0;10
508566;202008;352590;G;4781400;1;0;1
508633;202008;352590;N;8121400;0;1;-1
508672;202008;352590;N;8111700;0;4;-4
508734;202008;352590;I;5620104;0;1;-1
510622;202008;352590;I;5611203;1;1;0
510847;202008;352590;G;4723700;1;0;1
511348;202008;352590;Q;8711502;2;0;2
511645;202008;352590;G;4520001;2;0;2
513776;202008;352590;G;4721104;2;0;2
514016;202008;352590;Q;8650003;1;0;1
514095;202008;352590;G;4761003;1;0;1
514239;202008;352590;M;7319002;3;1;2
514542;202008;352590;I;5620104;1;1;0
514708;202008;352590;C;3329501;1;0;1
515136;202008;352590;G;4754701;2;0;2
515723;202008;352590;N;8111700;6;2;4
515844;202008;352590;F;4120400;6;0;6
516573;202008;352590;N;8211300;6;0;6
517190;202008;352590;G;4742300;4;0;4
517439;202008;352590;G;4744001;2;0;2
517780;202008;352590;H;4930202;2;0;2
518448;202008;352590;I;5611203;2;0;2
518681;202008;352590;H;5320201;2;0;2
518914;202008;352590;G;4721104;2;0;2
519078;202008;352590;G;4789001;2;0;2
520395;202008;352590;C;1095300;3;0;3
520413;202008;352590;I;5611201;1;0;1
520584;202008;352590;G;4752100;1;0;1
520690;202008;352590;G;4773300;3;0;3
522950;202008;352590;P;8599604;3;1;2
523160;202008;352590;F;4222701;7;1;6
523213;202008;352590;I;5611201;0;2;-2
524693;202008;352590;J;6141800;0;1;-1
527977;202008;352590;C;1813099;4;2;2
528068;202008;352590;G;4711302;0;1;-1
528361;202008;352590;G;4774100;1;0;1
528446;202008;352590;C;2091600;0;1;-1
528947;202008;352590;G;4753900;0;3;-3
529011;202008;352590;H;4930202;3;1;2
529014;202008;352590;F;4120400;6;7;-1
529180;202008;352590;C;2019399;1;6;-5
529247;202008;352590;C;2599399;2;1;1
529248;202008;352590;C;2599399;6;6;0
529386;202008;352590;C;2710402;22;5;17
529528;202008;352590;C;2599399;0;1;-1
529911;202008;352590;C;2512800;0;1;-1
529982;202008;352590;R;9312300;2;0;2
529983;202008;352590;G;4744005;0;1;-1
529984;202008;352590;C;2122000;3;0;3
529985;202008;352590;S;9430800;1;0;1
529986;202008;352590;G;4731800;0;1;-1
529987;202008;352590;C;2592602;0;1;-1
529989;202008;352590;G;4721102;1;0;1
529993;202008;352590;K;6550200;5;8;-3
530006;202008;352590;K;6550200;2;4;-2
530044;202008;352590;K;6550200;0;1;-1
530061;202008;352590;F;4399105;0;2;-2
530062;202008;352590;C;1013901;0;1;-1
530063;202008;352590;G;4530703;1;0;1
530064;202008;352590;M;6920601;0;2;-2
530065;202008;352590;S;9521500;0;1;-1
530067;202008;352590;R;9312300;1;0;1
530197;202008;352590;C;2013402;8;5;3
530198;202008;352590;C;2013402;2;0;2
530790;202008;352590;G;4781400;0;2;-2
531170;202008;352590;F;4120400;1;1;0
531185;202008;352590;C;2862300;0;1;-1
531303;202008;352590;G;4782201;1;2;-1
531377;202008;352590;G;4711301;18;3;15
531581;202008;352590;G;4771701;0;1;-1
531792;202008;352590;C;2821601;2;2;0
531802;202008;352590;G;4672900;1;0;1
531803;202008;352590;G;4713002;0;1;-1
531806;202008;352590;O;8411600;3;3;0
532328;202008;352590;C;3250705;1;0;1
532462;202008;352590;C;2063100;8;5;3
532475;202008;352590;C;2651500;0;7;-7
532830;202008;352590;I;5510801;0;1;-1
532841;202008;352590;G;4744002;2;0;2
532866;202008;352590;J;6010100;2;0;2
532867;202008;352590;H;4930202;1;1;0
532868;202008;352590;G;4639701;10;5;5
532887;202008;352590;G;4754701;0;1;-1
532888;202008;352590;F;4313400;3;0;3
532889;202008;352590;H;4929902;0;1;-1
533049;202008;352590;N;8111700;6;2;4
533087;202008;352590;M;6920601;1;0;1
533088;202008;352590;C;2342702;1;0;1
533739;202008;352590;G;4711302;3;3;0
534128;202008;352590;G;4711302;3;0;3
534269;202008;352590;I;5510801;0;1;-1
534417;202008;352590;Q;8640202;3;1;2
534439;202008;352590;Q;8640202;4;2;2
534597;202008;352590;F;4110700;1;0;1
534677;202008;352590;G;4789002;1;0;1
534679;202008;352590;G;4711302;1;1;0
534924;202008;352590;G;4713001;2;0;2
535991;202008;352590;G;4712100;1;0;1
536006;202008;352590;H;4921301;0;6;-6
536247;202008;352590;G;4731800;1;1;0
536777;202008;352590;H;5211799;0;10;-10
536853;202008;352590;Q;8640205;0;3;-3
536891;202008;352590;C;2229399;10;0;10
537063;202008;352590;G;4784900;0;1;-1
537065;202008;352590;G;4731800;1;1;0
537097;202008;352590;G;4781400;2;0;2
537110;202008;352590;G;4781400;1;0;1
537524;202008;352590;I;5620101;0;2;-2
537591;202008;352590;I;5620101;0;3;-3
537650;202008;352590;I;5620101;0;1;-1
537690;202008;352590;I;5620101;0;2;-2
537700;202008;352590;I;5620101;0;1;-1
537794;202008;352590;I;5620101;0;2;-2
537837;202008;352590;I;5620101;1;0;1
538080;202008;352590;G;4772500;0;1;-1
538089;202008;352590;G;4744005;1;0;1
538090;202008;352590;G;4763604;1;0;1
538091;202008;352590;Q;8630503;1;1;0
538093;202008;352590;C;1813099;0;1;-1
538094;202008;352590;M;6920601;1;0;1
538095;202008;352590;P;8599601;2;0;2
538096;202008;352590;G;4530703;1;0;1
538165;202008;352590;P;8599699;0;25;-25
538189;202008;352590;G;4755503;1;0;1
538472;202008;352590;C;1330800;14;14;0
538474;202008;352590;F;4313400;0;1;-1
538804;202008;352590;K;6550200;0;1;-1
538806;202008;352590;K;6550200;2;8;-6
538807;202008;352590;K;6550200;0;1;-1
538970;202008;352590;F;4120400;0;2;-2
538971;202008;352590;G;4731800;1;0;1
538991;202008;352590;H;4921301;1;10;-9
538993;202008;352590;G;4616800;0;1;-1
538997;202008;352590;C;1623400;0;1;-1
538999;202008;352590;C;1122401;1;0;1
539000;202008;352590;G;4711302;0;1;-1
539003;202008;352590;G;4712100;0;1;-1
539004;202008;352590;C;1112700;1;1;0
539005;202008;352590;G;4731800;0;1;-1
539006;202008;352590;G;4744099;4;2;2
539007;202008;352590;C;1112700;2;1;1
539008;202008;352590;G;4530703;1;0;1
539014;202008;352590;P;8513900;1;3;-2
539017;202008;352590;C;2229302;0;11;-11
539020;202008;352590;R;9312300;0;1;-1
539024;202008;352590;C;1033301;1;0;1
539025;202008;352590;C;2219600;2;5;-3
539027;202008;352590;C;1099601;1;1;0
539028;202008;352590;C;1629301;2;6;-4
539033;202008;352590;K;6622300;3;2;1
539037;202008;352590;G;4511104;1;0;1
539038;202008;352590;G;4530705;1;0;1
539039;202008;352590;C;2212900;2;1;1
539041;202008;352590;G;4672900;0;2;-2
539043;202008;352590;H;4929902;2;3;-1
539045;202008;352590;Q;8610101;69;25;44
539046;202008;352590;G;4771701;1;1;0
539047;202008;352590;G;4771701;1;2;-1
539055;202008;352590;G;4731800;1;0;1
539056;202008;352590;G;4711302;2;2;0
539058;202008;352590;G;4711302;0;2;-2
539061;202008;352590;G;4711302;0;2;-2
539063;202008;352590;G;4711302;6;5;1
539065;202008;352590;G;4731800;1;1;0
539066;202008;352590;G;4711302;8;10;-2
539067;202008;352590;G;4711302;4;1;3
539068;202008;352590;G;4711302;16;16;0
539069;202008;352590;G;4711302;1;4;-3
539071;202008;352590;G;4711302;4;7;-3
539072;202008;352590;G;4639701;0;1;-1
539074;202008;352590;G;4711302;5;2;3
539076;202008;352590;G;4711302;1;0;1
539078;202008;352590;G;4711302;3;2;1
539079;202008;352590;G;4711302;5;5;0
539080;202008;352590;G;4711302;15;9;6
539081;202008;352590;H;4921301;0;13;-13
539082;202008;352590;C;1311100;8;2;6
539083;202008;352590;C;1311100;17;29;-12
539084;202008;352590;C;2229301;140;74;66
539085;202008;352590;C;2229301;6;7;-1
539086;202008;352590;C;2229301;7;15;-8
539087;202008;352590;C;2229301;2;2;0
539088;202008;352590;P;8513900;1;1;0
539092;202008;352590;I;5590699;0;1;-1
539095;202008;352590;G;4721102;1;0;1
539096;202008;352590;G;4511101;1;0;1
539097;202008;352590;R;9329899;0;1;-1
539103;202008;352590;S;9430800;1;1;0
539104;202008;352590;C;1813099;0;1;-1
539111;202008;352590;Q;8610101;4;3;1
539114;202008;352590;S;9430800;1;0;1
539115;202008;352590;P;8511200;1;0;1
539117;202008;352590;Q;8610101;9;17;-8
539120;202008;352590;C;2342702;1;1;0
539122;202008;352590;Q;8800600;0;1;-1
539123;202008;352590;P;8511200;0;2;-2
539130;202008;352590;G;4744005;1;1;0
539131;202008;352590;Q;8711502;3;2;1
539132;202008;352590;G;4635499;0;1;-1
539135;202008;352590;G;4744099;1;0;1
539139;202008;352590;G;4711302;2;3;-1
539140;202008;352590;G;4711302;5;3;2
539141;202008;352590;G;4711302;0;2;-2
539142;202008;352590;G;4711302;3;3;0
539144;202008;352590;G;4711302;1;1;0
539147;202008;352590;F;4221902;0;1;-1
539148;202008;352590;M;6920601;3;0;3
539149;202008;352590;G;4731800;1;0;1
539156;202008;352590;S;9420100;0;1;-1
539158;202008;352590;S;9491000;1;4;-3
539160;202008;352590;S;9491000;0;1;-1
539163;202008;352590;S;9491000;1;0;1
539164;202008;352590;S;9491000;1;0;1
539168;202008;352590;G;4633801;7;6;1
539171;202008;352590;P;8531700;0;1;-1
539177;202008;352590;S;9491000;1;0;1
539179;202008;352590;S;9491000;1;1;0
539450;202008;352590;N;8299706;0;1;-1
539451;202008;352590;M;6920601;0;1;-1
539476;202008;352590;C;2071100;2;2;0
539719;202008;352590;C;1013901;4;9;-5
540111;202008;352590;N;8299799;0;1;-1
540112;202008;352590;Q;8640202;0;2;-2
540115;202008;352590;Q;8640202;0;1;-1
540116;202008;352590;Q;8640202;0;1;-1
540117;202008;352590;Q;8640202;0;1;-1
540118;202008;352590;H;4930202;0;3;-3
540144;202008;352590;Q;8610101;6;4;2
540175;202008;352590;P;8520100;1;3;-2
540176;202008;352590;S;9430800;0;1;-1
540177;202008;352590;S;9499500;1;1;0
540187;202008;352590;G;4647801;0;3;-3
540402;202008;352590;C;3250707;2;1;1
540479;202008;352590;C;2342702;18;1;17
540494;202008;352590;G;4661300;20;2;18
540567;202008;352590;I;5611201;1;0;1
540638;202008;352590;E;3702900;1;0;1
540651;202008;352590;G;4744001;0;1;-1
540653;202008;352590;N;8112500;2;0;2
540654;202008;352590;N;8112500;0;1;-1
540655;202008;352590;N;7820500;0;1;-1
540700;202008;352590;G;4639701;0;2;-2
540702;202008;352590;G;4771702;0;1;-1
540744;202008;352590;H;4930202;1;3;-2
540764;202008;352590;G;4782201;2;0;2
540765;202008;352590;G;4782201;0;2;-2
540908;202008;352590;H;4930202;2;0;2
540969;202008;352590;G;4771702;6;4;2
541136;202008;352590;G;4530703;1;0;1
541149;202008;352590;G;4530701;1;0;1
541278;202008;352590;G;4721102;1;0;1
541301;202008;352590;C;1031700;6;3;3
541623;202008;352590;G;4789004;1;0;1
541833;202008;352590;G;4669999;1;0;1
542213;202008;352590;F;4399199;1;0;1
542232;202008;352590;G;4771701;0;1;-1
542780;202008;352590;G;4732600;0;1;-1
542807;202008;352590;K;6424703;3;0;3
542898;202008;352590;Q;8640203;0;1;-1
542937;202008;352590;H;4930202;1;0;1
542939;202008;352590;Q;8711501;1;2;-1
542941;202008;352590;M;7112000;1;0;1
542942;202008;352590;M;7112000;0;1;-1
542944;202008;352590;P;8513900;2;1;1
542945;202008;352590;K;6622300;0;1;-1
543059;202008;352590;G;4712100;1;0;1
543191;202008;352590;C;3101200;2;0;2
543473;202008;352590;C;3101200;0;1;-1
543643;202008;352590;G;4712100;1;0;1
543644;202008;352590;G;4712100;0;1;-1
543813;202008;352590;G;4744005;1;0;1
543868;202008;352590;F;4313400;1;0;1
543870;202008;352590;P;8512100;0;6;-6
543922;202008;352590;G;4511101;8;1;7
544015;202008;352590;C;1093702;1;1;0
544339;202008;352590;G;4789007;2;0;2
544468;202008;352590;F;4399199;3;0;3
544568;202008;352590;H;4923002;0;1;-1
545014;202008;352590;G;4731800;0;1;-1
545042;202008;352590;F;4313400;0;2;-2
545049;202008;352590;C;2829199;0;1;-1
545127;202008;352590;L;6810202;1;1;0
545168;202008;352590;G;4520001;1;0;1
545170;202008;352590;G;4771702;1;0;1
545186;202008;352590;G;4649499;1;0;1
545191;202008;352590;C;2823200;0;2;-2
545197;202008;352590;C;3101200;0;1;-1
545287;202008;352590;G;4661300;4;1;3
545359;202008;352590;C;2449199;1;1;0
545506;202008;352590;G;4520001;1;0;1
545700;202008;352590;I;5510803;0;2;-2
545858;202008;352590;G;4649403;2;0;2
546254;202008;352590;G;4511102;1;0;1
546284;202008;352590;K;6550200;3;2;1
546285;202008;352590;Q;8630502;0;1;-1
546286;202008;352590;Q;8610102;4;2;2
546288;202008;352590;Q;8610101;2;1;1
546299;202008;352590;G;4673700;1;0;1
546508;202008;352590;G;4744005;1;0;1
546510;202008;352590;G;4761003;0;1;-1
546681;202008;352590;F;4321500;0;4;-4
546933;202008;352590;C;3314708;0;1;-1
546956;202008;352590;G;4541205;1;2;-1
547458;202008;352590;H;4930202;2;2;0
547558;202008;352590;K;6493000;0;1;-1
547717;202008;352590;C;2592602;2;2;0
547815;202008;352590;H;4930202;1;2;-1
547839;202008;352590;C;1094500;1;0;1
547979;202008;352590;K;6493000;1;0;1
548334;202008;352590;N;8219901;0;1;-1
548361;202008;352590;I;5611201;3;2;1
548362;202008;352590;I;5611201;0;3;-3
548435;202008;352590;C;2229302;0;1;-1
548466;202008;352590;G;4647801;0;1;-1
548467;202008;352590;N;8121400;3;2;1
548468;202008;352590;H;5223100;0;1;-1
548469;202008;352590;H;5223100;2;0;2
548707;202008;352590;G;4789099;1;0;1
548767;202008;352590;F;4221902;1;0;1
548812;202008;352590;G;4781400;0;1;-1
548816;202008;352590;H;4929902;8;6;2
548849;202008;352590;G;4789099;2;0;2
549057;202008;352590;G;4635402;11;9;2
549146;202008;352590;C;2229399;18;6;12
549173;202008;352590;H;4930202;0;1;-1
549209;202008;352590;Q;8640205;9;3;6
549244;202008;352590;N;7739099;1;0;1
549246;202008;352590;P;8512100;3;1;2
549253;202008;352590;N;8112500;1;1;0
549254;202008;352590;N;8112500;0;1;-1
549255;202008;352590;Q;8640202;1;2;-1
549305;202008;352590;G;4781400;0;5;-5
549365;202008;352590;C;2944100;7;3;4
549394;202008;352590;C;1629301;3;1;2
549508;202008;352590;I;5510803;0;1;-1
549805;202008;352590;F;4292802;13;5;8
549876;202008;352590;G;4772500;0;1;-1
549890;202008;352590;H;4930202;0;2;-2
549920;202008;352590;G;4721102;1;0;1
549940;202008;352590;K;6550200;1;2;-1
550035;202008;352590;E;3839401;2;0;2
550160;202008;352590;H;4930202;2;0;2
550211;202008;352590;C;1091101;0;1;-1
550213;202008;352590;H;4930202;0;1;-1
550240;202008;352590;G;4741500;2;0;2
550437;202008;352590;G;4731800;1;0;1
550462;202008;352590;C;1314600;11;2;9
550463;202008;352590;G;4530703;2;0;2
551125;202008;352590;C;2032100;0;2;-2
551255;202008;352590;G;4789099;0;1;-1
551269;202008;352590;G;4771701;2;0;2
551368;202008;352590;C;2522500;13;8;5
551629;202008;352590;Q;8610101;6;3;3
551672;202008;352590;C;2014200;1;2;-1
551808;202008;352590;C;2599399;0;2;-2
551811;202008;352590;C;2812700;1;0;1
551854;202008;352590;K;6422100;0;1;-1
552526;202008;352590;C;2222600;0;4;-4
552553;202008;352590;I;5612100;1;0;1
552763;202008;352590;G;4744005;1;1;0
552772;202008;352590;G;4511104;0;1;-1
552806;202008;352590;C;2539000;0;6;-6
552807;202008;352590;C;2539000;0;3;-3
553077;202008;352590;G;4633802;3;0;3
553078;202008;352590;G;4633802;0;1;-1
553312;202008;352590;C;3104700;2;0;2
553418;202008;352590;Q;8640212;1;2;-1
553424;202008;352590;Q;8640212;1;0;1
553447;202008;352590;S;9491000;1;0;1
553752;202008;352590;C;2949299;1;0;1
553808;202008;352590;G;4713001;1;0;1
554012;202008;352590;G;4713004;9;1;8
554030;202008;352590;G;4646001;1;0;1
554195;202008;352590;M;7420003;0;1;-1
554201;202008;352590;C;2591800;15;1;14
554257;202008;352590;G;4635402;4;13;-9
554265;202008;352590;C;1122401;6;5;1
554391;202008;352590;C;1721400;0;16;-16
554494;202008;352590;G;4711302;2;1;1
555162;202008;352590;G;4771701;0;1;-1
555186;202008;352590;G;4771701;1;0;1
555357;202008;352590;G;4771701;1;0;1
555469;202008;352590;G;4771701;0;1;-1
555617;202008;352590;C;2949299;2;0;2
556011;202008;352590;N;8211300;4;7;-3
556123;202008;352590;C;1411801;8;8;0
556273;202008;352590;G;4771701;0;2;-2
556424;202008;352590;G;4771701;0;1;-1
556458;202008;352590;G;4771701;0;1;-1
556588;202008;352590;G;4771701;2;1;1
556591;202008;352590;G;4771701;1;0;1
556693;202008;352590;G;4771701;1;1;0
556737;202008;352590;G;4771701;1;0;1
556748;202008;352590;G;4771701;3;0;3
556800;202008;352590;G;4771701;0;1;-1
556820;202008;352590;G;4771701;2;0;2
557017;202008;352590;G;4771701;2;0;2
557090;202008;352590;G;4771701;1;0;1
557203;202008;352590;G;4771701;0;1;-1
557426;202008;352590;Q;8800600;5;11;-6
557477;202008;352590;G;4635402;3;0;3
557724;202008;352590;J;6202300;0;1;-1
557728;202008;352590;P;8512100;0;1;-1
557731;202008;352590;N;8121400;18;10;8
557830;202008;352590;G;4782202;0;2;-2
558277;202008;352590;C;3314704;1;0;1
558591;202008;352590;G;4759899;1;1;0
558691;202008;352590;I;5612100;1;0;1
558697;202008;352590;C;2592601;2;0;2
559421;202008;352590;P;8541400;0;2;-2
559436;202008;352590;P;8541400;0;1;-1
559549;202008;352590;G;4789002;3;1;2
559561;202008;352590;C;2229301;2;0;2
559692;202008;352590;G;4744099;0;1;-1
559713;202008;352590;N;7721700;0;1;-1
559721;202008;352590;G;4530701;1;2;-1
560610;202008;352590;J;6209100;2;5;-3
560621;202008;352590;Q;8660700;7;8;-1
561189;202008;352590;L;6821802;0;1;-1
561340;202008;352590;F;4120400;0;1;-1
561344;202008;352590;C;3314710;6;3;3
561619;202008;352590;I;5510803;0;4;-4
562338;202008;352590;H;4930202;1;0;1
562348;202008;352590;F;4330401;0;2;-2
562616;202008;352590;G;4711302;27;10;17
562664;202008;352590;C;1099699;1;4;-3
562760;202008;352590;F;4211101;0;1;-1
562865;202008;352590;G;4771702;1;1;0
563359;202008;352590;G;4684201;1;0;1
563410;202008;352590;N;7739099;4;0;4
563429;202008;352590;I;5611203;0;1;-1
563430;202008;352590;I;5611203;1;5;-4
563547;202008;352590;G;4789099;2;0;2
564012;202008;352590;N;8111700;1;38;-37
564013;202008;352590;M;6920601;1;0;1
564030;202008;352590;P;8512100;0;2;-2
564031;202008;352590;N;8112500;0;1;-1
564032;202008;352590;Q;8690999;0;1;-1
564041;202008;352590;P;8513900;0;1;-1
564042;202008;352590;P;8513900;0;1;-1
564044;202008;352590;N;8112500;0;1;-1
564046;202008;352590;N;8112500;1;0;1
564047;202008;352590;Q;8630501;0;2;-2
564049;202008;352590;Q;8640207;1;7;-6
564123;202008;352590;G;4771701;3;1;2
564124;202008;352590;G;4771701;1;0;1
564125;202008;352590;G;4771701;1;0;1
564198;202008;352590;G;4744005;1;0;1
564360;202008;352590;C;2014200;3;3;0
564383;202008;352590;C;1013901;2;1;1
564451;202008;352590;F;4120400;14;2;12
564487;202008;352590;C;2222600;4;0;4
564674;202008;352590;G;4729699;0;1;-1
564764;202008;352590;G;4520001;0;1;-1
565043;202008;352590;I;5620101;1;3;-2
565197;202008;352590;N;8112500;0;1;-1
565286;202008;352590;G;4744005;3;1;2
565320;202008;352590;G;4623199;1;0;1
565335;202008;352590;H;4930202;1;2;-1
566478;202008;352590;J;6203100;0;2;-2
566612;202008;352590;C;2543800;0;2;-2
566917;202008;352590;I;5611201;0;2;-2
566947;202008;352590;G;4753900;1;1;0
566951;202008;352590;G;4771702;0;1;-1
566974;202008;352590;G;4530703;1;0;1
568434;202008;352590;G;4511101;9;1;8
568575;202008;352590;C;2229301;50;26;24
568778;202008;352590;F;4110700;2;1;1
568857;202008;352590;N;7739099;1;1;0
569002;202008;352590;G;4754702;1;0;1
569135;202008;352590;G;4744005;1;0;1
569170;202008;352590;G;4741500;1;0;1
569173;202008;352590;G;4741500;0;1;-1
569180;202008;352590;G;4741500;0;2;-2
569210;202008;352590;G;4744005;0;1;-1
570118;202008;352590;C;3299099;0;1;-1
570367;202008;352590;G;4771702;1;0;1
570489;202008;352590;G;4663000;2;0;2
570501;202008;352590;G;4530703;0;1;-1
570563;202008;352590;F;4299599;0;1;-1
570612;202008;352590;G;4789099;0;2;-2
570627;202008;352590;G;4731800;0;1;-1
570645;202008;352590;G;4692300;2;1;1
571402;202008;352590;G;4635402;0;1;-1
572488;202008;352590;H;5310502;2;0;2
572496;202008;352590;H;5223100;0;1;-1
572539;202008;352590;H;5310502;1;1;0
572959;202008;352590;C;1330800;3;0;3
572971;202008;352590;G;4789002;0;1;-1
573050;202008;352590;G;4744099;1;1;0
573126;202008;352590;G;4711302;2;1;1
573162;202008;352590;C;2869100;0;1;-1
573186;202008;352590;M;7490104;0;1;-1
573248;202008;352590;N;7820500;0;1;-1
574074;202008;352590;G;4711301;13;11;2
574425;202008;352590;I;5620101;0;3;-3
574636;202008;352590;C;2349401;23;3;20
574642;202008;352590;N;8211300;5;0;5
575122;202008;352590;H;4930202;2;5;-3
576127;202008;352590;G;4672900;12;0;12
576154;202008;352590;H;4930202;1;1;0
576765;202008;352590;C;2812700;1;2;-1
577472;202008;352590;H;4930203;2;0;2
579209;202008;352590;H;4930202;0;1;-1
579321;202008;352590;G;4781400;1;0;1
579909;202008;352590;G;4530703;3;2;1
580355;202008;352590;G;4711301;0;2;-2
585427;202008;352590;H;4930202;2;1;1
586772;202008;352590;G;4679604;0;1;-1
587217;202008;352590;C;3314710;33;4;29
588112;202008;352590;G;4541201;1;2;-1
588133;202008;352590;G;4783101;0;2;-2
591620;202008;352590;G;4661300;0;1;-1
593362;202008;352590;H;4930202;10;3;7
594147;202008;352590;G;4751201;1;1;0
594573;202008;352590;C;1733800;6;1;5
594574;202008;352590;C;1733800;3;1;2
595833;202008;352590;K;6422100;0;1;-1
595885;202008;352590;K;6422100;0;1;-1
595886;202008;352590;K;6422100;0;1;-1
599143;202008;352590;G;4781400;0;1;-1
602827;202008;352590;C;1733800;8;4;4
602978;202008;352590;N;7732201;1;0;1
603300;202008;352590;G;4721102;1;0;1
603304;202008;352590;E;3832700;1;1;0
603305;202008;352590;I;5620101;3;1;2
603458;202008;352590;I;5611201;0;1;-1
603464;202008;352590;C;2829199;1;0;1
603507;202008;352590;C;2599399;0;1;-1
604102;202008;352590;N;8299799;0;1;-1
604409;202008;352590;F;4330401;5;0;5
604705;202008;352590;G;4752100;1;0;1
604952;202008;352590;C;2813500;26;5;21
604953;202008;352590;C;2349401;5;13;-8
618255;202008;352590;A;132600;0;1;-1
620040;202008;352590;Q;8630504;0;1;-1
621600;202008;352590;M;6912500;6;0;6
191;202101;352590;C;2229399;3;0;3
461;202101;352590;G;4751201;0;1;-1
531;202101;352590;F;4329103;0;1;-1
1351;202101;352590;Q;8640202;3;0;3
1612;202101;352590;K;6622300;1;0;1
2716;202101;352590;C;2599399;1;2;-1
2765;202101;352590;G;4712100;1;0;1
2870;202101;352590;L;6810202;1;0;1
3531;202101;352590;C;2812700;4;2;2
3641;202101;352590;C;1091101;0;1;-1
3643;202101;352590;G;4744005;0;1;-1
4064;202101;352590;C;2222600;3;2;1
4192;202101;352590;C;2949299;38;9;29
4302;202101;352590;G;4754703;1;0;1
4333;202101;352590;G;4672900;3;0;3
5225;202101;352590;C;2040100;9;5;4
5354;202101;352590;N;7739099;1;1;0
5427;202101;352590;H;4924800;0;2;-2
5454;202101;352590;N;7810800;7;151;-144
5658;202101;352590;K;6622300;1;1;0
5770;202101;352590;Q;8610102;1;0;1
5885;202101;352590;H;5229002;0;1;-1
5965;202101;352590;G;4744001;0;1;-1
6891;202101;352590;C;1732000;1;0;1
7232;202101;352590;G;4757100;0;25;-25
7432;202101;352590;G;4753900;2;8;-6
9008;202101;352590;Q;8711502;6;2;4
9052;202101;352590;G;4721102;0;1;-1
9240;202101;352590;C;3101200;1;0;1
9531;202101;352590;G;4649404;0;1;-1
9633;202101;352590;G;4672900;1;2;-1
10421;202101;352590;M;6920601;1;0;1
10841;202101;352590;G;4530703;1;0;1
11592;202101;352590;S;9529199;2;0;2
11957;202101;352590;L;6810202;1;0;1
12009;202101;352590;G;4754701;1;1;0
12393;202101;352590;S;9603304;2;1;1
12410;202101;352590;H;5211701;7;6;1
13009;202101;352590;G;4772500;1;0;1
13314;202101;352590;G;4530703;0;1;-1
13336;202101;352590;I;5611203;1;0;1
13455;202101;352590;Q;8610101;1;7;-6
13596;202101;352590;N;8112500;1;0;1
13787;202101;352590;G;4633801;1;0;1
14089;202101;352590;C;2342702;5;3;2
14346;202101;352590;G;4763604;1;1;0
14714;202101;352590;J;6203100;2;1;1
14842;202101;352590;H;4929902;6;6;0
15036;202101;352590;S;9601703;9;1;8
15040;202101;352590;S;9601703;33;32;1
15339;202101;352590;C;1413401;0;1;-1
15784;202101;352590;P;8599603;0;1;-1
15854;202101;352590;C;2341900;4;3;1
16173;202101;352590;G;4616800;0;1;-1
16176;202101;352590;Q;8630503;0;1;-1
16644;202101;352590;M;6920601;0;2;-2
17599;202101;352590;P;8512100;3;0;3
17600;202101;352590;Q;8640299;2;0;2
17939;202101;352590;G;4530703;1;0;1
18362;202101;352590;G;4732600;1;0;1
18547;202101;352590;S;9601701;1;0;1
18780;202101;352590;R;9319199;1;0;1
18781;202101;352590;M;6920601;1;0;1
19586;202101;352590;C;2229303;0;2;-2
19976;202101;352590;C;2731700;5;0;5
20103;202101;352590;G;4711301;18;12;6
20161;202101;352590;G;4511101;5;5;0
20787;202101;352590;H;5223100;0;1;-1
20808;202101;352590;P;8593700;0;1;-1
20877;202101;352590;E;3701100;0;1;-1
20895;202101;352590;G;4742300;0;2;-2
20983;202101;352590;G;4644301;41;29;12
21012;202101;352590;I;5620101;0;1;-1
21065;202101;352590;M;7112000;3;4;-1
21889;202101;352590;G;4771701;0;1;-1
22070;202101;352590;C;1031700;0;1;-1
22570;202101;352590;N;8299701;31;21;10
22754;202101;352590;S;9430800;0;1;-1
23012;202101;352590;I;5611201;0;1;-1
23389;202101;352590;G;4789099;1;0;1
23904;202101;352590;C;3314702;1;0;1
23977;202101;352590;G;4721102;2;1;1
24303;202101;352590;L;6810202;0;4;-4
24482;202101;352590;C;2229302;3;1;2
24546;202101;352590;G;4781400;2;0;2
24668;202101;352590;G;4771701;1;2;-1
25491;202101;352590;C;2822402;1;1;0
25522;202101;352590;G;4652400;0;3;-3
25895;202101;352590;C;3102100;6;1;5
26396;202101;352590;H;4930203;2;13;-11
26677;202101;352590;I;5510803;1;0;1
26725;202101;352590;G;4689301;0;1;-1
26744;202101;352590;M;6920601;5;2;3
26745;202101;352590;Q;8640299;2;5;-3
26756;202101;352590;F;4329104;1;4;-3
27138;202101;352590;G;4751201;0;2;-2
27355;202101;352590;G;4643502;0;2;-2
27618;202101;352590;C;2222600;2;2;0
27781;202101;352590;Q;8630502;0;1;-1
27842;202101;352590;L;6810202;4;0;4
27977;202101;352590;Q;8630503;1;1;0
28510;202101;352590;N;8299706;1;0;1
29502;202101;352590;H;4930202;3;0;3
29652;202101;352590;G;4639701;0;2;-2
29729;202101;352590;C;1062700;2;2;0
29793;202101;352590;M;7120100;2;1;1
30247;202101;352590;G;4789099;0;1;-1
30529;202101;352590;P;8511200;2;0;2
30530;202101;352590;C;1081302;2;5;-3
31084;202101;352590;M;6920601;3;1;2
31127;202101;352590;C;2539001;3;0;3
31646;202101;352590;C;3250705;3;2;1
31942;202101;352590;G;4721104;1;0;1
33072;202101;352590;P;8512100;7;3;4
33160;202101;352590;N;8211300;32;20;12
33161;202101;352590;G;4634601;19;47;-28
33317;202101;352590;G;4712100;0;1;-1
33974;202101;352590;G;4712100;1;1;0
34074;202101;352590;G;4751201;0;1;-1
34334;202101;352590;G;4763603;1;1;0
35033;202101;352590;I;5611201;1;0;1
35405;202101;352590;I;5611203;0;1;-1
35926;202101;352590;C;2599399;1;0;1
36391;202101;352590;G;4530701;1;0;1
36581;202101;352590;G;4712100;1;0;1
36950;202101;352590;G;4530702;3;1;2
37027;202101;352590;I;5510803;1;0;1
37086;202101;352590;C;2539001;0;1;-1
37250;202101;352590;N;8112500;2;0;2
37470;202101;352590;C;2599399;1;4;-3
37472;202101;352590;G;4759899;0;5;-5
37591;202101;352590;S;9430800;1;0;1
37993;202101;352590;Q;8650099;2;0;2
38007;202101;352590;G;4763601;0;1;-1
38091;202101;352590;J;6209100;0;1;-1
38669;202101;352590;G;4731800;2;0;2
38709;202101;352590;H;4930202;1;1;0
39201;202101;352590;F;4313400;0;1;-1
39304;202101;352590;C;2920402;1;1;0
39669;202101;352590;G;4744005;1;0;1
40420;202101;352590;M;6920601;0;1;-1
40728;202101;352590;N;8211300;12;10;2
41323;202101;352590;C;2511000;3;0;3
41522;202101;352590;G;4751201;1;1;0
41888;202101;352590;P;8511200;1;2;-1
41905;202101;352590;C;2869100;1;0;1
42503;202101;352590;G;4763602;1;0;1
42936;202101;352590;C;1081302;3;3;0
43190;202101;352590;N;8011101;5;3;2
43602;202101;352590;N;7820500;1;0;1
43816;202101;352590;B;810007;1;0;1
44004;202101;352590;G;4731800;1;0;1
44155;202101;352590;C;1749400;0;1;-1
44252;202101;352590;K;6424703;1;0;1
44517;202101;352590;S;9609208;0;2;-2
44911;202101;352590;F;4330403;0;3;-3
45149;202101;352590;G;4781400;0;3;-3
45151;202101;352590;C;1340501;1;1;0
45296;202101;352590;F;4120400;0;2;-2
45371;202101;352590;M;6920601;1;0;1
45385;202101;352590;G;4511101;0;2;-2
45430;202101;352590;H;5221400;20;13;7
45549;202101;352590;C;2941700;21;8;13
45560;202101;352590;R;9313100;1;1;0
45825;202101;352590;E;3811400;1;0;1
45826;202101;352590;G;4614100;0;1;-1
45892;202101;352590;A;122900;0;1;-1
46455;202101;352590;H;4930203;5;1;4
46565;202101;352590;G;4619200;2;0;2
47037;202101;352590;C;2751100;5;0;5
47480;202101;352590;C;2229302;5;0;5
47722;202101;352590;J;6120501;1;0;1
47837;202101;352590;J;6110801;1;0;1
47894;202101;352590;S;9511800;1;0;1
48366;202101;352590;C;2451200;0;1;-1
48429;202101;352590;G;4530703;0;1;-1
48650;202101;352590;C;1099604;1;2;-1
49503;202101;352590;G;4731800;0;1;-1
49530;202101;352590;H;4930202;1;1;0
49597;202101;352590;S;9430800;0;1;-1
49759;202101;352590;Q;8630502;1;0;1
49831;202101;352590;P;8513900;3;4;-1
50068;202101;352590;G;4774100;1;0;1
51114;202101;352590;G;4511101;2;10;-8
51127;202101;352590;C;1412601;2;1;1
51403;202101;352590;I;5611203;0;1;-1
51461;202101;352590;G;4511101;1;3;-2
51923;202101;352590;G;4722901;1;0;1
52546;202101;352590;C;2091600;8;5;3
52547;202101;352590;G;4684299;0;1;-1
52705;202101;352590;G;4530705;1;0;1
52716;202101;352590;P;8512100;7;0;7
53026;202101;352590;F;4211101;1;1;0
53332;202101;352590;G;4781400;0;2;-2
53422;202101;352590;H;4930202;24;4;20
53459;202101;352590;Q;8800600;1;1;0
53793;202101;352590;C;2391503;1;0;1
53916;202101;352590;H;5211799;66;8;58
54122;202101;352590;C;2949299;6;3;3
54136;202101;352590;N;8211300;7;3;4
55500;202101;352590;I;5620103;1;2;-1
55564;202101;352590;H;4930202;10;5;5
55891;202101;352590;C;1013901;7;11;-4
55936;202101;352590;G;4722901;0;1;-1
56464;202101;352590;G;4754701;0;1;-1
56538;202101;352590;P;8511200;0;1;-1
56634;202101;352590;H;5223100;0;1;-1
56700;202101;352590;P;8599602;2;0;2
56891;202101;352590;L;6821802;1;0;1
57110;202101;352590;G;4789099;1;0;1
57565;202101;352590;G;4754702;1;0;1
58152;202101;352590;G;4755503;0;1;-1
58258;202101;352590;G;4679601;0;1;-1
58400;202101;352590;C;3312103;1;1;0
58912;202101;352590;G;4782201;0;1;-1
59339;202101;352590;H;4930202;11;9;2
59633;202101;352590;G;4789001;0;1;-1
59861;202101;352590;N;8121400;19;13;6
59936;202101;352590;S;9493600;0;1;-1
59982;202101;352590;M;6920601;2;1;1
60228;202101;352590;C;2222600;5;6;-1
60783;202101;352590;G;4752100;2;1;1
60784;202101;352590;G;4752100;1;0;1
60792;202101;352590;H;4930202;1;0;1
60832;202101;352590;I;5611201;0;1;-1
61075;202101;352590;G;4724500;0;1;-1
61219;202101;352590;G;4771701;0;1;-1
61220;202101;352590;G;4689399;1;1;0
61466;202101;352590;C;2539001;0;1;-1
61782;202101;352590;G;4639701;3;0;3
61879;202101;352590;K;6622300;1;1;0
62174;202101;352590;G;4744002;0;2;-2
62475;202101;352590;F;4330499;4;2;2
62570;202101;352590;G;4729699;0;1;-1
62877;202101;352590;G;4789099;0;1;-1
63028;202101;352590;N;8299706;1;0;1
63731;202101;352590;H;5229002;0;1;-1
64202;202101;352590;G;4789004;0;1;-1
64212;202101;352590;G;4646001;2;1;1
64454;202101;352590;N;8299706;2;0;2
64793;202101;352590;G;4789004;0;1;-1
64835;202101;352590;I;5620101;1;0;1
64837;202101;352590;I;5620101;1;0;1
64843;202101;352590;I;5620101;1;0;1
64868;202101;352590;Q;8720401;1;2;-1
65134;202101;352590;H;4930203;1;0;1
65544;202101;352590;I;5611201;0;1;-1
66904;202101;352590;G;4754701;1;0;1
67391;202101;352590;C;2599399;0;1;-1
67737;202101;352590;J;5819100;0;1;-1
67809;202101;352590;K;6622300;0;1;-1
67868;202101;352590;G;4732600;0;1;-1
68035;202101;352590;G;4744099;0;1;-1
68066;202101;352590;G;4771702;1;1;0
68090;202101;352590;G;4781400;0;6;-6
68901;202101;352590;N;7739099;1;1;0
69212;202101;352590;G;4711302;0;5;-5
69256;202101;352590;G;4712100;1;1;0
69771;202101;352590;F;4391600;1;1;0
70760;202101;352590;G;4520005;0;2;-2
70791;202101;352590;G;4729699;0;4;-4
70972;202101;352590;C;2539002;0;1;-1
71125;202101;352590;H;4930202;0;1;-1
71211;202101;352590;G;4520001;0;1;-1
71931;202101;352590;E;3600601;2;4;-2
71956;202101;352590;I;5611203;0;4;-4
72136;202101;352590;N;8292000;1;0;1
72323;202101;352590;C;1093702;187;6;181
72743;202101;352590;N;7820500;466;314;152
72822;202101;352590;F;4120400;1;3;-2
73060;202101;352590;N;7732201;0;1;-1
74394;202101;352590;G;4759801;3;0;3
74514;202101;352590;P;8541400;0;1;-1
74649;202101;352590;I;5611203;0;1;-1
74876;202101;352590;H;4930202;0;6;-6
75204;202101;352590;P;8599699;1;0;1
75358;202101;352590;C;2829199;2;3;-1
75567;202101;352590;N;7820500;1;0;1
75596;202101;352590;N;7820500;167;418;-251
76137;202101;352590;M;6920601;1;0;1
76205;202101;352590;C;1062700;0;3;-3
76676;202101;352590;G;4754701;1;0;1
76677;202101;352590;G;4754701;1;0;1
76678;202101;352590;G;4754701;1;0;1
76723;202101;352590;P;8512100;0;1;-1
77235;202101;352590;P;8599699;3;2;1
77259;202101;352590;P;8599699;1;0;1
77490;202101;352590;Q;8630502;0;1;-1
77557;202101;352590;F;4399199;1;1;0
77572;202101;352590;J;6190601;0;1;-1
77638;202101;352590;K;6622300;0;1;-1
78414;202101;352590;M;6920601;3;1;2
78630;202101;352590;G;4774100;1;0;1
78648;202101;352590;N;8129000;63;44;19
78671;202101;352590;G;4781400;0;2;-2
78722;202101;352590;G;4744005;2;0;2
78782;202101;352590;C;2222600;10;7;3
78985;202101;352590;G;4530702;0;1;-1
79244;202101;352590;G;4721104;0;1;-1
79575;202101;352590;G;4789099;1;2;-1
79621;202101;352590;H;4930202;3;2;1
79622;202101;352590;H;4930202;4;10;-6
79912;202101;352590;H;5120000;1;2;-1
79916;202101;352590;H;5120000;3;1;2
80036;202101;352590;N;8122200;0;1;-1
80718;202101;352590;G;4637106;9;6;3
80747;202101;352590;G;4774100;0;1;-1
81420;202101;352590;G;4744001;0;1;-1
81628;202101;352590;Q;8630503;2;0;2
81750;202101;352590;I;5611203;0;1;-1
82176;202101;352590;I;5510803;0;1;-1
82194;202101;352590;F;4120400;0;1;-1
82237;202101;352590;I;5510803;2;2;0
82432;202101;352590;Q;8630501;1;1;0
83147;202101;352590;P;8599601;1;0;1
83219;202101;352590;G;4649499;1;2;-1
83704;202101;352590;N;8211300;3;1;2
83970;202101;352590;N;8291100;4;0;4
84534;202101;352590;G;4530703;3;1;2
84948;202101;352590;G;4672900;3;1;2
85060;202101;352590;I;5611201;10;5;5
85063;202101;352590;I;5611201;5;3;2
85199;202101;352590;S;9430800;5;0;5
85330;202101;352590;N;8299799;5;1;4
85331;202101;352590;N;8299799;0;1;-1
85390;202101;352590;K;6462000;1;0;1
85397;202101;352590;Q;8711502;3;4;-1
85700;202101;352590;J;6203100;2;0;2
85932;202101;352590;N;7820500;2;0;2
86419;202101;352590;F;4120400;0;2;-2
86669;202101;352590;H;4930202;1;2;-1
88244;202101;352590;H;4930201;0;2;-2
88500;202101;352590;G;4530703;1;1;0
88553;202101;352590;C;2029100;1;1;0
88916;202101;352590;H;5112901;5;4;1
89310;202101;352590;G;4721102;1;0;1
89317;202101;352590;G;4520001;1;0;1
90085;202101;352590;P;8532500;0;1;-1
90151;202101;352590;G;4789002;1;0;1
90170;202101;352590;P;8599699;3;2;1
90711;202101;352590;G;4541202;0;1;-1
92086;202101;352590;G;4744003;0;1;-1
92587;202101;352590;C;3314721;4;1;3
93009;202101;352590;G;4511101;2;4;-2
93223;202101;352590;N;7711000;0;1;-1
93498;202101;352590;F;4299599;48;1;47
93501;202101;352590;F;4299599;41;44;-3
93968;202101;352590;Q;8640210;1;0;1
93969;202101;352590;Q;8640210;1;0;1
93970;202101;352590;N;8211300;1;0;1
94171;202101;352590;M;6920601;1;0;1
94292;202101;352590;G;4743100;1;0;1
94521;202101;352590;G;4731800;4;2;2
94566;202101;352590;C;2599399;1;0;1
94585;202101;352590;G;4639701;10;12;-2
95835;202101;352590;I;5611201;1;0;1
95858;202101;352590;H;5250804;0;1;-1
95864;202101;352590;M;6911701;0;1;-1
96554;202101;352590;N;8299799;8;8;0
97501;202101;352590;E;3839499;0;2;-2
98568;202101;352590;P;8512100;1;4;-3
98741;202101;352590;H;5250801;1;0;1
98874;202101;352590;I;5611203;4;1;3
99421;202101;352590;G;4731800;1;0;1
99456;202101;352590;N;8211300;63;26;37
99526;202101;352590;G;4771702;2;0;2
99689;202101;352590;G;4789002;0;2;-2
99718;202101;352590;G;4789099;1;2;-1
99831;202101;352590;N;8211300;1;0;1
100044;202101;352590;I;5620104;1;0;1
100422;202101;352590;G;4731800;0;1;-1
100883;202101;352590;G;4759899;0;1;-1
101362;202101;352590;P;8599603;0;1;-1
101936;202101;352590;M;6920601;3;0;3
102661;202101;352590;Q;8630504;1;1;0
103332;202101;352590;Q;8650099;9;11;-2
103432;202101;352590;R;9313100;2;1;1
103576;202101;352590;G;4789007;0;2;-2
103601;202101;352590;C;2949299;2;1;1
103682;202101;352590;G;4753900;1;2;-1
104165;202101;352590;I;5611201;3;1;2
104168;202101;352590;F;4120400;1;0;1
104243;202101;352590;L;6810202;2;0;2
104253;202101;352590;F;4321500;1;0;1
104544;202101;352590;H;5223100;0;1;-1
105318;202101;352590;G;4781400;0;1;-1
105319;202101;352590;I;5611203;0;1;-1
106009;202101;352590;H;4930201;4;2;2
106091;202101;352590;M;6920601;0;2;-2
106728;202101;352590;M;6920601;1;0;1
106790;202101;352590;G;4773300;1;0;1
107075;202101;352590;C;2222600;4;5;-1
107162;202101;352590;G;4724500;3;9;-6
107175;202101;352590;G;4724500;0;1;-1
107326;202101;352590;I;5611202;0;1;-1
107363;202101;352590;N;8299799;1;0;1
108150;202101;352590;I;5510803;0;1;-1
108307;202101;352590;I;5510803;0;1;-1
108630;202101;352590;G;4511101;2;0;2
109989;202101;352590;Q;8630501;1;1;0
110156;202101;352590;C;1412601;1;0;1
110206;202101;352590;G;4731800;0;2;-2
110214;202101;352590;F;4299599;0;1;-1
110471;202101;352590;R;9313100;2;0;2
110955;202101;352590;G;4520002;2;0;2
111056;202101;352590;S;9430800;6;7;-1
111643;202101;352590;S;9430800;0;6;-6
112138;202101;352590;I;5611203;1;0;1
112404;202101;352590;K;6622300;1;0;1
112411;202101;352590;N;8299706;0;1;-1
112450;202101;352590;Q;8630504;1;2;-1
113381;202101;352590;N;8299706;1;0;1
113560;202101;352590;I;5611203;0;1;-1
114396;202101;352590;I;5611203;1;0;1
114397;202101;352590;I;5611201;0;1;-1
114412;202101;352590;G;4781400;0;1;-1
114877;202101;352590;J;5914600;1;2;-1
114970;202101;352590;G;4530703;9;3;6
114991;202101;352590;F;4110700;2;0;2
114994;202101;352590;C;2950600;1;0;1
115528;202101;352590;G;4731800;4;0;4
115532;202101;352590;G;4782201;6;28;-22
115564;202101;352590;F;4313400;0;1;-1
115751;202101;352590;G;4789099;0;1;-1
115882;202101;352590;I;5611203;1;0;1
116016;202101;352590;G;4723700;0;1;-1
116109;202101;352590;F;4313400;8;13;-5
116177;202101;352590;P;8512100;2;1;1
116271;202101;352590;G;4511101;7;5;2
116682;202101;352590;F;4330404;2;0;2
116869;202101;352590;P;8513900;1;0;1
117114;202101;352590;I;5611201;0;1;-1
118508;202101;352590;N;8220200;0;1;-1
119087;202101;352590;G;4687703;0;1;-1
119920;202101;352590;N;7820500;143;84;59
120652;202101;352590;R;9313100;2;0;2
120823;202101;352590;F;4399105;1;1;0
121069;202101;352590;Q;8712300;1;4;-3
121132;202101;352590;N;8299799;1;0;1
121251;202101;352590;G;4744001;0;1;-1
121772;202101;352590;J;6202300;1;3;-2
121918;202101;352590;I;5611203;1;0;1
122114;202101;352590;M;6920601;1;0;1
122427;202101;352590;G;4755502;1;2;-1
122460;202101;352590;M;6920601;0;1;-1
123294;202101;352590;G;4781400;0;2;-2
123473;202101;352590;G;4744002;1;0;1
123878;202101;352590;M;6920601;0;1;-1
124177;202101;352590;G;4541203;1;0;1
124253;202101;352590;G;4761001;0;1;-1
124427;202101;352590;G;4721102;1;1;0
124964;202101;352590;P;8511200;1;2;-1
125142;202101;352590;R;9313100;1;1;0
126028;202101;352590;N;8299799;2;1;1
126409;202101;352590;N;8299799;1;0;1
127830;202101;352590;G;4711302;3;7;-4
127860;202101;352590;G;4774100;3;1;2
128121;202101;352590;G;4649499;1;0;1
128177;202101;352590;G;4771701;0;2;-2
128187;202101;352590;G;4721104;0;2;-2
129478;202101;352590;C;2219600;2;0;2
129574;202101;352590;G;4759899;0;1;-1
129655;202101;352590;Q;8650003;0;3;-3
129716;202101;352590;G;4686902;2;1;1
129755;202101;352590;G;4744099;0;1;-1
129916;202101;352590;G;4789099;0;1;-1
130146;202101;352590;C;2825900;0;2;-2
130198;202101;352590;G;4772500;0;1;-1
130205;202101;352590;G;4772500;0;3;-3
130622;202101;352590;M;7500100;1;0;1
131123;202101;352590;G;4741500;2;0;2
131415;202101;352590;C;2399101;3;0;3
131417;202101;352590;C;2539001;0;1;-1
131725;202101;352590;P;8512100;0;3;-3
131947;202101;352590;G;4759899;6;2;4
131949;202101;352590;G;4759899;4;0;4
131950;202101;352590;G;4759899;2;0;2
131951;202101;352590;G;4759899;2;0;2
131960;202101;352590;G;4649499;9;8;1
132066;202101;352590;G;4761001;2;3;-1
132787;202101;352590;G;4753900;0;1;-1
133015;202101;352590;H;4930203;2;3;-1
133047;202101;352590;N;8299799;0;2;-2
133073;202101;352590;G;4712100;0;7;-7
133122;202101;352590;N;8299799;29;5;24
133356;202101;352590;G;4789004;0;1;-1
133403;202101;352590;G;4789099;1;0;1
133429;202101;352590;C;1099699;1;0;1
133582;202101;352590;C;1082100;0;8;-8
133848;202101;352590;G;4645101;0;4;-4
134124;202101;352590;F;4120400;7;1;6
134794;202101;352590;G;4711302;3;5;-2
134935;202101;352590;G;4711301;12;5;7
135009;202101;352590;C;3211602;1;0;1
135180;202101;352590;G;4711302;2;0;2
135227;202101;352590;G;4511102;0;1;-1
135251;202101;352590;F;4322302;1;0;1
135758;202101;352590;C;2829199;1;1;0
135817;202101;352590;I;5611201;2;1;1
136106;202101;352590;P;8531700;0;3;-3
136117;202101;352590;C;2941700;1;0;1
136805;202101;352590;M;6920601;1;0;1
137288;202101;352590;G;4789002;0;1;-1
137439;202101;352590;C;2591800;8;3;5
138198;202101;352590;G;4761001;2;0;2
138199;202101;352590;I;5611201;0;1;-1
139781;202101;352590;F;4120400;0;1;-1
139953;202101;352590;C;2330302;1;0;1
140085;202101;352590;G;4759899;0;1;-1
140175;202101;352590;G;4530703;0;1;-1
140307;202101;352590;F;4313400;5;3;2
141085;202101;352590;C;1013902;9;6;3
142353;202101;352590;G;4712100;4;2;2
142527;202101;352590;G;4789002;5;0;5
142768;202101;352590;G;4751201;1;0;1
143019;202101;352590;G;4763602;0;6;-6
143432;202101;352590;H;4930202;7;6;1
145546;202101;352590;G;4721102;0;1;-1
146180;202101;352590;N;8299799;0;10;-10
146650;202101;352590;G;4763601;0;1;-1
148199;202101;352590;C;2710402;4;3;1
148365;202101;352590;G;4520001;1;1;0
148432;202101;352590;G;4711302;4;10;-6
148512;202101;352590;I;5611201;0;1;-1
149324;202101;352590;I;5611201;0;1;-1
150084;202101;352590;G;4763603;1;0;1
150134;202101;352590;G;4731800;1;2;-1
150521;202101;352590;N;8211300;4;1;3
150647;202101;352590;N;8011101;31;21;10
150778;202101;352590;G;4754701;0;1;-1
151545;202101;352590;K;6424703;1;0;1
152070;202101;352590;H;4930202;1;0;1
152071;202101;352590;H;4930202;0;2;-2
152529;202101;352590;N;8211300;3;7;-4
152700;202101;352590;G;4729699;1;0;1
152895;202101;352590;G;4530703;1;2;-1
153417;202101;352590;G;4530703;0;1;-1
153891;202101;352590;G;4530703;2;0;2
153938;202101;352590;C;2790299;13;7;6
154637;202101;352590;H;4930202;0;1;-1
154969;202101;352590;E;3701100;3;1;2
154999;202101;352590;H;4930201;1;0;1
155031;202101;352590;C;1053800;1;0;1
155217;202101;352590;Q;8630501;7;8;-1
155546;202101;352590;G;4722901;1;0;1
155651;202101;352590;G;4633801;18;6;12
156698;202101;352590;G;4744099;0;2;-2
157020;202101;352590;P;8599605;1;0;1
157146;202101;352590;M;7120100;2;2;0
157857;202101;352590;F;4321500;0;1;-1
158028;202101;352590;N;8111700;5;2;3
158512;202101;352590;G;4751201;0;1;-1
158675;202101;352590;F;4299599;0;1;-1
158881;202101;352590;F;4110700;0;1;-1
158963;202101;352590;C;2071100;1;1;0
159245;202101;352590;G;4731800;1;0;1
159276;202101;352590;F;4399103;0;1;-1
159516;202101;352590;C;2790299;1;0;1
159782;202101;352590;S;9430800;15;1;14
160430;202101;352590;P;8520100;2;0;2
160790;202101;352590;C;2759799;0;1;-1
161159;202101;352590;G;4722901;0;1;-1
161496;202101;352590;H;4930202;0;1;-1
161941;202101;352590;I;5611201;0;1;-1
162641;202101;352590;G;4752100;1;0;1
162877;202101;352590;I;5620101;2;0;2
163137;202101;352590;Q;8630503;0;1;-1
163454;202101;352590;G;4741500;2;0;2
163455;202101;352590;G;4741500;1;0;1
163479;202101;352590;G;4731800;2;0;2
163522;202101;352590;N;8211300;1;0;1
163759;202101;352590;C;2029100;8;4;4
163787;202101;352590;G;4635402;4;1;3
165345;202101;352590;H;4930202;1;2;-1
165518;202101;352590;M;6920601;1;0;1
165898;202101;352590;R;9313100;0;2;-2
166034;202101;352590;G;4520001;0;1;-1
166047;202101;352590;G;4754703;2;0;2
166189;202101;352590;G;4520005;0;1;-1
166748;202101;352590;G;4617600;1;3;-2
167017;202101;352590;C;1062700;0;1;-1
167384;202101;352590;S;9511800;0;1;-1
167611;202101;352590;G;4721102;4;2;2
167732;202101;352590;G;4722901;0;1;-1
168299;202101;352590;J;6204000;0;1;-1
168385;202101;352590;J;6201501;0;1;-1
168557;202101;352590;I;5510801;0;2;-2
168956;202101;352590;C;1031700;1;0;1
169268;202101;352590;P;8520100;6;1;5
169273;202101;352590;J;6201501;1;2;-1
169544;202101;352590;J;6203100;1;2;-1
169560;202101;352590;G;4761003;2;0;2
169784;202101;352590;G;4752100;0;1;-1
169793;202101;352590;C;2543800;5;0;5
170110;202101;352590;G;4744005;0;1;-1
170643;202101;352590;N;8112500;2;3;-1
170672;202101;352590;C;1053800;0;1;-1
171089;202101;352590;H;4930202;0;2;-2
171090;202101;352590;H;4930201;0;1;-1
171199;202101;352590;G;4754702;0;1;-1
172218;202101;352590;G;4712100;0;1;-1
172313;202101;352590;C;1099601;0;1;-1
172448;202101;352590;P;8512100;1;0;1
172456;202101;352590;P;8520100;0;1;-1
172780;202101;352590;C;1042200;3;4;-1
172910;202101;352590;P;8513900;3;4;-1
172911;202101;352590;P;8513900;1;2;-1
173441;202101;352590;H;4930202;0;2;-2
173717;202101;352590;G;4789001;0;1;-1
173797;202101;352590;G;4781400;1;1;0
174065;202101;352590;H;5212500;1;0;1
174413;202101;352590;N;7911200;0;1;-1
174692;202101;352590;K;6619399;0;1;-1
175185;202101;352590;I;5611203;0;2;-2
175324;202101;352590;J;6190699;4;1;3
175919;202101;352590;G;4511101;1;0;1
176234;202101;352590;M;6920601;3;0;3
176328;202101;352590;M;7112000;1;1;0
176643;202101;352590;N;7711000;3;2;1
176945;202101;352590;I;5611203;0;1;-1
176959;202101;352590;I;5611203;0;2;-2
177645;202101;352590;N;8130300;0;1;-1
177783;202101;352590;I;5611201;1;0;1
178175;202101;352590;G;4782201;0;1;-1
179112;202101;352590;G;4744001;1;0;1
179150;202101;352590;S;9609208;0;1;-1
179663;202101;352590;G;4530703;0;1;-1
179880;202101;352590;G;4753900;4;2;2
179881;202101;352590;G;4753900;0;1;-1
180011;202101;352590;G;4789099;1;0;1
180674;202101;352590;P;8512100;1;0;1
180810;202101;352590;G;4639701;1;2;-1
181429;202101;352590;G;4530703;4;2;2
182459;202101;352590;P;8511200;0;1;-1
182512;202101;352590;G;4744001;3;1;2
182555;202101;352590;G;4686902;0;1;-1
182658;202101;352590;B;891600;2;0;2
182927;202101;352590;G;4755502;1;0;1
182991;202101;352590;G;4729699;0;1;-1
183297;202101;352590;C;2621300;25;40;-15
183298;202101;352590;C;2632900;63;23;40
183365;202101;352590;N;8299799;103;89;14
184277;202101;352590;G;4729699;0;1;-1
184587;202101;352590;Q;8630503;2;1;1
185106;202101;352590;H;5212500;1;10;-9
185172;202101;352590;G;4789099;0;1;-1
185271;202101;352590;G;4761001;0;1;-1
185597;202101;352590;M;7311400;0;1;-1
185764;202101;352590;G;4784900;0;1;-1
186195;202101;352590;C;3316301;2;1;1
186705;202101;352590;G;4731800;1;0;1
186736;202101;352590;I;5611203;0;1;-1
187188;202101;352590;F;4321500;0;2;-2
187268;202101;352590;N;7732201;6;1;5
187391;202101;352590;G;4543900;1;0;1
187676;202101;352590;N;7830200;0;2;-2
188161;202101;352590;C;3313999;0;1;-1
188680;202101;352590;J;6201501;3;0;3
189449;202101;352590;H;4930202;1;2;-1
189729;202101;352590;F;4399199;2;0;2
189847;202101;352590;K;6491300;0;1;-1
191164;202101;352590;J;5829800;1;1;0
191347;202101;352590;F;4120400;1;1;0
191585;202101;352590;S;9609208;1;0;1
191649;202101;352590;P;8512100;1;0;1
191778;202101;352590;G;4530703;1;1;0
192306;202101;352590;G;4744001;1;0;1
193099;202101;352590;G;4763603;1;0;1
193102;202101;352590;P;8512100;0;2;-2
193431;202101;352590;G;4781400;0;1;-1
193617;202101;352590;S;9603304;1;0;1
193772;202101;352590;F;4213800;5;1;4
194327;202101;352590;C;2840200;1;0;1
194342;202101;352590;G;4729699;3;3;0
194660;202101;352590;G;4663000;0;1;-1
194761;202101;352590;I;5611203;0;1;-1
194866;202101;352590;H;5212500;1;6;-5
194878;202101;352590;G;4729699;0;1;-1
194988;202101;352590;N;8111700;7;4;3
195488;202101;352590;G;4789001;1;0;1
196117;202101;352590;N;7820500;7;2;5
196183;202101;352590;G;4511101;4;1;3
196476;202101;352590;I;5611201;0;1;-1
197077;202101;352590;C;2093200;1;1;0
197545;202101;352590;Q;8640212;1;0;1
197961;202101;352590;H;4930202;0;1;-1
198660;202101;352590;G;4729699;1;7;-6
198835;202101;352590;G;4755502;0;1;-1
199002;202101;352590;G;4744003;1;0;1
199252;202101;352590;F;4110700;2;1;1
199465;202101;352590;G;4789002;0;1;-1
200213;202101;352590;C;3101200;0;1;-1
200511;202101;352590;H;4930202;0;1;-1
200696;202101;352590;F;4222701;3;3;0
200946;202101;352590;I;5611203;0;5;-5
200952;202101;352590;G;4789099;1;1;0
201212;202101;352590;G;4686902;1;4;-3
201783;202101;352590;Q;8711502;1;0;1
201830;202101;352590;E;3832700;0;1;-1
202199;202101;352590;I;5611201;4;3;1
202227;202101;352590;I;5611201;1;1;0
202237;202101;352590;I;5611201;2;3;-1
202670;202101;352590;C;2222600;1;2;-1
202930;202101;352590;G;4781400;1;0;1
203534;202101;352590;G;4511101;4;2;2
204420;202101;352590;G;4789099;1;0;1
204974;202101;352590;G;4774100;1;0;1
204975;202101;352590;G;4774100;0;1;-1
205386;202101;352590;N;8111700;1;1;0
205410;202101;352590;I;5611201;5;0;5
205870;202101;352590;G;4754701;2;5;-3
205873;202101;352590;G;4754701;0;1;-1
207401;202101;352590;I;5611201;0;3;-3
207820;202101;352590;P;8541400;0;1;-1
208122;202101;352590;I;5611203;3;1;2
208376;202101;352590;Q;8630501;0;1;-1
208664;202101;352590;I;5620101;2;3;-1
209276;202101;352590;G;4731800;3;0;3
209879;202101;352590;I;5611201;2;0;2
209920;202101;352590;F;4330404;2;1;1
209921;202101;352590;F;4330404;0;2;-2
210188;202101;352590;G;4754701;0;1;-1
210413;202101;352590;M;6920601;3;4;-1
211187;202101;352590;M;7112000;1;4;-3
211188;202101;352590;J;6204000;0;6;-6
212366;202101;352590;G;4530703;0;2;-2
212690;202101;352590;K;6622300;1;0;1
213541;202101;352590;F;4321500;3;2;1
213561;202101;352590;G;4772500;2;5;-3
213914;202101;352590;I;5611201;6;5;1
214688;202101;352590;N;8011101;0;1;-1
215010;202101;352590;G;4713002;1;1;0
215069;202101;352590;I;5611201;0;1;-1
215348;202101;352590;G;4711302;3;2;1
215380;202101;352590;G;4511102;1;0;1
215387;202101;352590;G;4511101;1;1;0
215783;202101;352590;N;8211300;1;1;0
216114;202101;352590;I;5620101;2;0;2
216319;202101;352590;Q;8610101;1;6;-5
216929;202101;352590;G;4686902;1;2;-1
216995;202101;352590;G;4724500;6;16;-10
216996;202101;352590;G;4633801;1;1;0
216997;202101;352590;G;4724500;9;26;-17
217096;202101;352590;I;5620101;1;0;1
217576;202101;352590;L;6810201;1;0;1
219266;202101;352590;J;5914600;0;2;-2
219684;202101;352590;P;8599601;2;0;2
220268;202101;352590;I;5510801;3;1;2
220427;202101;352590;H;5250805;0;1;-1
220467;202101;352590;C;2621300;9;3;6
220992;202101;352590;G;4691500;3;3;0
221142;202101;352590;I;5611204;0;1;-1
221404;202101;352590;C;3299099;1;1;0
221563;202101;352590;Q;8711502;1;1;0
222480;202101;352590;G;4789001;0;2;-2
222517;202101;352590;C;2511000;6;3;3
223719;202101;352590;M;6920601;2;0;2
223809;202101;352590;I;5611201;2;3;-1
224386;202101;352590;P;8511200;0;1;-1
224387;202101;352590;M;6920601;0;1;-1
224545;202101;352590;I;5611201;0;1;-1
224963;202101;352590;N;8299799;1;0;1
225046;202101;352590;H;5211701;2;0;2
225047;202101;352590;H;5211701;0;2;-2
225050;202101;352590;G;4712100;1;0;1
225217;202101;352590;M;7111100;2;2;0
225220;202101;352590;M;7119701;2;0;2
225418;202101;352590;C;2660400;31;7;24
226077;202101;352590;G;4771701;0;2;-2
226174;202101;352590;Q;8640205;2;0;2
226272;202101;352590;I;5611201;1;0;1
226365;202101;352590;G;4712100;2;0;2
227726;202101;352590;G;4511101;3;5;-2
228076;202101;352590;G;4729699;0;1;-1
228226;202101;352590;G;4781400;0;1;-1
228800;202101;352590;G;4782201;1;1;0
228822;202101;352590;H;4930202;1;0;1
229139;202101;352590;G;4520004;2;1;1
229700;202101;352590;G;4754701;2;11;-9
230124;202101;352590;N;8211300;11;6;5
230150;202101;352590;G;4713002;0;2;-2
230424;202101;352590;G;4729699;1;0;1
230925;202101;352590;N;8220200;0;1;-1
231354;202101;352590;Q;8630504;1;0;1
231435;202101;352590;G;4530703;1;0;1
232663;202101;352590;P;8513900;1;0;1
233283;202101;352590;P;8513900;0;8;-8
233447;202101;352590;N;8122200;0;1;-1
233748;202101;352590;G;4744003;1;0;1
234325;202101;352590;G;4761003;1;0;1
234927;202101;352590;G;4753900;0;1;-1
235386;202101;352590;G;4742300;1;0;1
235621;202101;352590;G;4721102;0;1;-1
235789;202101;352590;M;7500100;1;0;1
235790;202101;352590;M;7500100;1;1;0
236281;202101;352590;J;6204000;1;1;0
237052;202101;352590;I;5611201;0;2;-2
238051;202101;352590;C;2222600;23;11;12
238210;202101;352590;K;6619399;0;1;-1
238668;202101;352590;G;4771701;1;3;-2
238688;202101;352590;C;3314707;5;3;2
238892;202101;352590;S;9602502;0;1;-1
240169;202101;352590;K;6622300;1;0;1
240176;202101;352590;H;4930202;0;2;-2
241128;202101;352590;C;1629301;0;1;-1
241342;202101;352590;G;4731800;2;4;-2
242308;202101;352590;S;9609299;1;2;-1
242324;202101;352590;G;4712100;0;2;-2
242325;202101;352590;N;8299799;2;0;2
244279;202101;352590;Q;8630502;0;2;-2
244558;202101;352590;G;4645103;0;1;-1
245061;202101;352590;M;6920601;2;1;1
246296;202101;352590;G;4729699;1;1;0
246429;202101;352590;C;3313901;0;2;-2
247046;202101;352590;P;8511200;3;0;3
247360;202101;352590;H;4930202;19;12;7
247571;202101;352590;F;4213800;1;2;-1
247682;202101;352590;C;1099699;3;2;1
247997;202101;352590;K;6622300;0;1;-1
249096;202101;352590;C;1099699;3;0;3
249405;202101;352590;G;4530703;1;1;0
249968;202101;352590;P;8599604;1;0;1
250008;202101;352590;G;4712100;1;1;0
251034;202101;352590;G;4623109;1;0;1
251054;202101;352590;G;4781400;0;230;-230
251065;202101;352590;G;4511104;2;2;0
251095;202101;352590;P;8513900;1;0;1
251096;202101;352590;P;8513900;2;1;1
251098;202101;352590;N;8130300;39;11;28
251099;202101;352590;G;4789099;5;9;-4
251763;202101;352590;S;9601701;1;0;1
251848;202101;352590;G;4761003;2;0;2
252631;202101;352590;C;3250706;1;0;1
252837;202101;352590;G;4782201;0;1;-1
252838;202101;352590;G;4781400;2;1;1
252840;202101;352590;G;4781400;0;1;-1
252873;202101;352590;G;4759801;1;0;1
253115;202101;352590;G;4633801;0;1;-1
253117;202101;352590;A;132600;1;9;-8
253372;202101;352590;M;6920601;1;0;1
253485;202101;352590;N;8299799;0;1;-1
253520;202101;352590;C;3314710;1;0;1
253557;202101;352590;L;6821802;0;1;-1
253970;202101;352590;N;8299799;1;4;-3
254354;202101;352590;C;2311700;1;1;0
254355;202101;352590;G;4744002;1;0;1
255209;202101;352590;H;5212500;10;10;0
255623;202101;352590;C;3314721;1;0;1
255674;202101;352590;C;2349401;1;2;-1
256094;202101;352590;G;4520005;0;1;-1
256204;202101;352590;Q;8630501;2;0;2
256343;202101;352590;G;4789005;1;0;1
256571;202101;352590;M;7500100;2;0;2
257407;202101;352590;N;8292000;0;1;-1
257806;202101;352590;G;4789099;1;0;1
258216;202101;352590;G;4754701;1;1;0
258254;202101;352590;N;8211300;0;3;-3
259922;202101;352590;C;2072000;4;2;2
260589;202101;352590;N;8219999;1;1;0
260784;202101;352590;G;4633801;1;0;1
261192;202101;352590;P;8599604;1;0;1
261294;202101;352590;G;4649499;0;4;-4
261785;202101;352590;I;5611201;1;0;1
262095;202101;352590;P;8513900;0;2;-2
262119;202101;352590;G;4520007;3;0;3
262705;202101;352590;H;4930202;1;0;1
262859;202101;352590;N;8211300;1;0;1
263010;202101;352590;C;2542000;0;1;-1
263941;202101;352590;Q;8712300;3;2;1
264196;202101;352590;C;1091101;10;8;2
266042;202101;352590;G;4744099;0;1;-1
266206;202101;352590;C;1733800;2;3;-1
266417;202101;352590;I;5611203;1;0;1
266567;202101;352590;P;8513900;1;0;1
266816;202101;352590;I;5620101;1;0;1
266849;202101;352590;P;8599603;0;3;-3
267294;202101;352590;P;8511200;3;0;3
267319;202101;352590;I;5611201;1;1;0
267530;202101;352590;G;4781400;1;3;-2
269413;202101;352590;N;8219999;0;1;-1
269419;202101;352590;L;6822600;1;0;1
269546;202101;352590;F;4120400;0;2;-2
270069;202101;352590;J;6311900;1;0;1
270555;202101;352590;J;5811500;0;1;-1
270647;202101;352590;M;6920601;0;1;-1
270949;202101;352590;F;4322302;2;2;0
271169;202101;352590;L;6821802;2;0;2
271729;202101;352590;G;4520001;0;1;-1
271762;202101;352590;G;4789004;1;0;1
272043;202101;352590;I;5611204;0;1;-1
272141;202101;352590;I;5611201;2;1;1
272391;202101;352590;S;9609208;0;2;-2
272633;202101;352590;C;1733800;2;7;-5
272886;202101;352590;P;8520100;0;2;-2
273016;202101;352590;G;4530703;1;1;0
273209;202101;352590;S;9601701;0;1;-1
274444;202101;352590;I;5611201;0;1;-1
274622;202101;352590;F;4330404;2;1;1
275557;202101;352590;F;4399103;0;1;-1
275764;202101;352590;I;5611201;0;1;-1
275848;202101;352590;G;4781400;0;13;-13
275990;202101;352590;C;1066000;0;5;-5
276494;202101;352590;G;4781400;3;18;-15
276495;202101;352590;G;4781400;0;7;-7
276568;202101;352590;H;4930202;80;21;59
276599;202101;352590;S;9521500;1;0;1
276724;202101;352590;H;4923002;1;1;0
277089;202101;352590;Q;8650004;1;0;1
277191;202101;352590;G;4712100;1;0;1
277260;202101;352590;C;3250705;4;1;3
277300;202101;352590;G;4772500;1;1;0
277320;202101;352590;P;8541400;0;1;-1
277932;202101;352590;M;7490199;1;1;0
277961;202101;352590;E;3821100;12;6;6
277963;202101;352590;I;5611201;2;0;2
278014;202101;352590;K;6462000;3;0;3
278074;202101;352590;N;8111700;38;20;18
278244;202101;352590;G;4757100;0;1;-1
278671;202101;352590;G;4789002;1;1;0
278935;202101;352590;G;4744005;0;1;-1
279454;202101;352590;F;4120400;3;3;0
280165;202101;352590;I;5510801;1;1;0
280521;202101;352590;I;5611201;6;0;6
280522;202101;352590;I;5611201;5;0;5
280643;202101;352590;C;3314707;1;0;1
280952;202101;352590;G;4712100;1;0;1
280967;202101;352590;G;4781400;0;1;-1
281688;202101;352590;G;4744099;1;0;1
282138;202101;352590;N;8111700;2;3;-1
283164;202101;352590;J;6190601;2;0;2
283169;202101;352590;N;8121400;4;3;1
283175;202101;352590;G;4520005;0;1;-1
283314;202101;352590;P;8513900;3;1;2
283766;202101;352590;G;4782201;0;2;-2
284088;202101;352590;L;6821801;0;1;-1
284263;202101;352590;G;4771701;2;0;2
284276;202101;352590;F;4322302;0;1;-1
285080;202101;352590;M;7420001;1;0;1
285119;202101;352590;P;8541400;1;1;0
285120;202101;352590;L;6821801;1;0;1
285561;202101;352590;R;9329804;1;0;1
285892;202101;352590;F;4120400;1;0;1
287696;202101;352590;S;9602502;1;0;1
287943;202101;352590;P;8511200;0;1;-1
288523;202101;352590;G;4772500;0;2;-2
288525;202101;352590;H;4930202;4;6;-2
290021;202101;352590;Q;8650004;1;0;1
290024;202101;352590;S;9420100;1;0;1
290679;202101;352590;G;4772500;1;1;0
290680;202101;352590;G;4772500;0;1;-1
290683;202101;352590;G;4772500;0;1;-1
291064;202101;352590;S;9511800;0;2;-2
291440;202101;352590;F;4321500;1;0;1
291509;202101;352590;Q;8711501;1;1;0
291560;202101;352590;G;4530701;1;1;0
291766;202101;352590;N;8111700;1;1;0
292592;202101;352590;G;4691500;4;9;-5
293905;202101;352590;N;8211300;0;1;-1
293947;202101;352590;G;4637199;3;0;3
294224;202101;352590;M;7311400;0;3;-3
294323;202101;352590;I;5611203;0;1;-1
294328;202101;352590;I;5611203;0;2;-2
294732;202101;352590;I;5611203;2;3;-1
294921;202101;352590;C;1091102;1;0;1
295218;202101;352590;G;4687702;0;1;-1
295416;202101;352590;G;4663000;1;0;1
295744;202101;352590;H;4930202;4;6;-2
295859;202101;352590;F;4330403;1;1;0
295861;202101;352590;F;4330499;1;1;0
296711;202101;352590;G;4763601;1;0;1
298371;202101;352590;I;5611201;1;1;0
298639;202101;352590;G;4619200;0;1;-1
299024;202101;352590;Q;8630502;5;1;4
299260;202101;352590;G;4761003;2;0;2
299707;202101;352590;G;4689399;5;2;3
299839;202101;352590;P;8511200;0;1;-1
299977;202101;352590;H;4930201;2;1;1
300515;202101;352590;F;4399101;1;1;0
300656;202101;352590;G;4669999;4;4;0
300768;202101;352590;Q;8630503;0;1;-1
300774;202101;352590;N;7990200;0;2;-2
301615;202101;352590;H;4930201;0;1;-1
301696;202101;352590;G;4781400;0;2;-2
301723;202101;352590;C;3321000;0;1;-1
301976;202101;352590;C;3314713;1;0;1
302434;202101;352590;I;5611203;2;0;2
304494;202101;352590;G;4722901;0;1;-1
305007;202101;352590;C;1093701;0;1;-1
305134;202101;352590;G;4781400;0;1;-1
305354;202101;352590;J;6110803;1;2;-1
306303;202101;352590;G;4686902;0;1;-1
306318;202101;352590;G;4772500;0;4;-4
307157;202101;352590;E;3702900;1;0;1
307188;202101;352590;C;2229399;0;1;-1
307305;202101;352590;M;7020400;1;1;0
307426;202101;352590;G;4784900;1;0;1
307528;202101;352590;K;6619399;1;0;1
307529;202101;352590;K;6622300;3;3;0
307688;202101;352590;G;4731800;1;1;0
307801;202101;352590;G;4763603;1;0;1
307802;202101;352590;G;4763603;0;1;-1
307941;202101;352590;G;4646001;1;1;0
308133;202101;352590;N;8230001;0;1;-1
308267;202101;352590;P;8512100;8;1;7
308470;202101;352590;F;4321500;1;0;1
308888;202101;352590;C;2731700;2;2;0
308941;202101;352590;J;6190601;1;1;0
309422;202101;352590;G;4789099;2;2;0
309427;202101;352590;Q;8640205;1;1;0
309428;202101;352590;Q;8640205;0;1;-1
310190;202101;352590;H;5211701;24;30;-6
310844;202101;352590;G;4744001;0;1;-1
311462;202101;352590;G;4530704;5;2;3
311773;202101;352590;G;4789099;1;0;1
311951;202101;352590;C;3299099;2;0;2
312068;202101;352590;C;2399101;3;0;3
312342;202101;352590;G;4771701;0;1;-1
312779;202101;352590;M;7119704;1;1;0
313248;202101;352590;C;3314702;49;7;42
313253;202101;352590;G;4744001;0;2;-2
313404;202101;352590;I;5611203;0;1;-1
313473;202101;352590;G;4754701;7;35;-28
313609;202101;352590;C;1094500;0;1;-1
313707;202101;352590;P;8593700;1;0;1
313788;202101;352590;H;4930201;0;1;-1
314088;202101;352590;C;1091102;0;1;-1
314241;202101;352590;G;4744099;1;0;1
314242;202101;352590;N;8299799;1;0;1
314253;202101;352590;G;4511101;0;1;-1
314254;202101;352590;C;1091101;6;5;1
314257;202101;352590;C;2599399;2;1;1
314416;202101;352590;C;3314708;1;7;-6
315544;202101;352590;N;8211300;1;1;0
315731;202101;352590;H;4930202;0;4;-4
316114;202101;352590;C;3313999;1;0;1
316499;202101;352590;G;4759899;0;5;-5
317223;202101;352590;F;4399103;3;4;-1
319581;202101;352590;F;4399199;0;1;-1
319748;202101;352590;F;4330402;2;0;2
320205;202101;352590;G;4530703;5;0;5
320325;202101;352590;G;4761001;2;0;2
321380;202101;352590;G;4724500;1;1;0
321627;202101;352590;G;4623109;2;1;1
321636;202101;352590;R;9313100;0;2;-2
321977;202101;352590;G;4763601;2;0;2
322035;202101;352590;F;4322303;2;1;1
322633;202101;352590;I;5620104;1;0;1
322870;202101;352590;C;2522500;1;2;-1
323725;202101;352590;G;4772500;1;0;1
323974;202101;352590;E;3702900;1;0;1
324657;202101;352590;N;7911200;1;1;0
325135;202101;352590;N;7739099;1;1;0
325762;202101;352590;N;7810800;1;8;-7
325771;202101;352590;G;4721104;18;3;15
325772;202101;352590;G;4637107;36;1;35
325801;202101;352590;H;4930202;1;0;1
325858;202101;352590;C;3101200;8;2;6
325859;202101;352590;G;4754701;1;1;0
325860;202101;352590;G;4754701;1;0;1
326015;202101;352590;J;6209100;2;0;2
326087;202101;352590;S;9609208;0;1;-1
326102;202101;352590;I;5611201;0;1;-1
326333;202101;352590;I;5611203;0;1;-1
326455;202101;352590;G;4752100;1;0;1
326921;202101;352590;J;6190699;1;7;-6
326947;202101;352590;I;5611201;1;0;1
327165;202101;352590;Q;8800600;1;0;1
327167;202101;352590;P;8511200;0;1;-1
327359;202101;352590;C;1053800;6;1;5
327741;202101;352590;Q;8712300;2;0;2
328099;202101;352590;F;4120400;0;6;-6
328586;202101;352590;G;4757100;2;0;2
328688;202101;352590;N;8121400;0;16;-16
328715;202101;352590;N;7732201;0;1;-1
328925;202101;352590;H;4930201;1;0;1
329080;202101;352590;G;4782201;1;2;-1
329285;202101;352590;I;5620104;1;0;1
329487;202101;352590;I;5611201;1;0;1
330449;202101;352590;G;4781400;0;1;-1
330595;202101;352590;H;4930202;0;2;-2
330954;202101;352590;G;4772500;2;0;2
331693;202101;352590;C;3314708;0;1;-1
331983;202101;352590;C;2229303;1;0;1
332469;202101;352590;H;5212500;0;2;-2
332773;202101;352590;I;5611203;0;1;-1
332951;202101;352590;G;4781400;2;0;2
333240;202101;352590;M;7112000;1;5;-4
333709;202101;352590;C;2823200;1;0;1
333835;202101;352590;Q;8630503;1;3;-2
333987;202101;352590;C;3101200;3;1;2
334485;202101;352590;J;6209100;0;1;-1
334534;202101;352590;S;9521500;0;3;-3
334602;202101;352590;G;4712100;1;0;1
335108;202101;352590;M;7311400;1;0;1
335830;202101;352590;H;4930202;1;0;1
335900;202101;352590;G;4782201;3;8;-5
336452;202101;352590;R;9313100;0;1;-1
336551;202101;352590;G;4782201;0;1;-1
336831;202101;352590;I;5611203;0;1;-1
336888;202101;352590;S;9601701;2;1;1
336925;202101;352590;N;8111700;4;2;2
337113;202101;352590;H;4930202;2;26;-24
337126;202101;352590;F;4321500;2;2;0
337291;202101;352590;H;5211701;1;0;1
337625;202101;352590;P;8511200;2;1;1
337933;202101;352590;G;4755502;1;1;0
338233;202101;352590;Q;8650004;0;1;-1
338416;202101;352590;P;8512100;0;3;-3
338727;202101;352590;P;8511200;0;2;-2
339023;202101;352590;G;4712100;1;0;1
339760;202101;352590;P;8511200;2;0;2
339982;202101;352590;N;8219999;0;1;-1
340000;202101;352590;P;8512100;0;2;-2
340336;202101;352590;G;4771701;0;1;-1
340561;202101;352590;I;5611203;2;1;1
341445;202101;352590;S;9603301;0;1;-1
341623;202101;352590;H;4930202;1;0;1
342798;202101;352590;M;6920601;1;1;0
343466;202101;352590;I;5611201;0;1;-1
344198;202101;352590;C;3314702;0;1;-1
345571;202101;352590;H;4930202;1;2;-1
346934;202101;352590;N;8121400;1;0;1
347998;202101;352590;G;4751201;3;0;3
348223;202101;352590;H;5250803;1;0;1
348529;202101;352590;G;4520005;13;8;5
348885;202101;352590;M;7120100;1;2;-1
349019;202101;352590;G;4781400;0;1;-1
349233;202101;352590;N;8219999;3;2;1
349356;202101;352590;G;4721104;8;1;7
349811;202101;352590;N;7911200;1;0;1
350478;202101;352590;F;4120400;2;5;-3
351178;202101;352590;G;4663000;8;4;4
351276;202101;352590;M;7112000;1;0;1
351837;202101;352590;F;4120400;2;0;2
352326;202101;352590;G;4541201;0;1;-1
352557;202101;352590;G;4752100;0;1;-1
353248;202101;352590;N;8211300;1;0;1
353385;202101;352590;F;4120400;0;1;-1
353453;202101;352590;C;3250701;1;1;0
355120;202101;352590;G;4741500;1;1;0
355166;202101;352590;G;4771702;0;1;-1
355243;202101;352590;N;8299799;1;3;-2
355879;202101;352590;F;4222701;1;1;0
356500;202101;352590;N;7810800;1;0;1
357090;202101;352590;N;8219999;2;0;2
357251;202101;352590;G;4789004;1;0;1
358186;202101;352590;G;4752100;1;0;1
358496;202101;352590;G;4782201;0;1;-1
358570;202101;352590;S;9602501;1;1;0
358589;202101;352590;F;4120400;0;3;-3
358851;202101;352590;H;4930201;0;2;-2
358853;202101;352590;H;4930201;3;9;-6
358869;202101;352590;H;4930202;0;3;-3
359085;202101;352590;G;4781400;0;1;-1
359419;202101;352590;S;9602501;3;2;1
359427;202101;352590;M;7500100;0;1;-1
359775;202101;352590;G;4634601;0;2;-2
360331;202101;352590;G;4789004;1;1;0
360471;202101;352590;M;7319003;3;2;1
360539;202101;352590;F;4399199;0;1;-1
360765;202101;352590;Q;8711502;1;0;1
360792;202101;352590;G;4781400;1;1;0
361355;202101;352590;G;4687702;0;1;-1
362336;202101;352590;C;1091102;1;1;0
362892;202101;352590;G;4744001;1;0;1
363315;202101;352590;G;4732600;1;2;-1
363873;202101;352590;G;4713002;0;1;-1
364249;202101;352590;G;4751201;0;2;-2
364634;202101;352590;C;2033900;1;1;0
364667;202101;352590;G;4789004;1;1;0
364698;202101;352590;C;2823200;0;1;-1
364796;202101;352590;N;8011101;0;2;-2
365055;202101;352590;G;4781400;0;1;-1
365349;202101;352590;I;5611201;0;2;-2
365563;202101;352590;N;8211300;0;1;-1
365686;202101;352590;G;4774100;1;0;1
365835;202101;352590;L;6822600;0;1;-1
366876;202101;352590;P;8593700;0;11;-11
366888;202101;352590;G;4783101;1;0;1
367602;202101;352590;G;4757100;2;0;2
367752;202101;352590;N;8111700;2;1;1
368164;202101;352590;N;7912100;0;1;-1
368341;202101;352590;N;7911200;0;1;-1
369136;202101;352590;G;4724500;0;2;-2
369304;202101;352590;G;4772500;1;0;1
369305;202101;352590;G;4772500;2;1;1
370760;202101;352590;L;6821801;0;1;-1
371238;202101;352590;N;8219999;0;1;-1
371678;202101;352590;P;8599605;0;1;-1
372309;202101;352590;I;5611203;0;2;-2
374570;202101;352590;G;4752100;1;0;1
374571;202101;352590;G;4754701;1;0;1
375409;202101;352590;C;2222600;0;1;-1
375948;202101;352590;G;4721102;1;0;1
376264;202101;352590;M;7119701;2;0;2
376564;202101;352590;G;4530703;1;0;1
376676;202101;352590;M;6911701;0;1;-1
377364;202101;352590;I;5620104;1;0;1
377787;202101;352590;J;6209100;2;0;2
377791;202101;352590;I;5611201;1;0;1
377823;202101;352590;G;4520001;0;3;-3
378371;202101;352590;C;2532201;0;1;-1
379157;202101;352590;P;8512100;0;1;-1
379176;202101;352590;N;8220200;129;135;-6
380127;202101;352590;M;6920601;2;1;1
380456;202101;352590;M;6920601;3;1;2
380842;202101;352590;G;4753900;0;3;-3
381265;202101;352590;J;6202300;3;0;3
381500;202101;352590;P;8593700;0;1;-1
382108;202101;352590;H;4930202;1;0;1
382213;202101;352590;M;6920601;1;0;1
382396;202101;352590;G;4520002;0;1;-1
382447;202101;352590;S;9430800;0;1;-1
382656;202101;352590;G;4789001;0;1;-1
383231;202101;352590;S;9602502;1;1;0
384030;202101;352590;I;5611201;0;1;-1
384794;202101;352590;J;6204000;2;0;2
385225;202101;352590;C;2610800;4;0;4
385308;202101;352590;M;7119703;2;1;1
385687;202101;352590;F;4330402;2;0;2
385821;202101;352590;P;8599604;1;1;0
386095;202101;352590;I;5611203;1;0;1
386609;202101;352590;S;9602502;2;0;2
386779;202101;352590;G;4761001;0;2;-2
386985;202101;352590;I;5620104;0;1;-1
387466;202101;352590;I;5611201;0;1;-1
387821;202101;352590;J;6201501;2;1;1
388208;202101;352590;P;8593700;2;0;2
388391;202101;352590;I;5611201;0;1;-1
388490;202101;352590;G;4520002;1;0;1
388563;202101;352590;N;8130300;7;3;4
388677;202101;352590;G;4652400;2;1;1
388819;202101;352590;G;4744002;2;0;2
388906;202101;352590;F;4321500;3;5;-2
389012;202101;352590;F;4120400;73;31;42
389459;202101;352590;S;9602502;0;1;-1
390857;202101;352590;F;4330405;1;9;-8
392121;202101;352590;N;8122200;1;1;0
392123;202101;352590;G;4530705;1;1;0
392127;202101;352590;H;4930201;2;0;2
392230;202101;352590;G;4721102;2;1;1
392329;202101;352590;F;4120400;4;3;1
392389;202101;352590;G;4721102;0;1;-1
392980;202101;352590;M;7119701;1;0;1
393159;202101;352590;G;4721102;0;1;-1
393345;202101;352590;Q;8630503;0;1;-1
393540;202101;352590;C;3321000;0;1;-1
393847;202101;352590;I;5611203;0;1;-1
394088;202101;352590;G;4789002;1;2;-1
394782;202101;352590;G;4781400;1;2;-1
394994;202101;352590;M;7319003;2;0;2
395244;202101;352590;G;4744099;1;0;1
395770;202101;352590;J;6201501;20;0;20
396067;202101;352590;H;4930202;8;4;4
396141;202101;352590;C;1412602;1;0;1
396242;202101;352590;Q;8712300;2;3;-1
396700;202101;352590;Q;8630504;1;0;1
396725;202101;352590;N;7740300;1;0;1
397061;202101;352590;H;5223100;1;0;1
397191;202101;352590;I;5611201;1;2;-1
398116;202101;352590;G;4755502;0;1;-1
398347;202101;352590;I;5611203;0;1;-1
399072;202101;352590;H;4930201;1;1;0
399159;202101;352590;P;8550302;0;9;-9
400201;202101;352590;G;4721102;1;0;1
400500;202101;352590;N;8111700;0;5;-5
400544;202101;352590;H;4930201;5;0;5
400833;202101;352590;G;4752100;0;1;-1
400855;202101;352590;S;9602502;0;3;-3
401036;202101;352590;M;7112000;1;1;0
401229;202101;352590;L;6821801;1;0;1
402982;202101;352590;M;7312200;2;0;2
403153;202101;352590;G;4781400;0;8;-8
403611;202101;352590;G;4712100;0;1;-1
404076;202101;352590;I;5611203;1;3;-2
404104;202101;352590;G;4781400;1;2;-1
404173;202101;352590;G;4781400;0;1;-1
404272;202101;352590;N;8111700;0;1;-1
404496;202101;352590;I;5611201;1;1;0
404590;202101;352590;G;4731800;6;2;4
405161;202101;352590;H;4930202;5;0;5
405641;202101;352590;C;2949299;8;5;3
407042;202101;352590;R;9321200;0;1;-1
407481;202101;352590;N;8111700;1;0;1
407503;202101;352590;G;4772500;0;1;-1
407802;202101;352590;G;4669999;2;3;-1
407813;202101;352590;M;6920601;4;1;3
408073;202101;352590;G;4712100;0;1;-1
409889;202101;352590;G;4754701;0;2;-2
409987;202101;352590;J;6209100;1;0;1
410036;202101;352590;N;8220200;0;1;-1
410129;202101;352590;P;8599604;4;0;4
411281;202101;352590;G;4712100;0;1;-1
411342;202101;352590;S;9602502;0;1;-1
411431;202101;352590;M;6920601;1;0;1
411835;202101;352590;G;4771701;1;1;0
412946;202101;352590;I;5611201;0;1;-1
412953;202101;352590;G;4721102;1;0;1
413200;202101;352590;M;7020400;1;0;1
413560;202101;352590;H;4930202;7;22;-15
414750;202101;352590;N;8121400;2;2;0
414785;202101;352590;S;9512600;1;2;-1
415381;202101;352590;N;8130300;3;0;3
415494;202101;352590;F;4399199;3;3;0
415668;202101;352590;M;6920601;1;1;0
416798;202101;352590;H;4930202;1;0;1
416890;202101;352590;G;4781400;1;0;1
417437;202101;352590;P;8511200;0;1;-1
417497;202101;352590;M;6920601;1;0;1
418296;202101;352590;G;4530703;1;1;0
418502;202101;352590;G;4752100;0;1;-1
418662;202101;352590;I;5611203;0;1;-1
418709;202101;352590;G;4789002;0;1;-1
419168;202101;352590;N;8219999;0;1;-1
419231;202101;352590;G;4754701;0;1;-1
419328;202101;352590;G;4645101;0;2;-2
420063;202101;352590;Q;8630503;0;1;-1
420559;202101;352590;G;4741500;1;0;1
421687;202101;352590;N;8112500;4;0;4
421715;202101;352590;G;4781400;1;0;1
421993;202101;352590;N;8121400;5;3;2
422754;202101;352590;I;5611201;0;2;-2
423219;202101;352590;M;6920601;0;1;-1
423927;202101;352590;I;5611203;0;1;-1
424258;202101;352590;H;5212500;1;5;-4
424391;202101;352590;G;4731800;0;1;-1
424477;202101;352590;C;1412601;2;3;-1
424673;202101;352590;G;4713004;3;16;-13
424879;202101;352590;P;8599603;1;0;1
425384;202101;352590;N;8219999;1;1;0
425495;202101;352590;C;2950600;3;0;3
425575;202101;352590;G;4520001;2;5;-3
425747;202101;352590;M;7119701;0;1;-1
425784;202101;352590;G;4774100;0;1;-1
425816;202101;352590;L;6822600;2;0;2
426074;202101;352590;G;4520001;0;1;-1
426099;202101;352590;F;4330403;2;2;0
427289;202101;352590;C;1042200;0;4;-4
427339;202101;352590;C;3314719;2;0;2
427834;202101;352590;A;139399;0;1;-1
427962;202101;352590;R;9313100;1;2;-1
428099;202101;352590;G;4649499;0;2;-2
428173;202101;352590;G;4713002;1;0;1
428343;202101;352590;P;8599604;0;1;-1
428429;202101;352590;M;7020400;2;0;2
428483;202101;352590;P;8599603;3;0;3
428624;202101;352590;M;7490104;1;0;1
428625;202101;352590;M;7490104;1;0;1
428743;202101;352590;N;8211300;0;1;-1
428745;202101;352590;L;6821801;1;0;1
428831;202101;352590;M;7120100;1;0;1
429033;202101;352590;G;4754701;0;1;-1
429044;202101;352590;Q;8630504;1;0;1
429174;202101;352590;G;4729699;2;5;-3
429317;202101;352590;G;4520001;1;0;1
429983;202101;352590;I;5611201;2;1;1
430241;202101;352590;G;4781400;0;1;-1
430337;202101;352590;S;9602502;1;0;1
430396;202101;352590;Q;8630502;1;0;1
430490;202101;352590;N;8111700;4;2;2
430920;202101;352590;C;3313901;1;0;1
431268;202101;352590;F;4291000;1;1;0
431649;202101;352590;H;5250804;1;0;1
431726;202101;352590;Q;8630503;0;1;-1
431771;202101;352590;G;4679699;0;1;-1
432276;202101;352590;C;3321000;1;0;1
432619;202101;352590;F;4120400;0;1;-1
432779;202101;352590;N;8112500;0;1;-1
432781;202101;352590;S;9499500;0;1;-1
432926;202101;352590;I;5620101;26;15;11
432928;202101;352590;I;5620101;10;9;1
432929;202101;352590;I;5620101;2;2;0
432933;202101;352590;I;5620101;7;4;3
434342;202101;352590;G;4633801;1;0;1
434677;202101;352590;I;5611203;1;0;1
435273;202101;352590;J;6209100;2;0;2
435342;202101;352590;G;4646001;0;2;-2
435574;202101;352590;H;5211701;2;5;-3
435717;202101;352590;N;8112500;0;1;-1
436718;202101;352590;M;7112000;1;0;1
436774;202101;352590;H;4930202;0;1;-1
437155;202101;352590;N;8220200;157;186;-29
437270;202101;352590;G;4782201;1;1;0
437495;202101;352590;G;4781400;0;1;-1
437496;202101;352590;G;4781400;0;1;-1
437725;202101;352590;J;6209100;4;2;2
438533;202101;352590;F;4313400;1;1;0
439472;202101;352590;M;6911701;0;1;-1
440119;202101;352590;G;4751201;0;1;-1
440758;202101;352590;I;5611203;1;0;1
441263;202101;352590;H;4930201;77;10;67
441286;202101;352590;Q;8630502;0;1;-1
441311;202101;352590;L;6822600;2;1;1
441371;202101;352590;F;4221904;4;16;-12
441430;202101;352590;I;5611201;0;1;-1
441542;202101;352590;P;8513900;6;2;4
441804;202101;352590;C;2330305;2;1;1
442583;202101;352590;G;4729602;0;2;-2
443414;202101;352590;G;4679603;1;2;-1
443749;202101;352590;N;8299799;20;12;8
443838;202101;352590;N;8111700;1;4;-3
444247;202101;352590;H;4930202;5;4;1
444530;202101;352590;G;4530703;1;3;-2
445626;202101;352590;G;4711302;4;0;4
446492;202101;352590;P;8599604;11;7;4
446655;202101;352590;K;6622300;1;1;0
446777;202101;352590;G;4751201;1;0;1
447678;202101;352590;G;4639701;8;12;-4
447868;202101;352590;G;4520007;1;1;0
448166;202101;352590;N;8111700;6;2;4
448541;202101;352590;F;4330499;0;2;-2
448838;202101;352590;C;1095300;10;7;3
450024;202101;352590;G;4753900;4;8;-4
451233;202101;352590;N;8211300;1;0;1
451766;202101;352590;G;4759899;4;1;3
452518;202101;352590;N;8219999;0;1;-1
453060;202101;352590;C;2943300;1;0;1
453379;202101;352590;J;6209100;0;2;-2
453452;202101;352590;C;2941700;2;0;2
453804;202101;352590;M;7112000;1;1;0
453961;202101;352590;I;5611201;3;2;1
453969;202101;352590;N;8211300;2;0;2
454342;202101;352590;Q;8630502;2;1;1
454401;202101;352590;G;4754701;1;0;1
454450;202101;352590;F;4312600;2;0;2
454661;202101;352590;Q;8640203;1;1;0
454819;202101;352590;I;5611201;1;1;0
454892;202101;352590;I;5611203;0;1;-1
454895;202101;352590;I;5611203;6;1;5
454896;202101;352590;I;5611203;0;1;-1
454897;202101;352590;I;5611203;1;1;0
454899;202101;352590;I;5611203;0;1;-1
455740;202101;352590;G;4781400;1;0;1
456341;202101;352590;N;8219999;1;0;1
456569;202101;352590;G;4723700;0;1;-1
456640;202101;352590;C;3314707;0;5;-5
456836;202101;352590;G;4712100;0;1;-1
457300;202101;352590;Q;8630503;2;0;2
458714;202101;352590;J;6319400;1;0;1
459144;202101;352590;G;4782201;2;2;0
459155;202101;352590;Q;8711502;1;2;-1
459303;202101;352590;G;4530703;1;0;1
459919;202101;352590;G;4723700;0;1;-1
460604;202101;352590;G;4789099;1;0;1
461253;202101;352590;N;8211300;2;0;2
461759;202101;352590;G;4722901;1;0;1
461980;202101;352590;K;6462000;1;1;0
462241;202101;352590;N;8112500;1;0;1
462290;202101;352590;C;2943300;2;0;2
462798;202101;352590;R;9313100;0;2;-2
463631;202101;352590;F;4330404;0;1;-1
463873;202101;352590;N;8299799;1;0;1
464790;202101;352590;G;4781400;1;4;-3
465655;202101;352590;P;8593700;0;1;-1
466992;202101;352590;S;9601701;1;0;1
467763;202101;352590;H;5250804;0;4;-4
468833;202101;352590;C;2542000;0;1;-1
469007;202101;352590;C;2651500;0;1;-1
469083;202101;352590;G;4724500;1;0;1
469376;202101;352590;G;4781400;0;1;-1
470067;202101;352590;M;6911701;1;0;1
470504;202101;352590;F;4120400;0;2;-2
470553;202101;352590;G;4646001;1;1;0
470703;202101;352590;H;4930202;1;1;0
470709;202101;352590;F;4313400;1;0;1
470974;202101;352590;G;4724500;0;1;-1
471015;202101;352590;G;4759899;0;1;-1
471726;202101;352590;C;1069400;4;3;1
472062;202101;352590;G;4541205;1;0;1
472312;202101;352590;I;5611201;0;1;-1
473329;202101;352590;I;5611201;0;1;-1
473376;202101;352590;F;4321500;1;4;-3
473386;202101;352590;G;4789099;0;1;-1
473475;202101;352590;G;4774100;0;1;-1
473534;202101;352590;G;4761001;5;0;5
474160;202101;352590;G;4729699;0;1;-1
474348;202101;352590;M;7020400;0;1;-1
474622;202101;352590;H;5250804;5;8;-3
474913;202101;352590;G;4774100;1;0;1
474915;202101;352590;G;4774100;3;2;1
475074;202101;352590;N;7740300;2;0;2
475184;202101;352590;G;4721102;0;1;-1
475466;202101;352590;N;8111700;1;0;1
475665;202101;352590;N;8011101;0;1;-1
475701;202101;352590;I;5611201;1;4;-3
475707;202101;352590;H;5223100;3;1;2
475807;202101;352590;G;4759899;0;1;-1
476108;202101;352590;G;4724500;1;1;0
476391;202101;352590;G;4729602;5;0;5
476404;202101;352590;G;4712100;2;0;2
476498;202101;352590;F;4221902;2;1;1
476569;202101;352590;G;4729699;0;1;-1
476836;202101;352590;G;4713002;1;1;0
477137;202101;352590;S;9511800;1;1;0
477364;202101;352590;G;4781400;1;1;0
477606;202101;352590;N;8299799;0;1;-1
478215;202101;352590;F;4292802;18;11;7
478443;202101;352590;I;5611203;5;3;2
478521;202101;352590;G;4520006;3;0;3
478704;202101;352590;N;8111700;0;1;-1
478992;202101;352590;G;4721102;1;2;-1
479828;202101;352590;F;4322302;3;0;3
480510;202101;352590;M;7319003;6;0;6
481128;202101;352590;F;4330404;0;1;-1
481227;202101;352590;I;5611201;1;0;1
481376;202101;352590;G;4686902;5;0;5
481676;202101;352590;C;3314713;6;2;4
481796;202101;352590;I;5611201;2;0;2
481820;202101;352590;J;6319400;2;0;2
482804;202101;352590;I;5611203;1;1;0
482806;202101;352590;G;4771701;3;1;2
482807;202101;352590;G;4771701;0;1;-1
483009;202101;352590;G;4781400;0;1;-1
483327;202101;352590;F;4322301;1;0;1
483505;202101;352590;F;4330403;3;0;3
483511;202101;352590;F;4292801;4;2;2
483933;202101;352590;H;4930202;1;0;1
484324;202101;352590;G;4729699;0;1;-1
484630;202101;352590;I;5611201;2;1;1
484673;202101;352590;Q;8630503;1;0;1
484797;202101;352590;J;6204000;0;1;-1
485159;202101;352590;I;5611201;0;2;-2
485176;202101;352590;M;7020400;1;0;1
485716;202101;352590;R;9321200;0;2;-2
485962;202101;352590;N;8299799;1;0;1
486181;202101;352590;C;3101200;0;1;-1
486908;202101;352590;H;4930202;1;2;-1
487134;202101;352590;K;6462000;2;0;2
487266;202101;352590;G;4789004;1;0;1
487684;202101;352590;G;4782201;0;1;-1
487785;202101;352590;Q;8630504;1;0;1
488326;202101;352590;M;7490104;0;1;-1
488478;202101;352590;C;2512800;1;0;1
488762;202101;352590;I;5611203;1;1;0
488826;202101;352590;G;4782201;0;1;-1
489314;202101;352590;M;7112000;1;0;1
489679;202101;352590;R;9313100;1;0;1
490176;202101;352590;F;4120400;0;1;-1
490238;202101;352590;G;4789099;1;0;1
490662;202101;352590;F;4330404;4;4;0
491028;202101;352590;G;4722901;1;0;1
491255;202101;352590;C;2511000;4;0;4
491618;202101;352590;G;4687702;5;5;0
491668;202101;352590;G;4772500;2;0;2
491704;202101;352590;G;4713004;0;6;-6
491706;202101;352590;G;4693100;1;1;0
492066;202101;352590;H;5212500;0;1;-1
492121;202101;352590;I;5611201;1;1;0
492289;202101;352590;G;4520003;0;1;-1
492321;202101;352590;N;8299799;0;2;-2
493147;202101;352590;C;2740602;3;0;3
493612;202101;352590;Q;8640202;2;1;1
493621;202101;352590;G;4711302;0;1;-1
493902;202101;352590;H;5229002;1;0;1
494037;202101;352590;N;7820500;14;4;10
494733;202101;352590;I;5611201;1;1;0
495045;202101;352590;G;4771704;1;0;1
495666;202101;352590;F;4120400;0;1;-1
495800;202101;352590;I;5611203;0;1;-1
496205;202101;352590;M;6920601;1;0;1
496405;202101;352590;C;3314713;1;0;1
496543;202101;352590;G;4781400;1;1;0
496842;202101;352590;I;5611201;0;1;-1
498643;202101;352590;N;7739099;2;0;2
499073;202101;352590;C;2229302;0;1;-1
499298;202101;352590;P;8593700;0;1;-1
499669;202101;352590;M;7112000;0;1;-1
499864;202101;352590;I;5611201;0;1;-1
499955;202101;352590;G;4633801;2;1;1
500480;202101;352590;N;8121400;3;0;3
502686;202101;352590;H;4930201;1;0;1
502777;202101;352590;Q;8640202;0;3;-3
502850;202101;352590;Q;8630504;2;3;-1
503015;202101;352590;I;5620104;0;1;-1
503142;202101;352590;G;4729699;2;0;2
504068;202101;352590;Q;8711502;5;0;5
505063;202101;352590;G;4789099;2;2;0
505514;202101;352590;N;8111700;3;4;-1
505791;202101;352590;H;5223100;0;1;-1
506995;202101;352590;I;5620101;1;0;1
506999;202101;352590;I;5620101;0;2;-2
507135;202101;352590;F;4120400;7;5;2
507820;202101;352590;N;8129000;0;1;-1
507955;202101;352590;G;4729602;0;2;-2
507979;202101;352590;N;8112500;1;0;1
508536;202101;352590;P;8512100;0;4;-4
508573;202101;352590;G;4772500;0;1;-1
508593;202101;352590;G;4520002;0;1;-1
508715;202101;352590;H;4930202;0;2;-2
508757;202101;352590;H;5212500;2;7;-5
509097;202101;352590;C;1053800;2;0;2
509297;202101;352590;G;4752100;1;2;-1
509372;202101;352590;I;5611201;0;1;-1
510370;202101;352590;I;5611203;0;1;-1
510791;202101;352590;G;4530705;0;2;-2
510792;202101;352590;G;4530705;0;1;-1
510793;202101;352590;I;5620101;1;1;0
511196;202101;352590;R;9313100;1;0;1
511518;202101;352590;M;7112000;2;30;-28
511565;202101;352590;I;5611203;0;1;-1
512067;202101;352590;M;7112000;1;0;1
512395;202101;352590;S;9603304;0;1;-1
512528;202101;352590;P;8599605;0;3;-3
512603;202101;352590;G;4744002;0;1;-1
512701;202101;352590;N;8211300;1;0;1
513486;202101;352590;N;8111700;1;0;1
513599;202101;352590;G;4782201;0;1;-1
514071;202101;352590;I;5611201;1;0;1
514081;202101;352590;C;1096100;1;0;1
514392;202101;352590;G;4772500;6;2;4
514473;202101;352590;I;5611203;2;1;1
514711;202101;352590;S;9602502;1;0;1
514712;202101;352590;I;5611203;0;1;-1
515541;202101;352590;I;5611203;1;1;0
516293;202101;352590;G;4789099;5;3;2
516811;202101;352590;F;4399199;2;0;2
517308;202101;352590;Q;8630503;1;0;1
517530;202101;352590;I;5611203;1;0;1
517633;202101;352590;G;4789004;0;1;-1
517890;202101;352590;M;7500100;0;4;-4
518641;202101;352590;N;8299799;0;1;-1
518811;202101;352590;S;9602501;0;1;-1
519302;202101;352590;K;6622300;1;0;1
520174;202101;352590;N;8291100;2;4;-2
520342;202101;352590;G;4729699;1;0;1
520798;202101;352590;G;4645101;1;0;1
521274;202101;352590;C;2521700;0;1;-1
521691;202101;352590;G;4763601;0;1;-1
521733;202101;352590;P;8512100;0;1;-1
522560;202101;352590;S;9602502;2;2;0
522591;202101;352590;G;4744099;2;0;2
522608;202101;352590;G;4511101;1;1;0
523760;202101;352590;Q;8630501;1;0;1
523846;202101;352590;N;8299799;0;1;-1
524310;202101;352590;G;4721104;0;1;-1
524311;202101;352590;C;1091102;0;3;-3
524540;202101;352590;F;4321500;2;4;-2
525150;202101;352590;I;5611201;0;1;-1
525304;202101;352590;J;6110803;2;0;2
525624;202101;352590;J;6204000;0;1;-1
525861;202101;352590;P;8512100;5;3;2
526883;202101;352590;C;1412601;0;1;-1
527085;202101;352590;S;9601703;7;10;-3
527562;202101;352590;H;4930202;1;4;-3
527823;202101;352590;C;3314799;4;6;-2
528174;202101;352590;N;7732201;4;1;3
528711;202101;352590;C;2543800;0;1;-1
529190;202101;352590;N;8111700;0;1;-1
529310;202101;352590;N;8211300;1;0;1
530385;202101;352590;G;4781400;0;4;-4
530756;202101;352590;S;9601701;1;0;1
530845;202101;352590;J;6202300;0;2;-2
531363;202101;352590;G;4781400;3;0;3
531998;202101;352590;P;8512100;5;3;2
532186;202101;352590;I;5611201;2;0;2
532312;202101;352590;M;7112000;0;2;-2
532835;202101;352590;G;4771701;1;0;1
533389;202101;352590;M;7112000;5;1;4
533628;202101;352590;G;4623109;1;0;1
533987;202101;352590;I;5611201;1;2;-1
534040;202101;352590;N;8211300;1;0;1
534240;202101;352590;I;5620101;1;0;1
534363;202101;352590;G;4781400;1;0;1
534364;202101;352590;G;4781400;0;1;-1
534395;202101;352590;G;4711301;0;7;-7
534591;202101;352590;L;6821802;0;1;-1
534807;202101;352590;F;4321500;0;1;-1
534870;202101;352590;G;4781400;0;1;-1
535356;202101;352590;I;5611201;2;1;1
535406;202101;352590;I;5611201;1;0;1
536444;202101;352590;I;5620104;1;0;1
537280;202101;352590;I;5611202;0;1;-1
537351;202101;352590;M;7119701;3;0;3
537374;202101;352590;S;9529199;0;2;-2
537494;202101;352590;M;7112000;8;0;8
538169;202101;352590;P;8599699;0;1;-1
538263;202101;352590;I;5611201;0;1;-1
538577;202101;352590;R;9313100;1;1;0
538892;202101;352590;F;4322303;0;1;-1
539118;202101;352590;Q;8640299;2;0;2
539787;202101;352590;G;4781400;0;1;-1
540026;202101;352590;G;4754701;0;1;-1
540126;202101;352590;G;4789099;2;0;2
540143;202101;352590;G;4520005;0;2;-2
540152;202101;352590;C;1099699;0;1;-1
540419;202101;352590;G;4781400;0;1;-1
541122;202101;352590;G;4781400;2;1;1
541585;202101;352590;P;8513900;0;1;-1
542284;202101;352590;G;4781400;1;0;1
542597;202101;352590;H;5320202;5;6;-1
542904;202101;352590;G;4530703;1;0;1
543096;202101;352590;K;6622300;7;0;7
543248;202101;352590;F;4321500;1;4;-3
543737;202101;352590;P;8593700;0;2;-2
544113;202101;352590;G;4782201;0;3;-3
544657;202101;352590;G;4530701;2;2;0
544777;202101;352590;J;6209100;1;0;1
545188;202101;352590;Q;8630504;1;0;1
545379;202101;352590;G;4729699;1;1;0
545398;202101;352590;F;4120400;1;0;1
545680;202101;352590;H;4930201;0;1;-1
545906;202101;352590;N;8111700;3;0;3
545953;202101;352590;P;8599604;1;0;1
546041;202101;352590;N;7810800;9;4;5
546292;202101;352590;N;8121400;12;2;10
546394;202101;352590;M;7319002;0;1;-1
546817;202101;352590;G;4774100;1;1;0
547072;202101;352590;F;4299599;3;0;3
547440;202101;352590;G;4639701;20;20;0
547580;202101;352590;G;4520001;0;1;-1
548133;202101;352590;N;7739099;13;6;7
548270;202101;352590;G;4752100;1;0;1
548533;202101;352590;G;4637199;8;0;8
549209;202101;352590;G;4761003;1;0;1
550052;202101;352590;S;9602502;0;1;-1
550743;202101;352590;P;8599604;0;2;-2
551569;202101;352590;M;7311400;2;0;2
552347;202101;352590;K;6622300;1;0;1
552724;202101;352590;G;4744005;0;1;-1
554069;202101;352590;M;7119701;1;0;1
554369;202101;352590;C;2222600;5;1;4
554451;202101;352590;M;7319002;2;0;2
555007;202101;352590;H;5229099;0;2;-2
555034;202101;352590;S;9602502;0;1;-1
555769;202101;352590;H;4930201;1;0;1
556854;202101;352590;I;5620104;1;1;0
557177;202101;352590;M;7490104;3;3;0
557310;202101;352590;N;8111700;2;2;0
557506;202101;352590;C;1413401;3;1;2
557622;202101;352590;Q;8630504;2;2;0
557629;202101;352590;P;8520100;10;0;10
558479;202101;352590;C;2093200;1;0;1
558672;202101;352590;I;5611203;1;1;0
559099;202101;352590;G;4713002;0;1;-1
559419;202101;352590;G;4789002;6;2;4
559714;202101;352590;I;5611203;1;0;1
560420;202101;352590;G;4781400;0;1;-1
561352;202101;352590;G;4742300;2;0;2
561623;202101;352590;G;4781400;14;0;14
562789;202101;352590;N;8219901;1;0;1
563133;202101;352590;P;8511200;1;0;1
563139;202101;352590;G;4712100;0;2;-2
564132;202101;352590;C;2061400;1;0;1
564179;202101;352590;G;4782201;0;1;-1
564758;202101;352590;M;7112000;1;9;-8
565594;202101;352590;G;4757100;2;0;2
566250;202101;352590;G;4773300;1;2;-1
567332;202101;352590;L;6821802;1;0;1
568211;202101;352590;H;4930202;2;2;0
568443;202101;352590;G;4774100;0;1;-1
568731;202101;352590;N;8211300;1;1;0
569120;202101;352590;I;5611201;3;1;2
569911;202101;352590;I;5611203;1;1;0
570273;202101;352590;S;9601701;1;1;0
571459;202101;352590;H;4930202;0;2;-2
571699;202101;352590;H;4930202;1;0;1
572171;202101;352590;N;8111700;2;0;2
572434;202101;352590;I;5611201;1;0;1
572503;202101;352590;J;6311900;0;1;-1
573094;202101;352590;N;8219999;2;0;2
573205;202101;352590;C;3314707;3;0;3
574663;202101;352590;M;7119701;5;0;5
574683;202101;352590;G;4520006;3;1;2
575367;202101;352590;N;8211300;2;2;0
575995;202101;352590;N;8230001;5;2;3
576085;202101;352590;G;4711302;1;0;1
576665;202101;352590;G;4711302;1;0;1
577559;202101;352590;G;4752100;0;1;-1
577735;202101;352590;G;4753900;0;2;-2
577899;202101;352590;G;4753900;17;20;-3
577900;202101;352590;G;4753900;2;2;0
577901;202101;352590;G;4753900;0;3;-3
577902;202101;352590;G;4753900;1;3;-2
578244;202101;352590;G;4753900;16;7;9
578264;202101;352590;G;4753900;0;2;-2
578826;202101;352590;G;4752100;0;1;-1
578835;202101;352590;N;7820500;30;22;8
578892;202101;352590;G;4712100;1;1;0
578893;202101;352590;G;4712100;7;2;5
578980;202101;352590;J;6201501;6;0;6
579665;202101;352590;C;1812100;0;34;-34
579783;202101;352590;G;4744099;2;0;2
580708;202101;352590;H;4930202;1;2;-1
581212;202101;352590;G;4781400;4;5;-1
581311;202101;352590;G;4781400;2;8;-6
581645;202101;352590;H;4930202;0;1;-1
582549;202101;352590;G;4752100;3;0;3
582705;202101;352590;H;4930202;1;2;-1
583206;202101;352590;C;2539001;1;0;1
583310;202101;352590;G;4781400;1;1;0
583500;202101;352590;F;4330404;9;4;5
583549;202101;352590;N;8020001;1;0;1
583660;202101;352590;I;5611201;0;2;-2
584107;202101;352590;G;4742300;2;0;2
584347;202101;352590;F;4330404;3;0;3
584453;202101;352590;G;4684299;0;1;-1
584774;202101;352590;C;2599399;2;2;0
584779;202101;352590;N;8219999;1;0;1
586998;202101;352590;C;3321000;0;1;-1
587670;202101;352590;C;2812700;1;3;-2
589702;202101;352590;G;4781400;1;0;1
589875;202101;352590;G;4637199;1;0;1
590059;202101;352590;P;8513900;7;0;7
590112;202101;352590;I;5611201;2;3;-1
590341;202101;352590;I;5611203;1;2;-1
590874;202101;352590;F;4110700;6;4;2
592371;202101;352590;P;8512100;1;0;1
593342;202101;352590;G;4724500;2;0;2
593351;202101;352590;M;7119701;2;0;2
593503;202101;352590;Q;8630504;3;0;3
593729;202101;352590;Q;8711502;1;1;0
594205;202101;352590;G;4752100;0;1;-1
594676;202101;352590;G;4520001;1;0;1
594798;202101;352590;G;4782201;0;1;-1
595876;202101;352590;F;4329199;2;0;2
596608;202101;352590;I;5611201;0;1;-1
598503;202101;352590;P;8532500;0;1;-1
599045;202101;352590;A;161003;1;1;0
599649;202101;352590;G;4763602;2;1;1
599885;202101;352590;Q;8640202;12;3;9
600070;202101;352590;G;4754702;0;1;-1
600267;202101;352590;N;7740300;1;0;1
601234;202101;352590;G;4781400;2;0;2
601473;202101;352590;G;4789007;1;0;1
602349;202101;352590;H;5229099;6;3;3
603013;202101;352590;P;8593700;14;0;14
603685;202101;352590;N;8121400;9;0;9
604100;202101;352590;F;4222701;2;0;2
604287;202101;352590;C;1721400;3;1;2
604313;202101;352590;M;6920601;1;0;1
604382;202101;352590;G;4771701;0;1;-1
604626;202101;352590;P;8599604;5;1;4
604671;202101;352590;H;4930201;0;1;-1
604819;202101;352590;F;4120400;2;1;1
605498;202101;352590;N;8211300;1;0;1
605562;202101;352590;I;5620103;1;1;0
605904;202101;352590;G;4669999;7;3;4
605905;202101;352590;G;4669999;0;2;-2
606123;202101;352590;I;5620104;0;1;-1
606753;202101;352590;I;5611201;1;2;-1
607553;202101;352590;H;4930202;1;1;0
607616;202101;352590;I;5611203;0;1;-1
607624;202101;352590;F;4321500;2;0;2
607629;202101;352590;Q;8650003;0;1;-1
607670;202101;352590;I;5611203;1;0;1
608687;202101;352590;P;8513900;0;1;-1
609236;202101;352590;G;4619200;1;0;1
609273;202101;352590;I;5611203;0;1;-1
609849;202101;352590;I;5611201;3;2;1
610605;202101;352590;G;4771701;0;1;-1
610704;202101;352590;I;5611203;0;1;-1
611171;202101;352590;C;2542000;1;0;1
611970;202101;352590;Q;8630504;1;1;0
612350;202101;352590;I;5620101;2;1;1
612829;202101;352590;G;4774100;0;1;-1
613178;202101;352590;G;4771701;0;1;-1
613209;202101;352590;N;8230001;1;13;-12
613590;202101;352590;N;8211300;3;5;-2
613714;202101;352590;G;4530703;0;1;-1
613896;202101;352590;G;4774100;1;0;1
614223;202101;352590;G;4713002;1;0;1
614438;202101;352590;I;5611201;0;1;-1
614499;202101;352590;C;3092000;0;1;-1
614512;202101;352590;C;3314799;1;1;0
614590;202101;352590;G;4781400;1;3;-2
615891;202101;352590;I;5611201;1;1;0
616457;202101;352590;F;4321500;1;0;1
616606;202101;352590;R;9329899;1;2;-1
616828;202101;352590;G;4781400;2;1;1
617089;202101;352590;F;4120400;2;1;1
617401;202101;352590;G;4731800;1;0;1
617436;202101;352590;R;9313100;0;3;-3
618223;202101;352590;N;8211300;1;1;0
618300;202101;352590;I;5611203;1;0;1
618327;202101;352590;R;9319199;0;2;-2
618667;202101;352590;G;4781400;3;0;3
618668;202101;352590;G;4781400;3;1;2
618669;202101;352590;G;4781400;5;0;5
618953;202101;352590;G;4530701;1;0;1
619031;202101;352590;N;7810800;0;1;-1
620358;202101;352590;G;4744099;0;1;-1
620671;202101;352590;Q;8630504;1;0;1
621402;202101;352590;H;5320201;1;1;0
621559;202101;352590;I;5611201;1;0;1
622270;202101;352590;G;4754701;1;0;1
622996;202101;352590;I;5611203;1;1;0
624591;202101;352590;G;4633801;1;1;0
625572;202101;352590;N;8111700;2;0;2
626038;202101;352590;J;6203100;0;1;-1
626100;202101;352590;F;4329199;5;6;-1
626155;202101;352590;I;5611201;0;4;-4
626249;202101;352590;Q;8630504;1;0;1
626488;202101;352590;I;5611201;1;2;-1
626905;202101;352590;N;8292000;1;6;-5
627059;202101;352590;G;4781400;1;0;1
627194;202101;352590;N;8111700;1;2;-1
627419;202101;352590;G;4713002;0;3;-3
628229;202101;352590;N;8291100;34;4;30
629820;202101;352590;I;5611203;0;2;-2
630102;202101;352590;G;4723700;1;0;1
630228;202101;352590;H;4930202;0;3;-3
630230;202101;352590;G;4761003;1;1;0
630594;202101;352590;G;4781400;0;3;-3
630758;202101;352590;Q;8711502;2;2;0
631115;202101;352590;K;6619399;1;0;1
631174;202101;352590;G;4520001;1;0;1
632950;202101;352590;H;4930202;2;0;2
634622;202101;352590;M;7319002;4;0;4
634958;202101;352590;C;1091102;1;0;1
635108;202101;352590;G;4771701;1;1;0
636158;202101;352590;G;4530703;5;0;5
636588;202101;352590;N;8111700;11;4;7
637427;202101;352590;G;4789099;1;0;1
638055;202101;352590;G;4781400;0;3;-3
638547;202101;352590;S;9602502;0;1;-1
638739;202101;352590;G;4789099;2;0;2
638830;202101;352590;G;4744001;2;1;1
639357;202101;352590;Q;8640202;2;0;2
639497;202101;352590;G;4784900;1;0;1
640116;202101;352590;I;5611203;2;1;1
640452;202101;352590;G;4789099;0;1;-1
641663;202101;352590;P;8599604;2;0;2
641671;202101;352590;N;8211300;1;2;-1
642464;202101;352590;N;8291100;1;0;1
642520;202101;352590;G;4781400;2;0;2
643184;202101;352590;G;4773300;1;0;1
645257;202101;352590;G;4744005;0;2;-2
645572;202101;352590;G;4781400;1;1;0
646262;202101;352590;G;4774100;0;1;-1
647307;202101;352590;H;4930202;1;0;1
648207;202101;352590;G;4729699;1;2;-1
648682;202101;352590;H;5320202;0;2;-2
648761;202101;352590;G;4686902;3;4;-1
648830;202101;352590;N;8211300;0;1;-1
648881;202101;352590;S;9602502;0;2;-2
648931;202101;352590;J;6209100;16;5;11
649172;202101;352590;S;9602502;2;1;1
649426;202101;352590;I;5611201;6;1;5
649468;202101;352590;C;2539001;4;0;4
650225;202101;352590;G;4789001;0;1;-1
650721;202101;352590;I;5611203;1;0;1
651926;202101;352590;G;4782201;0;1;-1
652460;202101;352590;P;8599604;0;1;-1
652792;202101;352590;G;4781400;0;1;-1
653011;202101;352590;F;4222701;0;1;-1
653012;202101;352590;F;4222701;0;1;-1
653196;202101;352590;G;4530703;0;2;-2
653197;202101;352590;G;4713001;0;1;-1
653223;202101;352590;I;5611201;1;1;0
654148;202101;352590;G;4759899;2;0;2
655279;202101;352590;F;4399103;6;2;4
655612;202101;352590;P;8593700;2;0;2
655812;202101;352590;G;4729699;1;0;1
656368;202101;352590;G;4744005;3;0;3
656775;202101;352590;G;4741500;2;0;2
657430;202101;352590;G;4755501;0;1;-1
657557;202101;352590;G;4773300;1;0;1
657970;202101;352590;I;5611203;1;1;0
658571;202101;352590;Q;8630504;6;0;6
659678;202101;352590;G;4772500;3;0;3
660030;202101;352590;I;5611203;2;1;1
660318;202101;352590;G;4635499;3;1;2
660735;202101;352590;H;5250804;11;1;10
660799;202101;352590;S;9602502;0;1;-1
661865;202101;352590;K;6622300;2;0;2
662399;202101;352590;G;4520005;0;1;-1
662614;202101;352590;G;4633801;1;0;1
662732;202101;352590;G;4783101;1;0;1
662781;202101;352590;I;5611203;2;0;2
663950;202101;352590;N;8020001;3;0;3
664640;202101;352590;Q;8630504;1;0;1
664714;202101;352590;C;1094500;3;0;3
664952;202101;352590;G;4729699;2;0;2
665298;202101;352590;M;7319004;2;0;2
665857;202101;352590;J;6120501;0;1;-1
665908;202101;352590;J;6120501;0;1;-1
666292;202101;352590;G;4520005;1;0;1
667256;202101;352590;H;4930202;1;1;0
669400;202101;352590;I;5611203;1;5;-4
669508;202101;352590;C;1062700;0;2;-2
669509;202101;352590;C;1062700;0;1;-1
670179;202101;352590;C;1813099;3;0;3
670603;202101;352590;G;4647801;1;0;1
670692;202101;352590;G;4774100;1;2;-1
670811;202101;352590;C;2091600;2;0;2
671241;202101;352590;P;8513900;3;0;3
671427;202101;352590;G;4753900;0;1;-1
671491;202101;352590;H;4930202;0;1;-1
671497;202101;352590;F;4120400;13;7;6
671498;202101;352590;N;8299706;1;0;1
671620;202101;352590;C;2019399;2;1;1
671685;202101;352590;C;2599399;3;2;1
671686;202101;352590;C;2599399;12;0;12
671838;202101;352590;C;2710402;19;9;10
671875;202101;352590;G;4789099;2;0;2
672581;202101;352590;Q;8640202;0;1;-1
672582;202101;352590;M;6920601;2;0;2
672583;202101;352590;C;2122000;0;1;-1
672585;202101;352590;S;9430800;1;1;0
672586;202101;352590;C;2592602;1;0;1
672587;202101;352590;S;9430800;1;3;-2
672589;202101;352590;C;1043100;1;0;1
672593;202101;352590;K;6550200;8;20;-12
672608;202101;352590;K;6550200;18;5;13
672619;202101;352590;K;6550200;0;2;-2
672655;202101;352590;K;6550200;3;0;3
672686;202101;352590;G;4530703;0;1;-1
672687;202101;352590;Q;8650004;1;0;1
672688;202101;352590;G;4789099;1;0;1
672689;202101;352590;M;6920601;0;1;-1
672690;202101;352590;S;9420100;1;0;1
672691;202101;352590;R;9312300;0;2;-2
672868;202101;352590;C;2013402;2;4;-2
672869;202101;352590;C;2013402;3;1;2
673427;202101;352590;G;4781400;0;1;-1
673556;202101;352590;G;4781400;8;10;-2
673724;202101;352590;G;4781400;5;2;3
674056;202101;352590;C;2862300;0;2;-2
674176;202101;352590;G;4782201;0;1;-1
674178;202101;352590;G;4782201;2;0;2
674182;202101;352590;G;4782201;4;9;-5
674183;202101;352590;G;4782201;1;0;1
674270;202101;352590;G;4711301;1;6;-5
674388;202101;352590;G;4731800;0;1;-1
674720;202101;352590;C;2821601;2;0;2
674735;202101;352590;G;4672900;1;0;1
674737;202101;352590;O;8411600;22;0;22
675005;202101;352590;G;4530705;1;0;1
675356;202101;352590;C;3250705;7;0;7
675504;202101;352590;C;2063100;0;6;-6
675585;202101;352590;G;4781400;1;51;-50
675955;202101;352590;G;4744002;5;2;3
675971;202101;352590;Q;8630504;0;1;-1
675975;202101;352590;J;6010100;1;0;1
675976;202101;352590;H;4930202;0;3;-3
675977;202101;352590;G;4639701;0;4;-4
675997;202101;352590;G;4754701;1;0;1
675998;202101;352590;N;8299706;1;0;1
675999;202101;352590;G;4663000;1;0;1
676000;202101;352590;F;4313400;0;3;-3
676001;202101;352590;H;4929902;1;0;1
676227;202101;352590;M;6920601;1;0;1
676228;202101;352590;S;9430800;0;1;-1
676946;202101;352590;G;4711302;3;5;-2
677323;202101;352590;G;4711302;0;2;-2
677624;202101;352590;Q;8640202;0;1;-1
677626;202101;352590;Q;8690999;0;1;-1
677638;202101;352590;Q;8640299;0;1;-1
677643;202101;352590;Q;8640202;7;1;6
677947;202101;352590;G;4637107;0;1;-1
678586;202101;352590;G;4713004;0;2;-2
679586;202101;352590;H;4921301;1;7;-6
679823;202101;352590;N;8299706;1;0;1
679824;202101;352590;G;4731800;1;0;1
680508;202101;352590;Q;8640205;2;4;-2
680510;202101;352590;S;9420100;0;1;-1
680511;202101;352590;C;2592602;0;1;-1
680519;202101;352590;C;1412602;0;1;-1
680520;202101;352590;G;4711302;0;1;-1
680522;202101;352590;G;4783101;1;0;1
680568;202101;352590;C;2229399;0;3;-3
680784;202101;352590;G;4784900;1;0;1
680787;202101;352590;G;4731800;0;1;-1
680858;202101;352590;G;4781400;0;1;-1
681324;202101;352590;I;5620101;0;1;-1
681352;202101;352590;I;5620101;2;2;0
681516;202101;352590;I;5620101;0;2;-2
681598;202101;352590;I;5620101;0;1;-1
681659;202101;352590;I;5620101;0;1;-1
681756;202101;352590;I;5620101;3;1;2
681779;202101;352590;I;5620101;0;2;-2
681781;202101;352590;I;5620101;1;1;0
681792;202101;352590;I;5620101;8;0;8
681917;202101;352590;G;4772500;1;3;-2
681929;202101;352590;G;4511102;1;0;1
681930;202101;352590;G;4744005;0;1;-1
681932;202101;352590;Q;8630503;0;1;-1
681933;202101;352590;H;5223100;0;1;-1
681934;202101;352590;C;1813099;7;2;5
681935;202101;352590;M;6920601;0;1;-1
681936;202101;352590;P;8512100;0;1;-1
681937;202101;352590;P;8599601;1;1;0
682021;202101;352590;P;8599699;0;2;-2
682033;202101;352590;R;9313100;1;0;1
682368;202101;352590;C;1330800;32;24;8
682372;202101;352590;F;4313400;1;1;0
682715;202101;352590;K;6550200;1;1;0
682717;202101;352590;K;6550200;6;13;-7
682718;202101;352590;K;6550200;0;1;-1
682926;202101;352590;F;4120400;0;1;-1
682927;202101;352590;G;4731800;1;0;1
682952;202101;352590;H;4921301;1;9;-8
682956;202101;352590;C;1623400;2;1;1
682958;202101;352590;G;4711302;1;0;1
682959;202101;352590;C;1081302;1;1;0
682960;202101;352590;M;6920601;0;1;-1
682961;202101;352590;C;1112700;1;2;-1
682963;202101;352590;G;4731800;1;1;0
682964;202101;352590;G;4744099;1;1;0
682965;202101;352590;C;1112700;0;1;-1
682966;202101;352590;G;4530703;4;2;2
682968;202101;352590;G;4731800;0;1;-1
682970;202101;352590;I;5611201;1;1;0
682972;202101;352590;P;8513900;15;4;11
682973;202101;352590;G;4511101;2;1;1
682975;202101;352590;C;2229302;1;2;-1
682978;202101;352590;R;9312300;2;0;2
682979;202101;352590;G;4721102;0;1;-1
682985;202101;352590;C;1033301;1;1;0
682986;202101;352590;C;2219600;10;4;6
682988;202101;352590;G;4689399;2;1;1
682990;202101;352590;C;1099601;1;0;1
682991;202101;352590;C;1629301;4;4;0
682995;202101;352590;G;4729699;0;1;-1
682997;202101;352590;K;6622300;3;5;-2
683000;202101;352590;G;4511104;3;2;1
683001;202101;352590;G;4530703;0;1;-1
683004;202101;352590;H;4929902;4;0;4
683005;202101;352590;Q;8610101;44;27;17
683006;202101;352590;G;4541203;0;1;-1
683007;202101;352590;C;1091101;1;0;1
683014;202101;352590;R;9312300;0;1;-1
683016;202101;352590;G;4731800;1;2;-1
683017;202101;352590;G;4711302;0;1;-1
683019;202101;352590;G;4711302;1;9;-8
683022;202101;352590;G;4711302;2;0;2
683024;202101;352590;G;4711302;8;7;1
683026;202101;352590;G;4711302;1;6;-5
683027;202101;352590;G;4711302;1;3;-2
683028;202101;352590;G;4711302;4;13;-9
683029;202101;352590;G;4711302;4;4;0
683031;202101;352590;G;4711302;2;6;-4
683033;202101;352590;G;4711302;3;8;-5
683035;202101;352590;G;4711302;0;1;-1
683037;202101;352590;G;4711302;1;7;-6
683038;202101;352590;G;4711302;1;6;-5
683039;202101;352590;G;4711302;1;13;-12
683040;202101;352590;H;4921301;1;4;-3
683041;202101;352590;C;1311100;0;1;-1
683042;202101;352590;C;1311100;11;16;-5
683043;202101;352590;C;2229301;25;10;15
683044;202101;352590;C;2229301;1;2;-1
683045;202101;352590;C;2229301;34;20;14
683046;202101;352590;C;2229301;1;0;1
683047;202101;352590;C;2229301;3;2;1
683050;202101;352590;Q;8730102;1;1;0
683051;202101;352590;Q;8730102;5;0;5
683055;202101;352590;Q;8800600;3;0;3
683058;202101;352590;S;9420100;1;0;1
683059;202101;352590;G;4721102;1;0;1
683061;202101;352590;G;4511101;0;1;-1
683068;202101;352590;S;9430800;4;1;3
683069;202101;352590;C;1813099;5;2;3
683070;202101;352590;G;4721102;0;1;-1
683076;202101;352590;Q;8610101;3;3;0
683078;202101;352590;G;4771701;1;1;0
683079;202101;352590;S;9430800;0;1;-1
683080;202101;352590;P;8511200;0;1;-1
683082;202101;352590;Q;8610101;6;6;0
683085;202101;352590;M;6920601;1;1;0
683086;202101;352590;C;2342702;1;1;0
683096;202101;352590;G;4530703;0;1;-1
683097;202101;352590;Q;8711502;2;6;-4
683100;202101;352590;G;4744099;0;1;-1
683110;202101;352590;G;4731800;0;1;-1
683111;202101;352590;G;4711302;2;5;-3
683112;202101;352590;G;4711302;0;6;-6
683113;202101;352590;G;4711302;1;4;-3
683114;202101;352590;G;4711302;2;7;-5
683116;202101;352590;G;4711302;0;7;-7
683119;202101;352590;S;9420100;1;0;1
683126;202101;352590;Q;8800600;1;0;1
683127;202101;352590;S;9491000;1;0;1
683128;202101;352590;S;9491000;1;0;1
683132;202101;352590;S;9491000;1;0;1
683133;202101;352590;G;4633801;2;7;-5
683142;202101;352590;M;6920601;0;1;-1
683144;202101;352590;R;9312300;0;1;-1
683195;202101;352590;C;1053800;1;0;1
683408;202101;352590;N;8211300;3;0;3
683481;202101;352590;R;9312300;1;1;0
683482;202101;352590;P;8513900;0;2;-2
683499;202101;352590;C;2071100;1;0;1
683791;202101;352590;C;1013901;21;1;20
683951;202101;352590;R;9321200;0;1;-1
684120;202101;352590;G;4744099;0;1;-1
684269;202101;352590;N;8299799;1;1;0
684271;202101;352590;Q;8640202;1;0;1
684272;202101;352590;Q;8640202;2;0;2
684273;202101;352590;Q;8640201;2;1;1
684276;202101;352590;Q;8640202;1;0;1
684278;202101;352590;Q;8640205;2;0;2
684279;202101;352590;Q;8650004;8;1;7
684281;202101;352590;S;9601701;0;1;-1
684282;202101;352590;Q;8640202;2;1;1
684283;202101;352590;Q;8640202;1;0;1
684284;202101;352590;Q;8640202;1;1;0
684286;202101;352590;Q;8650099;0;1;-1
684311;202101;352590;S;9430800;1;1;0
684312;202101;352590;Q;8610101;2;4;-2
684348;202101;352590;P;8520100;0;1;-1
684349;202101;352590;S;9430800;3;2;1
684350;202101;352590;S;9499500;1;0;1
684364;202101;352590;G;4647801;1;1;0
684365;202101;352590;P;8599601;1;0;1
684444;202101;352590;C;1622699;0;1;-1
684479;202101;352590;H;5112901;1;5;-4
684515;202101;352590;I;5620104;0;1;-1
684599;202101;352590;C;3250707;2;7;-5
684682;202101;352590;C;2342702;2;1;1
684696;202101;352590;G;4661300;5;4;1
684855;202101;352590;P;8512100;4;0;4
684874;202101;352590;P;8592999;0;1;-1
684876;202101;352590;N;8112500;0;1;-1
684877;202101;352590;N;7820500;8;7;1
684925;202101;352590;G;4639701;3;2;1
684941;202101;352590;G;4744099;2;1;1
684973;202101;352590;H;4930202;4;3;1
684992;202101;352590;G;4782201;1;6;-5
684993;202101;352590;G;4782201;2;12;-10
685157;202101;352590;H;4930202;2;0;2
685215;202101;352590;G;4771702;3;6;-3
685216;202101;352590;N;8211300;2;2;0
685307;202101;352590;I;5611201;1;0;1
685397;202101;352590;G;4530703;0;1;-1
685413;202101;352590;G;4530701;1;0;1
685559;202101;352590;G;4721102;3;1;2
685583;202101;352590;C;1031700;7;4;3
685966;202101;352590;G;4789004;1;1;0
686219;202101;352590;G;4669999;3;3;0
686234;202101;352590;I;5510801;0;4;-4
686338;202101;352590;G;4789004;1;0;1
686558;202101;352590;G;4722901;1;0;1
686613;202101;352590;G;4731800;0;1;-1
686889;202101;352590;G;4712100;1;1;0
687009;202101;352590;C;2222600;2;1;1
687441;202101;352590;Q;8640203;2;1;1
687474;202101;352590;G;4530705;0;2;-2
687495;202101;352590;H;4930202;2;0;2
687498;202101;352590;R;9313100;0;1;-1
687499;202101;352590;P;8599601;1;0;1
687501;202101;352590;N;8112500;1;0;1
687503;202101;352590;M;7112000;0;1;-1
687504;202101;352590;S;9420100;0;1;-1
687505;202101;352590;P;8513900;11;1;10
687507;202101;352590;N;8112500;1;0;1
687620;202101;352590;G;4712100;1;0;1
687641;202101;352590;F;4329103;1;0;1
687724;202101;352590;C;3314799;1;0;1
687786;202101;352590;C;3101200;4;1;3
688072;202101;352590;C;3101200;0;1;-1
688155;202101;352590;G;4520001;1;0;1
688272;202101;352590;G;4712100;0;1;-1
688273;202101;352590;G;4712100;4;0;4
688550;202101;352590;Q;8630502;1;0;1
688612;202101;352590;G;4511101;1;0;1
688618;202101;352590;I;5620101;1;1;0
688643;202101;352590;G;4687702;1;0;1
688708;202101;352590;C;1093702;1;0;1
688751;202101;352590;F;4322301;3;1;2
688815;202101;352590;S;9529199;0;1;-1
689345;202101;352590;H;4923002;1;0;1
689406;202101;352590;C;2821602;1;6;-5
689698;202101;352590;G;4520001;0;1;-1
689778;202101;352590;C;2539001;0;1;-1
689936;202101;352590;C;2829199;0;1;-1
689988;202101;352590;B;810006;0;1;-1
690102;202101;352590;G;4649499;5;0;5
690107;202101;352590;C;2823200;0;1;-1
690198;202101;352590;G;4661300;2;1;1
690282;202101;352590;C;2449199;5;1;4
690338;202101;352590;H;4930203;1;0;1
690683;202101;352590;I;5510803;4;0;4
690861;202101;352590;G;4649403;1;0;1
690916;202101;352590;G;4781400;0;1;-1
691006;202101;352590;G;4781400;0;1;-1
691222;202101;352590;G;4753900;2;1;1
691298;202101;352590;I;5510801;1;1;0
691356;202101;352590;G;4511102;1;0;1
691388;202101;352590;K;6550200;2;0;2
691389;202101;352590;Q;8630502;1;2;-1
691390;202101;352590;Q;8610102;1;1;0
691391;202101;352590;Q;8610101;9;0;9
691392;202101;352590;Q;8640210;0;1;-1
691824;202101;352590;F;4321500;4;4;0
692094;202101;352590;G;4731800;1;0;1
692120;202101;352590;C;3314708;1;1;0
692219;202101;352590;C;2949299;0;1;-1
692416;202101;352590;G;4763602;2;2;0
692452;202101;352590;N;8112500;1;1;0
692684;202101;352590;G;4721103;0;1;-1
692742;202101;352590;H;4930202;0;4;-4
692998;202101;352590;C;2099199;0;2;-2
693089;202101;352590;C;2539002;0;1;-1
693093;202101;352590;C;2592602;6;1;5
693197;202101;352590;H;4930202;2;0;2
693222;202101;352590;C;1094500;0;1;-1
693372;202101;352590;K;6493000;3;2;1
693549;202101;352590;K;6422100;0;1;-1
693589;202101;352590;J;6204000;0;1;-1
693731;202101;352590;I;5611201;0;8;-8
693797;202101;352590;N;8219901;2;0;2
693819;202101;352590;I;5611201;2;2;0
693902;202101;352590;I;5611203;2;3;-1
693923;202101;352590;P;8512100;0;2;-2
693938;202101;352590;M;6920601;0;1;-1
693939;202101;352590;N;8112500;0;4;-4
693940;202101;352590;N;8121400;0;3;-3
693942;202101;352590;H;5223100;1;0;1
693943;202101;352590;H;5223100;0;2;-2
693944;202101;352590;P;8599601;1;0;1
693945;202101;352590;P;8599601;0;1;-1
694246;202101;352590;F;4221902;4;4;0
694298;202101;352590;H;4929902;9;11;-2
694328;202101;352590;I;5611201;0;4;-4
694329;202101;352590;I;5611201;1;1;0
694349;202101;352590;G;4789099;1;0;1
694369;202101;352590;G;4763601;0;1;-1
694584;202101;352590;G;4635402;8;8;0
694690;202101;352590;C;2229399;25;19;6
694718;202101;352590;H;4930202;7;2;5
694759;202101;352590;Q;8640205;4;1;3
694812;202101;352590;M;6920601;0;1;-1
694814;202101;352590;P;8512100;5;0;5
694821;202101;352590;N;8112500;0;1;-1
694822;202101;352590;J;6202300;0;1;-1
694942;202101;352590;C;2944100;20;9;11
694979;202101;352590;C;1629301;4;0;4
695121;202101;352590;I;5510803;1;0;1
695420;202101;352590;F;4292802;0;10;-10
695512;202101;352590;G;4689399;1;0;1
695530;202101;352590;H;4930202;2;0;2
695573;202101;352590;C;2539001;0;1;-1
695591;202101;352590;K;6550200;1;1;0
695681;202101;352590;E;3821100;0;1;-1
695793;202101;352590;G;4751201;0;1;-1
695796;202101;352590;G;4755502;2;0;2
695810;202101;352590;H;4930202;1;0;1
695892;202101;352590;N;7732201;1;3;-2
696120;202101;352590;G;4633802;1;0;1
696140;202101;352590;G;4731800;0;1;-1
696599;202101;352590;G;4633801;0;1;-1
696954;202101;352590;C;2032100;0;3;-3
697082;202101;352590;M;7210000;0;1;-1
697095;202101;352590;G;4530701;0;1;-1
697221;202101;352590;C;2522500;9;12;-3
697514;202101;352590;G;4789099;0;1;-1
697516;202101;352590;Q;8610101;3;4;-1
697557;202101;352590;C;2014200;6;6;0
697677;202101;352590;G;4530703;1;2;-1
697696;202101;352590;C;2599399;0;1;-1
697701;202101;352590;C;2812700;1;0;1
697757;202101;352590;K;6422100;4;1;3
697764;202101;352590;K;6422100;1;0;1
697983;202101;352590;K;6422100;2;1;1
698048;202101;352590;K;6422100;5;0;5
698725;202101;352590;K;6422100;0;1;-1
698777;202101;352590;K;6422100;0;1;-1
698970;202101;352590;K;6422100;0;2;-2
699135;202101;352590;C;2222600;2;5;-3
699173;202101;352590;I;5612100;1;0;1
699253;202101;352590;S;9529102;0;1;-1
699391;202101;352590;Q;8640202;1;1;0
699424;202101;352590;G;4744005;0;1;-1
699437;202101;352590;G;4511104;1;0;1
699478;202101;352590;C;2539002;1;0;1
699479;202101;352590;C;2539002;0;1;-1
699527;202101;352590;B;810099;1;0;1
699528;202101;352590;C;2330302;1;2;-1
699631;202101;352590;P;8513900;0;1;-1
700072;202101;352590;C;3104700;1;0;1
700081;202101;352590;P;8513900;0;3;-3
700083;202101;352590;P;8511200;1;0;1
700085;202101;352590;P;8513900;0;5;-5
700135;202101;352590;I;5611201;0;1;-1
700205;202101;352590;Q;8640212;1;0;1
700242;202101;352590;S;9491000;12;0;12
700283;202101;352590;C;2599399;0;1;-1
700494;202101;352590;H;4922102;0;1;-1
700495;202101;352590;H;4922102;0;1;-1
700649;202101;352590;G;4713004;3;4;-1
700947;202101;352590;G;4713004;5;2;3
701172;202101;352590;C;2591800;7;5;2
701236;202101;352590;G;4635402;2;4;-2
701245;202101;352590;C;1122401;7;26;-19
701472;202101;352590;C;1721400;1;3;-2
701519;202101;352590;C;3299002;0;1;-1
701596;202101;352590;G;4711302;0;5;-5
702052;202101;352590;C;2099199;0;1;-1
702093;202101;352590;G;4771701;0;1;-1
702153;202101;352590;G;4771701;1;1;0
702272;202101;352590;G;4771701;1;0;1
702415;202101;352590;G;4771701;1;1;0
702437;202101;352590;G;4771701;0;1;-1
702492;202101;352590;G;4771701;1;0;1
702644;202101;352590;C;2949299;20;6;14
703006;202101;352590;C;1095300;0;1;-1
703035;202101;352590;N;8211300;5;5;0
703101;202101;352590;C;1412601;0;1;-1
703168;202101;352590;C;1411801;8;17;-9
703242;202101;352590;C;1111902;2;4;-2
703546;202101;352590;G;4771701;0;2;-2
703621;202101;352590;G;4771701;1;0;1
703651;202101;352590;G;4771701;0;1;-1
703663;202101;352590;G;4771701;0;2;-2
703884;202101;352590;G;4771701;0;2;-2
703962;202101;352590;G;4771701;1;0;1
704039;202101;352590;G;4771701;0;1;-1
704288;202101;352590;Q;8800600;14;11;3
704608;202101;352590;M;6920601;1;0;1
704609;202101;352590;J;6202300;0;1;-1
704614;202101;352590;N;8121400;24;11;13
704729;202101;352590;G;4782202;1;1;0
705121;202101;352590;G;4742300;1;0;1
705734;202101;352590;C;2592601;0;1;-1
705815;202101;352590;G;4637107;3;1;2
705862;202101;352590;F;4321500;1;2;-1
706469;202101;352590;G;4789099;3;0;3
706524;202101;352590;Q;8800600;0;1;-1
706697;202101;352590;G;4789002;8;2;6
707957;202101;352590;I;5611201;0;1;-1
707965;202101;352590;J;6204000;3;2;1
707973;202101;352590;J;6209100;3;2;1
707984;202101;352590;Q;8660700;3;6;-3
708080;202101;352590;G;4771701;0;1;-1
708125;202101;352590;G;4731800;1;0;1
708126;202101;352590;P;8513900;0;1;-1
708128;202101;352590;G;4530703;1;0;1
708712;202101;352590;H;4930202;0;1;-1
708755;202101;352590;G;4789099;0;1;-1
708854;202101;352590;F;4120400;0;2;-2
708857;202101;352590;C;3314710;9;6;3
709905;202101;352590;G;4781400;0;1;-1
710053;202101;352590;H;4930202;1;2;-1
710068;202101;352590;F;4330401;2;0;2
710114;202101;352590;J;6202300;1;2;-1
710383;202101;352590;G;4711302;11;35;-24
710434;202101;352590;C;1099699;11;3;8
710547;202101;352590;F;4211101;4;1;3
710584;202101;352590;P;8512100;0;1;-1
710609;202101;352590;G;4783101;0;1;-1
710680;202101;352590;G;4771702;1;1;0
711283;202101;352590;G;4684201;2;0;2
711344;202101;352590;N;7739099;7;1;6
711360;202101;352590;I;5611203;1;3;-2
711361;202101;352590;I;5611203;3;6;-3
711498;202101;352590;G;4789099;0;1;-1
712066;202101;352590;N;8111700;19;26;-7
712067;202101;352590;H;5223100;1;0;1
712068;202101;352590;M;6920601;3;0;3
712081;202101;352590;P;8512100;5;1;4
712082;202101;352590;N;8112500;1;0;1
712091;202101;352590;N;8112500;0;1;-1
712092;202101;352590;P;8513900;0;1;-1
712093;202101;352590;Q;8630502;0;1;-1
712094;202101;352590;N;8112500;0;1;-1
712095;202101;352590;N;8112500;1;0;1
712096;202101;352590;N;8112500;0;1;-1
712098;202101;352590;Q;8640207;3;3;0
712195;202101;352590;G;4771701;3;3;0
712196;202101;352590;G;4771701;0;1;-1
712197;202101;352590;G;4771701;1;0;1
712334;202101;352590;G;4530703;1;0;1
712482;202101;352590;C;2014200;5;3;2
712508;202101;352590;G;4711302;0;2;-2
712509;202101;352590;C;1013901;1;2;-1
712584;202101;352590;F;4120400;1;0;1
712585;202101;352590;F;4120400;13;11;2
712631;202101;352590;C;2222600;0;3;-3
712752;202101;352590;F;4120400;3;4;-1
712872;202101;352590;G;4729699;0;6;-6
712984;202101;352590;G;4520001;0;1;-1
713053;202101;352590;C;2229399;1;6;-5
713071;202101;352590;G;4637199;2;0;2
713147;202101;352590;G;4741500;0;1;-1
713320;202101;352590;I;5620101;2;1;1
713514;202101;352590;N;8112500;0;1;-1
713636;202101;352590;G;4744005;0;1;-1
713646;202101;352590;S;9521500;1;1;0
713682;202101;352590;G;4623199;2;0;2
713694;202101;352590;H;4930202;1;2;-1
713838;202101;352590;M;7020400;0;1;-1
713923;202101;352590;G;4721102;1;1;0
714058;202101;352590;G;4763601;0;1;-1
714061;202101;352590;G;4783101;0;1;-1
714928;202101;352590;G;4712100;0;1;-1
715037;202101;352590;J;6203100;9;8;1
715145;202101;352590;G;4637199;1;2;-1
715190;202101;352590;C;2543800;4;2;2
715218;202101;352590;C;2330302;2;3;-1
715544;202101;352590;I;5611201;0;2;-2
715585;202101;352590;G;4771702;1;6;-5
717573;202101;352590;C;2229301;34;25;9
717770;202101;352590;C;1091102;1;0;1
717824;202101;352590;F;4110700;6;1;5
717825;202101;352590;F;4110700;3;1;2
717905;202101;352590;G;4679699;1;1;0
717917;202101;352590;N;7739099;3;3;0
717927;202101;352590;C;3314710;1;1;0
718162;202101;352590;G;4744005;0;1;-1
718285;202101;352590;G;4741500;1;0;1
718287;202101;352590;G;4741500;1;0;1
718289;202101;352590;G;4741500;0;1;-1
718290;202101;352590;G;4741500;1;0;1
718295;202101;352590;G;4741500;0;1;-1
718333;202101;352590;G;4744005;0;1;-1
719425;202101;352590;C;3299099;1;2;-1
719694;202101;352590;G;4744001;0;1;-1
719712;202101;352590;G;4633801;1;1;0
719815;202101;352590;G;4744002;1;0;1
719833;202101;352590;G;4663000;2;0;2
719843;202101;352590;G;4530703;0;1;-1
719981;202101;352590;G;4789099;1;0;1
720009;202101;352590;C;2099199;1;0;1
720010;202101;352590;G;4692300;2;1;1
720160;202101;352590;G;4520005;6;3;3
720176;202101;352590;C;1629301;5;0;5
720339;202101;352590;J;5813100;1;0;1
720878;202101;352590;G;4635402;2;1;1
722229;202101;352590;H;5310502;0;1;-1
722235;202101;352590;H;5223100;0;1;-1
722309;202101;352590;P;8512100;0;1;-1
722789;202101;352590;C;1330800;4;4;0
722840;202101;352590;R;9313100;0;1;-1
722993;202101;352590;G;4711302;1;2;-1
723033;202101;352590;C;2869100;0;2;-2
723056;202101;352590;G;4754703;1;0;1
723121;202101;352590;N;7820500;0;3;-3
723122;202101;352590;I;5611201;0;4;-4
723305;202101;352590;J;6201501;1;0;1
724048;202101;352590;G;4711301;14;20;-6
724723;202101;352590;C;2349401;18;6;12
724729;202101;352590;N;8211300;6;2;4
725295;202101;352590;H;4930202;1;5;-4
726427;202101;352590;G;4672900;3;2;1
727943;202101;352590;H;4930203;4;0;4
730748;202101;352590;G;4530703;4;4;0
731225;202101;352590;G;4711301;5;8;-3
734545;202101;352590;S;9511800;1;0;1
736643;202101;352590;K;6424703;1;0;1
737210;202101;352590;H;4930202;1;0;1
737685;202101;352590;G;4639701;0;5;-5
738714;202101;352590;G;4679604;4;4;0
745598;202101;352590;C;2330399;1;0;1
746641;202101;352590;H;4930202;0;5;-5
748069;202101;352590;C;1733800;9;7;2
748070;202101;352590;C;1733800;5;5;0
749423;202101;352590;K;6422100;0;1;-1
749470;202101;352590;K;6422100;0;1;-1
749665;202101;352590;K;6422100;0;2;-2
752631;202101;352590;G;4744001;0;1;-1
753191;202101;352590;G;4781400;3;2;1
753298;202101;352590;G;4781400;2;3;-1
756125;202101;352590;I;5620101;2;0;2
757736;202101;352590;C;1733800;12;2;10
757934;202101;352590;N;7732201;1;0;1
757979;202101;352590;N;8111700;4;1;3
758000;202101;352590;H;4930202;1;1;0
758253;202101;352590;E;3832700;1;1;0
758254;202101;352590;I;5620104;1;1;0
758294;202101;352590;G;4781400;1;0;1
758299;202101;352590;I;5611201;0;1;-1
758450;202101;352590;C;2829199;1;1;0
758497;202101;352590;C;2599399;1;0;1
760194;202101;352590;C;2813500;7;30;-23
760195;202101;352590;C;2349401;36;37;-1
766843;202101;352590;Q;8630504;0;1;-1
781519;202101;352590;Q;8630503;0;1;-1
117;202105;352590;C;2229399;0;1;-1
367;202105;352590;G;4751201;1;1;0
1623;202105;352590;G;4752100;0;1;-1
2215;202105;352590;G;4772500;1;0;1
2454;202105;352590;C;2599399;5;15;-10
3176;202105;352590;C;2812700;5;3;2
3206;202105;352590;H;4930203;3;4;-1
3322;202105;352590;P;8599601;1;0;1
3329;202105;352590;I;5510803;0;2;-2
3372;202105;352590;C;1340599;1;0;1
3666;202105;352590;C;2222600;1;1;0
3773;202105;352590;Q;8630503;0;1;-1
3793;202105;352590;C;2949299;41;10;31
3904;202105;352590;G;4772500;1;1;0
3922;202105;352590;G;4672900;2;0;2
4502;202105;352590;N;7911200;1;0;1
4598;202105;352590;N;8219901;2;0;2
4670;202105;352590;G;4511102;1;0;1
4809;202105;352590;C;2040100;5;4;1
4956;202105;352590;N;7739099;1;5;-4
5050;202105;352590;N;7810800;18;16;2
5250;202105;352590;K;6622300;1;2;-1
5314;202105;352590;C;2539002;1;1;0
5349;202105;352590;Q;8610102;2;0;2
6166;202105;352590;G;4789099;0;2;-2
6795;202105;352590;K;6436100;0;2;-2
7018;202105;352590;C;2829199;2;0;2
7179;202105;352590;G;4753900;13;3;10
7313;202105;352590;N;8112500;0;1;-1
7745;202105;352590;C;2229303;0;1;-1
8035;202105;352590;G;4644302;1;0;1
8986;202105;352590;P;8599601;1;0;1
9002;202105;352590;G;4649406;0;4;-4
9293;202105;352590;G;4672900;0;1;-1
10400;202105;352590;G;4789007;0;10;-10
11118;202105;352590;S;9529199;0;1;-1
11141;202105;352590;N;8299706;0;1;-1
11896;202105;352590;H;5211701;19;5;14
12571;202105;352590;C;2342702;1;0;1
12687;202105;352590;G;4530703;1;0;1
12715;202105;352590;I;5611203;2;1;1
12820;202105;352590;Q;8610101;8;8;0
13137;202105;352590;G;4633801;0;2;-2
13322;202105;352590;C;1610201;1;1;0
13383;202105;352590;C;2342702;2;0;2
13906;202105;352590;C;1813001;0;1;-1
13945;202105;352590;J;6203100;1;3;-2
13966;202105;352590;G;4511102;1;0;1
14059;202105;352590;G;4771702;1;0;1
14065;202105;352590;H;4929902;5;7;-2
14252;202105;352590;S;9601703;4;5;-1
14256;202105;352590;S;9601703;44;25;19
14549;202105;352590;C;1413401;2;1;1
14710;202105;352590;G;4530705;0;1;-1
14711;202105;352590;G;4530705;1;1;0
14962;202105;352590;P;8599601;0;1;-1
15016;202105;352590;C;2341900;1;0;1
15295;202105;352590;G;4616800;1;2;-1
17283;202105;352590;G;4732600;1;0;1
17441;202105;352590;S;9601701;0;1;-1
17668;202105;352590;M;6920601;0;1;-1
18384;202105;352590;C;2229303;0;1;-1
18736;202105;352590;C;2731700;1;0;1
18863;202105;352590;G;4711301;6;5;1
18928;202105;352590;G;4511101;0;3;-3
19555;202105;352590;E;3701100;2;0;2
19575;202105;352590;G;4742300;4;2;2
19644;202105;352590;G;4644301;34;36;-2
19672;202105;352590;I;5620101;1;0;1
19715;202105;352590;M;7112000;3;47;-44
19988;202105;352590;K;6622300;1;0;1
20308;202105;352590;H;5250804;0;1;-1
20481;202105;352590;K;6424703;2;0;2
20545;202105;352590;N;8292000;0;2;-2
20628;202105;352590;I;5611201;1;1;0
21144;202105;352590;F;4222701;1;2;-1
21149;202105;352590;N;8299701;60;43;17
21329;202105;352590;S;9430800;2;2;0
21591;202105;352590;I;5611201;2;3;-1
22238;202105;352590;I;5611203;0;2;-2
22393;202105;352590;G;4724500;0;1;-1
22495;202105;352590;G;4721102;1;1;0
22962;202105;352590;C;2229302;2;1;1
23178;202105;352590;G;4689399;1;1;0
23901;202105;352590;C;2822402;0;2;-2
24006;202105;352590;J;6010100;0;1;-1
24176;202105;352590;I;5611203;6;0;6
24282;202105;352590;C;3102100;18;6;12
24746;202105;352590;H;4930203;8;8;0
25038;202105;352590;I;5510803;1;0;1
25102;202105;352590;M;6920601;2;1;1
25103;202105;352590;Q;8640299;1;3;-2
25109;202105;352590;F;4329104;1;5;-4
25412;202105;352590;G;4530705;0;1;-1
25460;202105;352590;G;4751201;2;1;1
25879;202105;352590;C;2222600;1;1;0
26093;202105;352590;L;6810202;7;2;5
26215;202105;352590;Q;8630503;0;2;-2
26216;202105;352590;P;8511200;0;1;-1
26672;202105;352590;M;7312200;0;1;-1
27281;202105;352590;G;4744001;2;0;2
27655;202105;352590;H;4930202;0;1;-1
27788;202105;352590;G;4639701;1;2;-1
27846;202105;352590;C;1062700;3;3;0
27911;202105;352590;M;6920601;1;1;0
28354;202105;352590;G;4781400;1;0;1
28358;202105;352590;G;4789099;0;1;-1
28618;202105;352590;C;1081302;1;3;-2
28796;202105;352590;G;4530703;1;1;0
29027;202105;352590;M;7120100;1;0;1
29089;202105;352590;C;2222600;1;1;0
29141;202105;352590;M;6920601;0;1;-1
29173;202105;352590;G;4755502;0;1;-1
29269;202105;352590;G;4712100;1;0;1
29689;202105;352590;C;3250705;2;1;1
29937;202105;352590;G;4721104;2;0;2
30081;202105;352590;C;3101200;3;1;2
30534;202105;352590;G;4687703;1;0;1
31070;202105;352590;N;8211300;23;11;12
31071;202105;352590;G;4634601;0;11;-11
31834;202105;352590;G;4712100;1;0;1
31964;202105;352590;C;2222600;0;2;-2
32871;202105;352590;I;5611201;0;1;-1
33344;202105;352590;G;4530701;0;1;-1
33737;202105;352590;C;2599399;1;0;1
33860;202105;352590;C;2949299;0;3;-3
34185;202105;352590;G;4530701;1;0;1
34712;202105;352590;G;4530702;3;2;1
34963;202105;352590;G;4687701;2;0;2
35043;202105;352590;C;2592602;0;1;-1
35141;202105;352590;C;2599399;1;1;0
35196;202105;352590;C;2599399;4;3;1
35199;202105;352590;G;4759899;4;1;3
35540;202105;352590;P;8599601;0;1;-1
35794;202105;352590;J;6209100;1;0;1
36387;202105;352590;H;4930202;0;1;-1
36846;202105;352590;F;4313400;2;2;0
37258;202105;352590;Q;8650099;0;1;-1
37991;202105;352590;M;6920601;1;1;0
38289;202105;352590;N;8211300;11;9;2
38307;202105;352590;C;2539001;3;0;3
38471;202105;352590;S;9430800;0;2;-2
38651;202105;352590;C;3314710;0;1;-1
38831;202105;352590;C;2511000;1;0;1
38900;202105;352590;R;9312300;1;0;1
39017;202105;352590;G;4751201;2;1;1
39369;202105;352590;P;8511200;1;0;1
39932;202105;352590;G;4763602;2;1;1
40347;202105;352590;C;1081302;18;7;11
40586;202105;352590;N;8011101;9;3;6
40784;202105;352590;P;8599601;1;0;1
40934;202105;352590;N;7820500;13;14;-1
41322;202105;352590;G;4731800;0;1;-1
41548;202105;352590;K;6424703;1;0;1
41768;202105;352590;G;4754701;1;0;1
42015;202105;352590;J;6110801;0;1;-1
42207;202105;352590;F;4223500;1;1;0
42434;202105;352590;G;4781400;2;0;2
42435;202105;352590;C;1340501;0;2;-2
42639;202105;352590;M;6920601;1;1;0
42653;202105;352590;G;4511101;0;3;-3
42690;202105;352590;H;5221400;21;26;-5
42801;202105;352590;C;2941700;28;19;9
42812;202105;352590;R;9313100;1;0;1
42891;202105;352590;I;5510801;0;2;-2
43650;202105;352590;H;4930203;0;1;-1
43817;202105;352590;G;4789099;1;0;1
44183;202105;352590;C;2751100;5;2;3
44814;202105;352590;J;6120501;1;2;-1
45195;202105;352590;F;4120400;1;0;1
45455;202105;352590;C;2451200;0;1;-1
46544;202105;352590;G;4773300;0;2;-2
46549;202105;352590;G;4731800;1;0;1
46573;202105;352590;H;4930202;2;0;2
46790;202105;352590;H;5223100;1;0;1
46857;202105;352590;P;8513900;1;0;1
47650;202105;352590;G;4763601;1;1;0
47741;202105;352590;G;4789004;1;0;1
48063;202105;352590;G;4511101;0;2;-2
48375;202105;352590;G;4511101;2;1;1
48517;202105;352590;G;4511102;1;0;1
48572;202105;352590;C;2219600;1;1;0
48814;202105;352590;G;4722901;1;2;-1
49415;202105;352590;C;2091600;4;8;-4
49449;202105;352590;G;4520001;1;0;1
49628;202105;352590;G;4772500;0;2;-2
49846;202105;352590;S;9511800;1;0;1
50249;202105;352590;H;4930202;5;5;0
50268;202105;352590;Q;8800600;1;0;1
50556;202105;352590;C;2391503;0;1;-1
50680;202105;352590;H;5211799;73;18;55
50865;202105;352590;C;2949299;1;0;1
50883;202105;352590;N;8211300;3;2;1
51274;202105;352590;C;3312102;1;2;-1
51990;202105;352590;H;5223100;1;1;0
52195;202105;352590;H;4930202;1;11;-10
52515;202105;352590;C;1013901;6;9;-3
52569;202105;352590;G;4722901;1;0;1
53059;202105;352590;C;2814301;1;3;-2
53091;202105;352590;J;6204000;0;1;-1
53249;202105;352590;H;5223100;2;0;2
53321;202105;352590;P;8599602;3;1;2
53530;202105;352590;L;6821802;1;1;0
54710;202105;352590;G;4755503;1;1;0
55355;202105;352590;H;4930202;3;1;2
55846;202105;352590;H;4930202;17;13;4
56130;202105;352590;G;4789001;1;0;1
56250;202105;352590;G;4789099;4;0;4
56353;202105;352590;N;8121400;32;18;14
56445;202105;352590;N;8291100;0;1;-1
56679;202105;352590;G;4771702;3;0;3
56711;202105;352590;C;2222600;0;3;-3
56805;202105;352590;G;4731800;1;0;1
56989;202105;352590;M;7112000;0;2;-2
57064;202105;352590;G;4771701;1;0;1
57241;202105;352590;G;4752100;1;0;1
57242;202105;352590;G;4752100;4;2;2
57286;202105;352590;I;5611201;1;0;1
57894;202105;352590;C;2539001;2;1;1
58195;202105;352590;G;4639701;4;0;4
58832;202105;352590;F;4330499;2;2;0
59322;202105;352590;G;4633801;0;1;-1
59700;202105;352590;G;4781400;1;0;1
59980;202105;352590;H;5229002;2;1;1
60423;202105;352590;G;4646001;0;1;-1
61004;202105;352590;I;5620101;0;1;-1
61008;202105;352590;I;5620101;0;1;-1
61027;202105;352590;Q;8720401;3;6;-3
61292;202105;352590;H;4930203;1;0;1
62553;202105;352590;I;5611201;0;1;-1
62567;202105;352590;G;4759899;0;2;-2
62719;202105;352590;C;2811900;1;0;1
62747;202105;352590;F;4120400;0;1;-1
62748;202105;352590;F;4120400;0;1;-1
62749;202105;352590;F;4120400;1;1;0
62922;202105;352590;G;4754701;0;1;-1
63314;202105;352590;I;5611201;1;0;1
63528;202105;352590;C;1821100;1;0;1
63736;202105;352590;J;5819100;1;1;0
64015;202105;352590;G;4744099;4;1;3
64067;202105;352590;G;4781400;1;4;-3
64978;202105;352590;G;4711302;1;0;1
65166;202105;352590;G;4711302;3;2;1
65219;202105;352590;G;4712100;1;1;0
65731;202105;352590;F;4391600;4;4;0
66460;202105;352590;G;4520001;1;0;1
66654;202105;352590;G;4520005;0;1;-1
66991;202105;352590;H;4930202;1;1;0
67695;202105;352590;E;3600601;8;1;7
67718;202105;352590;I;5611203;3;0;3
67904;202105;352590;N;8292000;2;2;0
67998;202105;352590;G;4789099;0;1;-1
68020;202105;352590;G;4722901;1;0;1
68065;202105;352590;C;1093702;25;30;-5
68475;202105;352590;N;7820500;174;288;-114
68535;202105;352590;F;4120400;5;3;2
68865;202105;352590;I;5611201;0;1;-1
69903;202105;352590;Q;8800600;0;1;-1
70072;202105;352590;G;4759801;0;1;-1
70080;202105;352590;J;6209100;2;0;2
70144;202105;352590;G;4724500;2;0;2
70154;202105;352590;H;5320201;0;1;-1
70437;202105;352590;C;3292202;0;1;-1
70520;202105;352590;H;4930202;0;1;-1
70817;202105;352590;P;8599699;1;2;-1
70950;202105;352590;C;2829199;1;1;0
71137;202105;352590;N;7820500;0;1;-1
71165;202105;352590;N;7820500;275;263;12
71481;202105;352590;P;8599601;0;1;-1
72161;202105;352590;G;4754701;0;1;-1
72384;202105;352590;P;8599699;1;0;1
72816;202105;352590;P;8599699;0;2;-2
73098;202105;352590;F;4399199;0;1;-1
73111;202105;352590;J;6190601;1;0;1
73317;202105;352590;I;5611203;0;1;-1
73888;202105;352590;M;6920601;0;1;-1
73904;202105;352590;Q;8630501;1;2;-1
74108;202105;352590;N;8129000;25;108;-83
74129;202105;352590;G;4781400;1;0;1
74167;202105;352590;G;4744005;0;5;-5
74214;202105;352590;C;2222600;11;12;-1
74911;202105;352590;G;4789099;0;1;-1
74954;202105;352590;H;4930202;3;5;-2
74955;202105;352590;H;4930202;4;4;0
75233;202105;352590;H;5120000;3;1;2
75235;202105;352590;H;5120000;2;0;2
75345;202105;352590;N;8122200;1;0;1
75945;202105;352590;G;4744005;1;0;1
76000;202105;352590;G;4637106;1;1;0
76113;202105;352590;H;5223100;0;1;-1
76925;202105;352590;G;4646001;0;2;-2
77362;202105;352590;I;5510803;0;2;-2
77628;202105;352590;Q;8630501;1;1;0
78450;202105;352590;G;4781400;1;0;1
78789;202105;352590;N;8211300;0;3;-3
79021;202105;352590;N;8291100;4;3;1
79951;202105;352590;G;4672900;1;6;-5
80065;202105;352590;I;5611201;3;4;-1
80068;202105;352590;I;5611201;2;2;0
80327;202105;352590;N;8299799;1;12;-11
80328;202105;352590;N;8299799;1;2;-1
80390;202105;352590;Q;8711502;2;3;-1
80655;202105;352590;J;6203100;0;3;-3
81267;202105;352590;F;4120400;1;1;0
81559;202105;352590;D;3514000;1;2;-1
81585;202105;352590;H;4930202;2;3;-1
82083;202105;352590;M;7111100;0;1;-1
82084;202105;352590;G;4789099;0;1;-1
82945;202105;352590;N;8121400;2;1;1
83006;202105;352590;H;4930201;2;3;-1
83286;202105;352590;C;2029100;2;0;2
83308;202105;352590;G;4672900;1;0;1
83619;202105;352590;H;5112901;6;5;1
83975;202105;352590;G;4721102;0;1;-1
84436;202105;352590;S;9491000;1;1;0
84695;202105;352590;P;8532500;3;1;2
84793;202105;352590;P;8599699;5;7;-2
85685;202105;352590;C;3314707;1;0;1
86777;202105;352590;Q;8630501;1;0;1
86849;202105;352590;G;4782202;0;2;-2
87043;202105;352590;C;3314721;41;36;5
87421;202105;352590;G;4511101;1;2;-1
87853;202105;352590;F;4299599;10;11;-1
87856;202105;352590;F;4299599;0;4;-4
87891;202105;352590;I;5620102;0;1;-1
88281;202105;352590;Q;8640210;1;1;0
88822;202105;352590;C;2599399;0;1;-1
88836;202105;352590;G;4639701;8;6;2
88928;202105;352590;G;4729699;1;0;1
89352;202105;352590;G;4731800;0;2;-2
89788;202105;352590;M;6911701;0;1;-1
90020;202105;352590;H;5250804;0;4;-4
90689;202105;352590;N;8299799;2;7;-5
90750;202105;352590;G;4781400;0;1;-1
90978;202105;352590;N;8112500;1;0;1
91076;202105;352590;G;4751201;0;1;-1
91192;202105;352590;I;5620101;1;0;1
91772;202105;352590;Q;8630503;0;1;-1
91866;202105;352590;C;2449199;1;0;1
92637;202105;352590;P;8512100;2;3;-1
92929;202105;352590;I;5611203;0;1;-1
93119;202105;352590;G;4789007;0;23;-23
93251;202105;352590;M;7112000;1;0;1
93410;202105;352590;K;6622300;0;2;-2
93481;202105;352590;N;8211300;17;22;-5
93545;202105;352590;G;4771702;0;1;-1
93728;202105;352590;G;4789099;0;1;-1
93924;202105;352590;R;9329802;0;1;-1
93946;202105;352590;C;3299004;0;2;-2
94141;202105;352590;G;4530703;1;0;1
94409;202105;352590;G;4530703;1;0;1
94845;202105;352590;G;4759899;1;0;1
95283;202105;352590;J;6203100;0;1;-1
95355;202105;352590;I;5611201;1;0;1
96272;202105;352590;F;4399105;1;0;1
96543;202105;352590;Q;8630504;1;0;1
96625;202105;352590;G;4520001;2;0;2
97143;202105;352590;Q;8650099;9;12;-3
97343;202105;352590;H;5250804;1;0;1
97371;202105;352590;G;4789007;11;1;10
97396;202105;352590;C;2949299;0;2;-2
97476;202105;352590;G;4753900;1;1;0
97813;202105;352590;N;8299706;0;1;-1
97924;202105;352590;F;4120400;1;0;1
98138;202105;352590;G;4789099;1;0;1
99104;202105;352590;N;8299706;1;0;1
99305;202105;352590;K;6612603;1;0;1
99684;202105;352590;H;4930201;2;9;-7
99766;202105;352590;G;4771701;0;1;-1
100355;202105;352590;M;6920601;1;2;-1
100686;202105;352590;C;2222600;2;4;-2
100708;202105;352590;C;1032599;0;1;-1
100784;202105;352590;G;4724500;0;4;-4
101103;202105;352590;G;4782201;4;0;4
101419;202105;352590;H;4929901;1;0;1
102150;202105;352590;G;4511101;1;1;0
103299;202105;352590;G;4672900;0;2;-2
103538;202105;352590;F;4299599;0;12;-12
103638;202105;352590;C;2229303;1;1;0
103755;202105;352590;R;9313100;1;0;1
104226;202105;352590;G;4520002;2;0;2
104319;202105;352590;S;9430800;1;3;-2
105020;202105;352590;G;4744005;1;0;1
105218;202105;352590;I;5611203;0;1;-1
107475;202105;352590;G;4763601;1;2;-1
107741;202105;352590;J;5914600;0;4;-4
107790;202105;352590;G;4744002;0;2;-2
107819;202105;352590;G;4530703;3;4;-1
107840;202105;352590;I;5611201;0;1;-1
107841;202105;352590;F;4110700;2;0;2
108380;202105;352590;G;4731800;1;2;-1
108384;202105;352590;G;4782201;3;1;2
108409;202105;352590;F;4313400;0;4;-4
108749;202105;352590;N;7719599;1;0;1
108942;202105;352590;F;4313400;24;12;12
109088;202105;352590;G;4511101;3;5;-2
109473;202105;352590;F;4330404;0;1;-1
109642;202105;352590;J;5822101;0;1;-1
109656;202105;352590;P;8513900;0;1;-1
109897;202105;352590;I;5611201;6;0;6
110681;202105;352590;G;4789001;0;1;-1
111050;202105;352590;J;6201501;5;0;5
111651;202105;352590;G;4687703;0;1;-1
112066;202105;352590;P;8512100;0;2;-2
112391;202105;352590;G;4722901;0;1;-1
112459;202105;352590;N;7820500;127;131;-4
112686;202105;352590;C;2869100;1;1;0
113478;202105;352590;Q;8712300;2;4;-2
113664;202105;352590;G;4781400;1;0;1
113941;202105;352590;H;5240199;1;1;0
114728;202105;352590;G;4755502;3;0;3
115251;202105;352590;M;7119701;5;0;5
115348;202105;352590;M;7319099;2;0;2
115505;202105;352590;G;4781400;1;0;1
115586;202105;352590;L;6810202;0;1;-1
115699;202105;352590;G;4772500;0;1;-1
115838;202105;352590;C;2599399;0;1;-1
116317;202105;352590;G;4541203;1;0;1
116434;202105;352590;G;4639701;1;1;0
116539;202105;352590;G;4721102;1;0;1
117247;202105;352590;G;4731800;0;1;-1
117746;202105;352590;G;4774100;1;0;1
118083;202105;352590;I;5611201;0;1;-1
118374;202105;352590;G;4530703;1;0;1
118429;202105;352590;N;8299799;1;1;0
119262;202105;352590;G;4687702;2;0;2
119573;202105;352590;G;4693100;1;1;0
119761;202105;352590;G;4711302;5;5;0
119792;202105;352590;G;4774100;1;1;0
119896;202105;352590;G;4753900;1;0;1
120053;202105;352590;G;4771701;1;1;0
120060;202105;352590;M;6920601;2;1;1
120679;202105;352590;M;6920601;0;2;-2
121254;202105;352590;C;2219600;3;1;2
121516;202105;352590;G;4744099;1;0;1
122159;202105;352590;G;4623109;9;0;9
122282;202105;352590;M;7500100;0;1;-1
122733;202105;352590;G;4741500;0;1;-1
122880;202105;352590;G;4639701;1;0;1
122953;202105;352590;I;5611201;1;0;1
123021;202105;352590;G;4530703;0;1;-1
123303;202105;352590;P;8512100;2;0;2
123507;202105;352590;G;4759899;0;1;-1
123517;202105;352590;G;4649499;5;0;5
123527;202105;352590;G;4744099;0;1;-1
123782;202105;352590;G;4520001;1;1;0
124453;202105;352590;H;4930203;6;3;3
124507;202105;352590;G;4712100;4;4;0
124555;202105;352590;N;8299799;0;13;-13
124715;202105;352590;J;6204000;1;0;1
124744;202105;352590;S;9511800;1;0;1
124848;202105;352590;C;1099699;9;2;7
124986;202105;352590;C;1082100;2;2;0
125224;202105;352590;G;4645101;2;0;2
125472;202105;352590;F;4120400;0;1;-1
125676;202105;352590;C;1091102;0;1;-1
126110;202105;352590;G;4711302;1;4;-3
126250;202105;352590;G;4711301;12;11;1
126449;202105;352590;G;4711302;0;3;-3
126986;202105;352590;C;2829199;0;1;-1
127041;202105;352590;I;5611201;0;1;-1
127063;202105;352590;I;5611203;2;0;2
127064;202105;352590;I;5611203;1;0;1
127326;202105;352590;P;8531700;6;2;4
128138;202105;352590;I;5611201;1;0;1
128613;202105;352590;C;2591800;1;2;-1
129284;202105;352590;K;6424703;0;1;-1
129328;202105;352590;G;4761001;0;2;-2
129329;202105;352590;I;5611201;1;0;1
130518;202105;352590;G;4781400;1;0;1
130744;202105;352590;F;4120400;1;3;-2
131108;202105;352590;G;4530703;1;3;-2
131234;202105;352590;F;4313400;9;4;5
132016;202105;352590;C;1013902;0;4;-4
133223;202105;352590;G;4712100;7;1;6
133451;202105;352590;G;4530703;1;0;1
133632;202105;352590;G;4752100;1;0;1
133812;202105;352590;G;4763602;5;0;5
134180;202105;352590;H;4930202;2;5;-3
135652;202105;352590;L;6810202;1;0;1
136685;202105;352590;N;8299799;24;7;17
136769;202105;352590;F;4120400;1;0;1
137109;202105;352590;G;4763601;3;1;2
137402;202105;352590;C;2330305;0;1;-1
138029;202105;352590;H;5250804;5;0;5
138244;202105;352590;G;4687702;1;1;0
138695;202105;352590;G;4633801;1;0;1
138713;202105;352590;G;4711302;8;10;-2
138833;202105;352590;G;4713002;2;1;1
139010;202105;352590;H;5223100;0;1;-1
139213;202105;352590;C;2330301;7;0;7
139896;202105;352590;Q;8800600;0;1;-1
140339;202105;352590;G;4731800;2;3;-1
140437;202105;352590;I;5611201;3;0;3
140474;202105;352590;I;5611201;3;0;3
140671;202105;352590;N;8211300;1;1;0
140784;202105;352590;N;8011101;13;9;4
141415;202105;352590;G;4754702;1;0;1
141472;202105;352590;G;4771701;2;1;1
142533;202105;352590;N;8211300;3;3;0
142867;202105;352590;G;4530703;0;1;-1
143302;202105;352590;G;4781400;0;3;-3
143351;202105;352590;Q;8630503;0;1;-1
143862;202105;352590;C;2790299;9;3;6
143864;202105;352590;C;2790299;0;3;-3
143866;202105;352590;G;4530703;0;2;-2
144605;202105;352590;C;3314710;5;0;5
144778;202105;352590;E;3701100;3;1;2
144808;202105;352590;H;4930201;0;1;-1
144842;202105;352590;C;1053800;4;0;4
145004;202105;352590;Q;8630501;3;11;-8
145409;202105;352590;G;4633801;0;3;-3
146174;202105;352590;K;6622300;0;1;-1
146452;202105;352590;G;4744099;1;0;1
146848;202105;352590;P;8513900;0;1;-1
146849;202105;352590;M;7120100;0;1;-1
147650;202105;352590;N;8111700;1;5;-4
148057;202105;352590;C;2710403;1;1;0
148097;202105;352590;G;4751201;1;1;0
148232;202105;352590;F;4299599;2;4;-2
148304;202105;352590;G;4685100;1;1;0
148514;202105;352590;C;2071100;0;1;-1
148795;202105;352590;G;4731800;1;1;0
149270;202105;352590;S;9430800;0;2;-2
149491;202105;352590;G;4761001;1;0;1
149940;202105;352590;G;4771701;0;1;-1
149942;202105;352590;G;4771701;1;0;1
150050;202105;352590;C;2543800;1;0;1
150076;202105;352590;I;5620101;3;0;3
150390;202105;352590;M;7490104;1;1;0
150391;202105;352590;M;7490104;0;1;-1
151257;202105;352590;I;5611201;3;0;3
151837;202105;352590;H;4930202;0;1;-1
151991;202105;352590;G;4789099;0;1;-1
152162;202105;352590;C;2219600;1;2;-1
152295;202105;352590;G;4781400;1;2;-1
152561;202105;352590;H;4930202;0;1;-1
152562;202105;352590;H;4930202;0;1;-1
152601;202105;352590;G;4741500;1;1;0
152602;202105;352590;G;4741500;1;0;1
152603;202105;352590;G;4741500;2;0;2
152621;202105;352590;G;4731800;2;0;2
152875;202105;352590;C;2029100;6;12;-6
152900;202105;352590;G;4635402;3;1;2
153400;202105;352590;I;5620104;0;2;-2
153403;202105;352590;H;4930202;1;0;1
153405;202105;352590;G;4520001;0;1;-1
153839;202105;352590;S;9493600;1;1;0
154511;202105;352590;M;6920601;1;1;0
154660;202105;352590;M;7020400;0;2;-2
154838;202105;352590;R;9313100;0;1;-1
154876;202105;352590;R;9313100;1;0;1
155659;202105;352590;G;4617600;1;0;1
156238;202105;352590;S;9511800;1;1;0
156261;202105;352590;N;8112500;1;0;1
156444;202105;352590;G;4721102;1;0;1
156571;202105;352590;G;4722901;0;1;-1
157162;202105;352590;J;6201501;1;0;1
157320;202105;352590;I;5510801;0;1;-1
157503;202105;352590;I;5611201;0;1;-1
157977;202105;352590;P;8520100;2;0;2
158227;202105;352590;J;6203100;0;2;-2
158242;202105;352590;G;4761003;1;1;0
158461;202105;352590;G;4752100;1;0;1
158469;202105;352590;C;2543800;2;0;2
158737;202105;352590;G;4744005;1;0;1
158740;202105;352590;I;5620104;0;1;-1
159248;202105;352590;C;1053800;2;1;1
160476;202105;352590;N;8211300;1;0;1
160664;202105;352590;G;4712100;0;2;-2
160767;202105;352590;C;1099601;3;5;-2
160883;202105;352590;P;8520100;1;0;1
161139;202105;352590;C;1042200;5;1;4
161278;202105;352590;P;8513900;1;1;0
161281;202105;352590;P;8513900;1;0;1
161535;202105;352590;Q;8650004;0;1;-1
161760;202105;352590;H;4930202;2;2;0
162321;202105;352590;G;4781400;1;0;1
162339;202105;352590;H;5212500;1;2;-1
162881;202105;352590;K;6619399;2;0;2
163469;202105;352590;J;6190699;1;0;1
164027;202105;352590;G;4511101;0;1;-1
164053;202105;352590;H;4930202;1;0;1
164685;202105;352590;N;7711000;0;1;-1
164977;202105;352590;I;5611203;0;1;-1
165009;202105;352590;M;7490104;0;2;-2
165602;202105;352590;N;8130300;4;0;4
166073;202105;352590;J;5813100;0;1;-1
166101;202105;352590;G;4782201;1;1;0
167665;202105;352590;G;4753900;3;5;-2
167666;202105;352590;G;4753900;0;2;-2
167780;202105;352590;G;4789099;1;1;0
168200;202105;352590;G;4789002;2;0;2
168394;202105;352590;P;8512100;1;0;1
168526;202105;352590;G;4639701;1;0;1
168847;202105;352590;G;4744001;1;0;1
169094;202105;352590;G;4530703;1;1;0
169633;202105;352590;G;4731800;0;1;-1
170007;202105;352590;P;8511200;0;1;-1
170088;202105;352590;G;4686902;1;1;0
170186;202105;352590;B;891600;1;3;-2
170493;202105;352590;I;5611201;1;0;1
170814;202105;352590;C;2621300;56;20;36
170815;202105;352590;C;2632900;3;26;-23
170878;202105;352590;N;8299799;87;106;-19
172132;202105;352590;Q;8630501;1;0;1
172345;202105;352590;C;2229303;2;0;2
172448;202105;352590;H;5212500;2;2;0
172607;202105;352590;G;4761001;0;1;-1
172913;202105;352590;G;4729699;1;0;1
173432;202105;352590;C;3316301;2;0;2
174254;202105;352590;I;5611201;0;1;-1
174350;202105;352590;F;4321500;0;3;-3
174438;202105;352590;N;7732201;2;1;1
174709;202105;352590;M;6920601;0;1;-1
174711;202105;352590;G;4744099;0;1;-1
174870;202105;352590;G;4789004;0;1;-1
175024;202105;352590;G;4713002;0;1;-1
175796;202105;352590;J;6201501;6;1;5
176518;202105;352590;H;4930202;0;1;-1
176781;202105;352590;F;4399199;0;5;-5
176826;202105;352590;G;4731800;1;0;1
178087;202105;352590;J;5829800;1;0;1
178259;202105;352590;F;4120400;2;6;-4
178689;202105;352590;G;4530703;1;3;-2
179165;202105;352590;G;4744001;2;0;2
179924;202105;352590;P;8512100;1;0;1
180051;202105;352590;G;4789004;0;1;-1
180218;202105;352590;G;4781400;0;1;-1
180389;202105;352590;S;9603304;0;1;-1
180542;202105;352590;F;4213800;0;15;-15
181057;202105;352590;G;4729699;3;1;2
181332;202105;352590;C;2539001;1;0;1
181333;202105;352590;G;4663000;1;1;0
181517;202105;352590;H;5212500;9;4;5
181612;202105;352590;N;8111700;2;8;-6
182649;202105;352590;N;7820500;18;1;17
182717;202105;352590;G;4511101;2;3;-1
183144;202105;352590;H;4930202;0;1;-1
183482;202105;352590;C;2093200;0;1;-1
183938;202105;352590;Q;8640212;1;0;1
184120;202105;352590;G;4530703;1;0;1
184296;202105;352590;H;4930202;1;1;0
184925;202105;352590;G;4729699;1;9;-8
185014;202105;352590;F;4120400;0;1;-1
185022;202105;352590;C;1092900;0;1;-1
185632;202105;352590;G;4789002;3;0;3
185758;202105;352590;J;5812301;0;1;-1
186751;202105;352590;F;4222701;1;2;-1
186877;202105;352590;G;4754703;1;0;1
186985;202105;352590;G;4789099;2;1;1
187224;202105;352590;G;4686902;7;5;2
187706;202105;352590;Q;8711502;1;1;0
187747;202105;352590;E;3832700;7;2;5
188083;202105;352590;I;5611201;1;0;1
188091;202105;352590;I;5611201;1;0;1
188249;202105;352590;G;4759899;0;1;-1
188860;202105;352590;I;5611201;0;1;-1
189265;202105;352590;G;4511101;2;2;0
189539;202105;352590;G;4729699;0;1;-1
189610;202105;352590;I;5620104;1;0;1
189796;202105;352590;G;4781400;0;1;-1
190796;202105;352590;I;5611201;2;0;2
191336;202105;352590;G;4754701;5;9;-4
191340;202105;352590;G;4754701;0;3;-3
191346;202105;352590;G;4754701;1;5;-4
192733;202105;352590;G;4687703;0;1;-1
192748;202105;352590;I;5611201;0;1;-1
193132;202105;352590;I;5611201;1;0;1
193391;202105;352590;I;5611203;3;2;1
193720;202105;352590;I;5620102;0;1;-1
193887;202105;352590;I;5620101;3;5;-2
194422;202105;352590;G;4731800;4;3;1
194800;202105;352590;G;4789005;0;1;-1
194801;202105;352590;G;4712100;0;1;-1
195263;202105;352590;G;4754701;1;1;0
195476;202105;352590;M;6920601;0;1;-1
195790;202105;352590;S;9521500;0;1;-1
196193;202105;352590;M;7112000;1;0;1
196194;202105;352590;J;6204000;2;3;-1
196384;202105;352590;G;4781400;0;1;-1
196662;202105;352590;J;6311900;0;1;-1
196859;202105;352590;G;4757100;2;1;1
197874;202105;352590;G;4771701;0;1;-1
198396;202105;352590;F;4321500;2;2;0
198412;202105;352590;G;4772500;6;4;2
198640;202105;352590;G;4722901;1;0;1
198745;202105;352590;I;5611201;2;7;-5
199474;202105;352590;N;8011101;0;2;-2
199829;202105;352590;I;5611201;0;2;-2
200788;202105;352590;I;5620101;2;3;-1
200957;202105;352590;Q;8610101;6;5;1
201391;202105;352590;M;6920601;1;0;1
201500;202105;352590;N;8219999;1;0;1
201501;202105;352590;N;8219999;0;2;-2
201506;202105;352590;G;4686902;3;1;2
201574;202105;352590;G;4724500;5;11;-6
201575;202105;352590;G;4633801;1;0;1
201576;202105;352590;G;4724500;4;10;-6
202713;202105;352590;M;7500100;0;1;-1
202933;202105;352590;N;8112500;1;2;-1
203168;202105;352590;N;8211300;1;0;1
203320;202105;352590;C;2812700;0;1;-1
203691;202105;352590;J;5914600;3;0;3
203884;202105;352590;I;5611201;2;2;0
204078;202105;352590;P;8599601;1;0;1
204720;202105;352590;H;5250805;1;0;1
204754;202105;352590;C;2621300;5;120;-115
204984;202105;352590;G;4772500;0;1;-1
205261;202105;352590;G;4691500;1;6;-5
205411;202105;352590;I;5611204;0;2;-2
205793;202105;352590;Q;8711502;0;1;-1
205798;202105;352590;J;6190601;1;1;0
206159;202105;352590;F;4330401;0;1;-1
206613;202105;352590;G;4520006;0;1;-1
206632;202105;352590;C;2511000;14;8;6
206743;202105;352590;G;4731800;1;3;-2
206815;202105;352590;I;5611201;0;3;-3
207674;202105;352590;N;7732201;0;1;-1
207782;202105;352590;G;4511101;0;1;-1
207810;202105;352590;I;5611201;0;3;-3
208359;202105;352590;M;6920601;1;0;1
208514;202105;352590;I;5611201;0;1;-1
209326;202105;352590;C;2660400;160;13;147
209918;202105;352590;N;8299799;2;1;1
210028;202105;352590;Q;8640205;1;1;0
211458;202105;352590;G;4511101;3;5;-2
211977;202105;352590;M;7490199;0;1;-1
212356;202105;352590;Q;8711502;2;0;2
212413;202105;352590;G;4731800;0;1;-1
212445;202105;352590;H;4930202;1;0;1
212737;202105;352590;G;4520004;1;2;-1
213246;202105;352590;G;4754701;53;2;51
213251;202105;352590;G;4754701;1;0;1
213658;202105;352590;N;8211300;0;2;-2
213692;202105;352590;G;4713002;1;0;1
214447;202105;352590;N;8220200;4;2;2
214929;202105;352590;G;4530703;1;0;1
214958;202105;352590;H;5240199;1;0;1
216033;202105;352590;P;8513900;0;1;-1
216178;202105;352590;G;4742300;1;0;1
216703;202105;352590;N;8122200;0;1;-1
216961;202105;352590;H;5250804;2;1;1
216963;202105;352590;G;4744003;1;2;-1
217486;202105;352590;H;5223100;0;1;-1
217900;202105;352590;G;4789099;2;2;0
218475;202105;352590;G;4771701;1;0;1
218631;202105;352590;G;4721102;1;0;1
218766;202105;352590;M;7500100;1;0;1
218983;202105;352590;H;4930202;1;6;-5
219099;202105;352590;M;6920601;0;1;-1
219232;202105;352590;J;6204000;1;0;1
219493;202105;352590;P;8592901;0;1;-1
220124;202105;352590;G;4789004;0;1;-1
220507;202105;352590;G;4732600;0;1;-1
220781;202105;352590;C;2222600;1;4;-3
220926;202105;352590;K;6619399;1;0;1
220935;202105;352590;F;4292802;1;0;1
221354;202105;352590;C;3314707;1;4;-3
221923;202105;352590;C;2651500;0;1;-1
222737;202105;352590;H;4930202;2;3;-1
223145;202105;352590;G;4635499;0;1;-1
223800;202105;352590;G;4731800;2;0;2
224318;202105;352590;K;6622300;0;1;-1
224669;202105;352590;G;4712100;2;2;0
224670;202105;352590;N;8299799;3;5;-2
226637;202105;352590;F;4321500;2;1;1
226772;202105;352590;M;7311400;1;0;1
227028;202105;352590;G;4687703;0;1;-1
227177;202105;352590;M;6920601;1;3;-2
227659;202105;352590;F;4330401;2;1;1
229013;202105;352590;P;8511200;0;2;-2
229268;202105;352590;G;4651601;1;0;1
229291;202105;352590;H;4930202;22;21;1
229482;202105;352590;F;4213800;1;0;1
230927;202105;352590;G;4646001;1;1;0
231643;202105;352590;C;3211602;0;1;-1
231659;202105;352590;G;4712100;3;1;2
231689;202105;352590;G;4669999;1;0;1
232301;202105;352590;N;7911200;1;1;0
232574;202105;352590;G;4623109;3;1;2
232595;202105;352590;G;4781400;5;5;0
232607;202105;352590;G;4511104;0;1;-1
232638;202105;352590;P;8513900;2;0;2
232640;202105;352590;N;8130300;24;25;-1
232641;202105;352590;G;4789099;1;2;-1
233264;202105;352590;S;9601701;1;0;1
233342;202105;352590;G;4761003;0;1;-1
234044;202105;352590;G;4789004;1;0;1
234248;202105;352590;G;4781400;2;1;1
234250;202105;352590;G;4781400;2;0;2
234418;202105;352590;G;4771701;0;1;-1
234720;202105;352590;M;6920601;0;1;-1
234859;202105;352590;C;3314710;1;0;1
235277;202105;352590;N;8299799;6;4;2
235504;202105;352590;F;4399105;1;0;1
235605;202105;352590;C;2311700;3;0;3
235606;202105;352590;G;4744002;1;1;0
235876;202105;352590;I;5611203;2;2;0
236358;202105;352590;G;4751201;1;0;1
236389;202105;352590;H;5212500;8;8;0
236788;202105;352590;C;2349401;1;6;-5
237030;202105;352590;C;2599399;1;0;1
237613;202105;352590;M;7500100;0;1;-1
238568;202105;352590;I;5611202;0;1;-1
238698;202105;352590;S;9511800;1;0;1
238752;202105;352590;G;4773300;0;1;-1
238864;202105;352590;F;4321500;0;2;-2
239131;202105;352590;N;8211300;0;4;-4
239188;202105;352590;Q;8630506;0;2;-2
239301;202105;352590;G;4771701;1;0;1
240174;202105;352590;J;5911102;1;0;1
240734;202105;352590;C;2072000;5;2;3
240757;202105;352590;N;8011101;0;1;-1
241553;202105;352590;G;4633801;0;1;-1
242031;202105;352590;G;4649499;1;1;0
242709;202105;352590;P;8513900;1;1;0
242730;202105;352590;G;4520007;2;1;1
243552;202105;352590;C;2542000;0;3;-3
243594;202105;352590;C;1830003;1;1;0
243671;202105;352590;G;4782201;0;4;-4
244095;202105;352590;M;7490199;2;1;1
244474;202105;352590;G;4633801;0;1;-1
244556;202105;352590;N;8299799;1;0;1
244636;202105;352590;C;1091101;3;1;2
245275;202105;352590;G;4713002;1;2;-1
245592;202105;352590;G;4744001;1;0;1
246562;202105;352590;C;1733800;2;1;1
246753;202105;352590;I;5611203;2;0;2
247102;202105;352590;G;4721102;2;1;1
247117;202105;352590;P;8599603;3;3;0
247150;202105;352590;H;4930202;0;1;-1
247396;202105;352590;I;5611204;1;0;1
247518;202105;352590;P;8511200;1;0;1
247544;202105;352590;I;5611201;1;1;0
247546;202105;352590;H;4930202;1;0;1
247758;202105;352590;G;4781400;4;1;3
249322;202105;352590;G;4751201;1;0;1
249431;202105;352590;L;6822600;1;3;-2
249547;202105;352590;F;4120400;1;1;0
250042;202105;352590;J;6311900;6;0;6
250088;202105;352590;C;2790299;1;1;0
250312;202105;352590;G;4722901;0;1;-1
250418;202105;352590;G;4663000;1;0;1
250472;202105;352590;J;5811500;0;1;-1
250536;202105;352590;M;6920601;0;1;-1
251029;202105;352590;L;6821802;0;1;-1
251576;202105;352590;G;4789004;1;0;1
251620;202105;352590;I;5611201;0;1;-1
251951;202105;352590;I;5611201;0;1;-1
252416;202105;352590;C;1733800;0;3;-3
252628;202105;352590;P;8520100;2;0;2
252647;202105;352590;F;4322301;1;0;1
252903;202105;352590;S;9601701;1;0;1
253755;202105;352590;M;6920601;0;1;-1
253812;202105;352590;G;4731800;0;3;-3
254240;202105;352590;F;4330404;1;0;1
254710;202105;352590;G;4761001;0;1;-1
255052;202105;352590;G;4782201;2;1;1
255259;202105;352590;G;4781400;4;9;-5
255400;202105;352590;C;1066000;17;9;8
255851;202105;352590;G;4781400;1;3;-2
255934;202105;352590;S;9521500;1;6;-5
256484;202105;352590;G;4712100;0;2;-2
256539;202105;352590;C;3250705;4;2;2
257167;202105;352590;E;3821100;4;16;-12
257170;202105;352590;I;5611201;1;1;0
257213;202105;352590;K;6462000;2;1;1
257260;202105;352590;N;8111700;21;14;7
257322;202105;352590;J;6319400;1;0;1
257451;202105;352590;F;4330499;2;1;1
257642;202105;352590;G;4729602;0;1;-1
257875;202105;352590;M;6920601;2;0;2
258028;202105;352590;I;5611203;1;0;1
258040;202105;352590;G;4744005;1;0;1
258493;202105;352590;F;4120400;15;7;8
258620;202105;352590;G;4744001;0;1;-1
259161;202105;352590;G;4783101;1;0;1
259226;202105;352590;G;4711302;1;0;1
259358;202105;352590;C;3314708;1;0;1
259468;202105;352590;I;5611201;2;0;2
259661;202105;352590;G;4755503;0;1;-1
259847;202105;352590;G;4712100;2;0;2
259864;202105;352590;G;4781400;1;0;1
260521;202105;352590;G;4744099;1;0;1
261146;202105;352590;C;3250706;0;1;-1
261178;202105;352590;G;4759899;0;1;-1
261845;202105;352590;J;6190601;1;0;1
261846;202105;352590;J;6190601;0;1;-1
261847;202105;352590;N;8121400;3;1;2
261959;202105;352590;C;2342702;2;1;1
262286;202105;352590;M;6920601;1;0;1
262714;202105;352590;I;5620104;0;1;-1
262837;202105;352590;F;4322302;1;1;0
263322;202105;352590;G;4712100;0;1;-1
263420;202105;352590;P;8511200;1;0;1
263421;202105;352590;P;8511200;1;0;1
263575;202105;352590;M;7420001;1;0;1
263612;202105;352590;P;8541400;1;1;0
263613;202105;352590;L;6821801;2;1;1
263655;202105;352590;C;3314704;2;0;2
264074;202105;352590;R;9329804;1;1;0
264387;202105;352590;M;6920601;0;1;-1
264907;202105;352590;P;8511200;1;0;1
265900;202105;352590;G;4754701;1;1;0
266349;202105;352590;I;5611203;0;1;-1
266725;202105;352590;H;4930202;1;2;-1
268547;202105;352590;M;6920601;1;1;0
268570;202105;352590;G;4761002;0;2;-2
268610;202105;352590;Q;8630504;1;0;1
269449;202105;352590;Q;8711501;0;1;-1
269497;202105;352590;G;4530701;1;0;1
269498;202105;352590;G;4530703;1;0;1
269672;202105;352590;N;8111700;9;5;4
270275;202105;352590;G;4757100;0;1;-1
270431;202105;352590;G;4691500;4;6;-2
270900;202105;352590;G;4743100;1;0;1
271661;202105;352590;N;8211300;3;1;2
271689;202105;352590;G;4637199;0;1;-1
271955;202105;352590;M;7311400;1;1;0
272041;202105;352590;I;5611203;4;1;3
272047;202105;352590;I;5611203;1;2;-1
272351;202105;352590;I;5611203;0;1;-1
272533;202105;352590;C;1091102;1;0;1
272806;202105;352590;G;4687702;1;1;0
272899;202105;352590;C;3314799;0;1;-1
272983;202105;352590;G;4663000;1;0;1
273295;202105;352590;H;4930202;3;1;2
273812;202105;352590;F;4120400;1;0;1
273920;202105;352590;G;4729699;1;1;0
274130;202105;352590;N;7733100;0;1;-1
274690;202105;352590;P;8512100;0;1;-1
274978;202105;352590;N;7733100;3;0;3
274982;202105;352590;N;7733100;3;0;3
275030;202105;352590;G;4637199;2;1;1
275643;202105;352590;I;5611201;0;1;-1
275665;202105;352590;I;5611201;0;2;-2
276196;202105;352590;I;5620104;1;0;1
276203;202105;352590;Q;8630502;4;0;4
276487;202105;352590;H;4930202;0;1;-1
276819;202105;352590;G;4689399;0;2;-2
276934;202105;352590;P;8511200;0;1;-1
276935;202105;352590;P;8511200;0;1;-1
277032;202105;352590;I;5611201;0;1;-1
277068;202105;352590;F;4213800;3;0;3
277490;202105;352590;K;6622300;0;1;-1
277554;202105;352590;F;4399101;2;0;2
277698;202105;352590;G;4669999;5;1;4
278420;202105;352590;G;4530703;1;0;1
278477;202105;352590;H;4930202;0;1;-1
278992;202105;352590;I;5611203;1;0;1
278994;202105;352590;N;8299799;1;0;1
279336;202105;352590;I;5611203;0;1;-1
280264;202105;352590;G;4783101;1;0;1
280431;202105;352590;C;3212400;1;0;1
280616;202105;352590;D;3511502;1;0;1
280890;202105;352590;L;6810201;0;1;-1
281135;202105;352590;G;4756300;0;1;-1
281164;202105;352590;G;4722901;1;0;1
281263;202105;352590;F;4321500;0;1;-1
281492;202105;352590;Q;8630503;0;1;-1
281743;202105;352590;G;4781400;1;0;1
281941;202105;352590;J;6110803;0;2;-2
282202;202105;352590;G;4781400;2;0;2
282784;202105;352590;G;4686902;4;0;4
283218;202105;352590;G;4744005;1;0;1
283387;202105;352590;M;6920601;1;0;1
283682;202105;352590;F;4399103;3;0;3
283699;202105;352590;M;7020400;1;0;1
283884;202105;352590;K;6619399;2;0;2
283885;202105;352590;K;6622300;6;2;4
284013;202105;352590;G;4731800;1;0;1
284110;202105;352590;G;4763603;0;1;-1
284111;202105;352590;G;4763603;0;2;-2
284257;202105;352590;G;4646001;3;1;2
284693;202105;352590;S;9602502;5;0;5
284769;202105;352590;K;6462000;1;0;1
285040;202105;352590;M;6911701;0;1;-1
285123;202105;352590;C;2731700;1;0;1
285601;202105;352590;G;4789099;3;2;1
285604;202105;352590;Q;8640205;1;0;1
285605;202105;352590;Q;8640205;0;1;-1
286261;202105;352590;H;5211701;48;34;14
287463;202105;352590;G;4530704;2;3;-1
287754;202105;352590;G;4789099;1;1;0
287758;202105;352590;N;8219999;0;2;-2
288063;202105;352590;G;4530705;0;1;-1
288322;202105;352590;G;4781400;1;0;1
288656;202105;352590;M;7119704;0;1;-1
288859;202105;352590;N;8111700;1;1;0
289083;202105;352590;C;3314702;1;5;-4
289263;202105;352590;G;4754701;25;3;22
289504;202105;352590;P;8593700;1;0;1
290021;202105;352590;G;4771702;1;0;1
290023;202105;352590;C;1091101;4;4;0
290026;202105;352590;C;2599399;0;25;-25
290180;202105;352590;C;3314708;2;6;-4
290764;202105;352590;C;3314710;1;0;1
291384;202105;352590;H;4930202;1;2;-1
292201;202105;352590;I;5611201;2;0;2
292933;202105;352590;G;4772500;0;1;-1
293325;202105;352590;I;5620102;1;0;1
293919;202105;352590;G;4771701;0;1;-1
294605;202105;352590;F;4120400;1;0;1
294900;202105;352590;F;4399199;5;4;1
295055;202105;352590;F;4330402;0;1;-1
295487;202105;352590;G;4530703;1;0;1
295607;202105;352590;G;4761001;2;2;0
295871;202105;352590;F;4321500;0;1;-1
296086;202105;352590;M;6920601;0;1;-1
296210;202105;352590;G;4789004;1;0;1
296384;202105;352590;G;4781400;1;0;1
296580;202105;352590;G;4724500;1;1;0
296720;202105;352590;I;5611201;0;1;-1
296835;202105;352590;G;4623109;1;0;1
296836;202105;352590;G;4623109;0;1;-1
297165;202105;352590;G;4763601;0;1;-1
297224;202105;352590;F;4322303;2;2;0
297772;202105;352590;I;5620104;1;0;1
298533;202105;352590;G;4781400;3;2;1
298774;202105;352590;G;4772500;0;1;-1
298859;202105;352590;F;4120400;13;1;12
299434;202105;352590;G;4741500;1;1;0
299642;202105;352590;Q;8650003;0;1;-1
300025;202105;352590;N;7739099;1;1;0
300525;202105;352590;M;6920601;1;0;1
300568;202105;352590;N;7810800;9;8;1
300576;202105;352590;G;4721104;4;4;0
300577;202105;352590;G;4637107;2;0;2
300657;202105;352590;C;3101200;1;4;-3
300658;202105;352590;G;4754701;0;1;-1
300802;202105;352590;J;6209100;0;2;-2
301312;202105;352590;G;4744002;0;1;-1
301863;202105;352590;Q;8800600;0;1;-1
302031;202105;352590;C;1053800;11;1;10
302364;202105;352590;Q;8712300;2;1;1
302691;202105;352590;F;4120400;11;0;11
303089;202105;352590;G;4744005;0;4;-4
303106;202105;352590;G;4721104;1;1;0
303195;202105;352590;N;8121400;1;2;-1
303220;202105;352590;N;7732201;0;1;-1
303224;202105;352590;I;5611201;0;1;-1
303490;202105;352590;I;5611202;2;0;2
303907;202105;352590;I;5611201;0;1;-1
304838;202105;352590;G;4781400;1;0;1
304973;202105;352590;H;4930202;1;0;1
306316;202105;352590;C;2229303;3;1;2
306400;202105;352590;G;4782201;0;3;-3
306652;202105;352590;G;4771701;1;1;0
307000;202105;352590;I;5611203;2;1;1
307132;202105;352590;I;5611203;0;1;-1
307262;202105;352590;S;9411100;0;1;-1
307352;202105;352590;F;4120400;0;1;-1
307449;202105;352590;M;7112000;0;1;-1
307706;202105;352590;N;7711000;1;0;1
307946;202105;352590;Q;8630503;0;2;-2
308103;202105;352590;C;3101200;1;0;1
308607;202105;352590;S;9521500;2;1;1
308608;202105;352590;S;9521500;0;1;-1
308818;202105;352590;N;8299799;1;0;1
308820;202105;352590;G;4781400;0;1;-1
309168;202105;352590;M;7311400;1;0;1
309601;202105;352590;G;4712100;0;1;-1
309812;202105;352590;E;3811400;0;1;-1
309902;202105;352590;G;4782201;3;0;3
310417;202105;352590;G;4781400;0;1;-1
310419;202105;352590;R;9313100;0;1;-1
310457;202105;352590;G;4782201;1;0;1
310817;202105;352590;S;9601701;0;1;-1
310854;202105;352590;N;8111700;5;4;1
311040;202105;352590;H;4930202;0;6;-6
311045;202105;352590;F;4321500;0;4;-4
311051;202105;352590;R;9313100;0;2;-2
311183;202105;352590;H;5211701;4;1;3
311494;202105;352590;G;4759899;0;1;-1
311509;202105;352590;P;8511200;1;1;0
311690;202105;352590;F;4399103;4;0;4
312102;202105;352590;H;4930201;2;0;2
312553;202105;352590;G;4754701;1;0;1
313302;202105;352590;G;4752100;2;2;0
313641;202105;352590;N;8219999;0;2;-2
313642;202105;352590;N;8219999;2;1;1
313655;202105;352590;H;4930202;1;0;1
314198;202105;352590;I;5611203;1;1;0
314789;202105;352590;R;9313100;1;0;1
314915;202105;352590;S;9602502;1;0;1
315037;202105;352590;S;9603301;3;3;0
315127;202105;352590;G;4623101;1;0;1
315205;202105;352590;H;4930202;0;1;-1
315451;202105;352590;K;6422100;1;0;1
315712;202105;352590;L;6821802;0;8;-8
315877;202105;352590;G;4721104;1;1;0
316357;202105;352590;F;4322301;1;0;1
316394;202105;352590;S;9602502;1;0;1
317082;202105;352590;I;5611201;1;2;-1
317174;202105;352590;G;4789099;1;0;1
317752;202105;352590;G;4754701;2;1;1
317878;202105;352590;G;4781400;1;0;1
318079;202105;352590;I;5611201;1;0;1
318721;202105;352590;C;2539001;1;0;1
319049;202105;352590;H;4930202;0;2;-2
320154;202105;352590;G;4742300;1;0;1
320272;202105;352590;N;8121400;0;1;-1
321129;202105;352590;G;4774100;1;1;0
321275;202105;352590;G;4751201;1;1;0
321496;202105;352590;G;4729699;0;1;-1
321502;202105;352590;H;5250803;2;2;0
321803;202105;352590;G;4520005;15;2;13
322467;202105;352590;N;8219999;0;1;-1
322541;202105;352590;G;4721104;1;0;1
322560;202105;352590;G;4721104;3;3;0
323545;202105;352590;F;4120400;16;8;8
323740;202105;352590;G;4744005;0;1;-1
323912;202105;352590;G;4772500;0;2;-2
324148;202105;352590;G;4663000;2;3;-1
325234;202105;352590;G;4541201;0;1;-1
325461;202105;352590;G;4752100;1;0;1
325727;202105;352590;M;7312200;0;1;-1
326215;202105;352590;F;4120400;6;3;3
326271;202105;352590;C;3250701;2;2;0
326523;202105;352590;N;8111700;1;3;-2
327825;202105;352590;G;4614100;2;0;2
327838;202105;352590;G;4771702;5;3;2
327933;202105;352590;N;8299799;2;2;0
328859;202105;352590;G;4789099;2;0;2
329582;202105;352590;N;8219999;1;1;0
329712;202105;352590;C;3321000;2;0;2
329848;202105;352590;Q;8630501;1;0;1
330177;202105;352590;Q;8630503;1;0;1
330228;202105;352590;M;6920601;0;1;-1
330229;202105;352590;G;4782201;0;1;-1
330507;202105;352590;G;4618499;2;0;2
330664;202105;352590;G;4752100;3;0;3
331283;202105;352590;H;4930201;2;4;-2
331627;202105;352590;I;5611201;0;1;-1
331817;202105;352590;S;9602501;2;1;1
332056;202105;352590;G;4789002;0;1;-1
332161;202105;352590;G;4634601;1;2;-1
332194;202105;352590;G;4783102;1;1;0
332570;202105;352590;I;5611201;1;1;0
332686;202105;352590;G;4789004;6;3;3
332831;202105;352590;M;7319003;3;1;2
332894;202105;352590;F;4399199;2;0;2
333016;202105;352590;G;4639701;0;1;-1
333097;202105;352590;Q;8711502;1;0;1
333721;202105;352590;G;4713002;1;0;1
334138;202105;352590;G;4520005;0;1;-1
334796;202105;352590;H;4930202;0;1;-1
335075;202105;352590;G;4744001;1;0;1
335318;202105;352590;F;4292802;1;0;1
335467;202105;352590;G;4732600;2;1;1
336084;202105;352590;S;9602501;1;1;0
336277;202105;352590;Q;8630503;0;2;-2
336665;202105;352590;C;2033900;1;1;0
336707;202105;352590;G;4789004;2;0;2
337338;202105;352590;I;5611201;0;1;-1
337726;202105;352590;L;6822600;0;2;-2
338367;202105;352590;H;5223100;1;0;1
338524;202105;352590;F;4399199;2;0;2
338591;202105;352590;G;4781400;1;0;1
339333;202105;352590;H;5112901;2;0;2
339335;202105;352590;G;4757100;0;1;-1
339479;202105;352590;N;8111700;7;3;4
339790;202105;352590;P;8599603;1;1;0
339825;202105;352590;N;7912100;1;0;1
339976;202105;352590;N;7911200;0;1;-1
340666;202105;352590;G;4724500;1;0;1
340805;202105;352590;G;4772500;1;0;1
341284;202105;352590;J;6319400;2;1;1
341578;202105;352590;S;9511800;1;0;1
342273;202105;352590;C;1013901;3;5;-2
342369;202105;352590;S;9601701;1;3;-2
342630;202105;352590;G;4782201;0;1;-1
343011;202105;352590;P;8599605;0;2;-2
343230;202105;352590;G;4781400;1;0;1
343625;202105;352590;S;9609208;2;0;2
343972;202105;352590;I;5611203;0;2;-2
344288;202105;352590;M;6920601;1;1;0
345353;202105;352590;I;5611201;1;1;0
345355;202105;352590;P;8511200;0;1;-1
346112;202105;352590;N;8112500;1;0;1
346419;202105;352590;C;2222600;1;0;1
346676;202105;352590;G;4772500;1;0;1
346857;202105;352590;G;4530703;1;1;0
347470;202105;352590;G;4530703;1;0;1
348189;202105;352590;M;6920601;1;0;1
348470;202105;352590;N;8219999;0;1;-1
348617;202105;352590;G;4520001;2;0;2
348742;202105;352590;G;4782202;1;0;1
349010;202105;352590;N;8291100;1;0;1
349298;202105;352590;P;8512100;1;0;1
349733;202105;352590;F;4330402;1;0;1
349854;202105;352590;N;8220200;223;82;141
350615;202105;352590;F;4399103;1;3;-2
350858;202105;352590;M;7020400;0;1;-1
351036;202105;352590;M;6920601;1;0;1
352491;202105;352590;H;4930202;1;3;-2
352763;202105;352590;G;4520002;0;3;-3
353038;202105;352590;G;4789001;0;1;-1
354977;202105;352590;G;4721102;1;0;1
355382;202105;352590;I;5611201;0;1;-1
355446;202105;352590;C;2610800;0;1;-1
355857;202105;352590;F;4330402;0;1;-1
355972;202105;352590;P;8599604;2;0;2
355973;202105;352590;P;8599604;0;1;-1
356332;202105;352590;G;4637199;0;2;-2
356867;202105;352590;G;4761001;0;1;-1
357065;202105;352590;I;5620104;0;1;-1
357473;202105;352590;I;5611201;0;1;-1
357796;202105;352590;J;6201501;0;1;-1
358166;202105;352590;P;8593700;0;1;-1
358495;202105;352590;N;8130300;1;3;-2
358612;202105;352590;G;4652400;4;0;4
358695;202105;352590;G;4744002;1;1;0
358783;202105;352590;F;4321500;0;6;-6
358881;202105;352590;F;4120400;90;92;-2
359188;202105;352590;C;2222600;0;1;-1
359910;202105;352590;C;3314702;0;1;-1
360139;202105;352590;S;9491000;1;0;1
360562;202105;352590;F;4330405;24;0;24
360928;202105;352590;G;4530703;1;0;1
361484;202105;352590;P;8511200;1;0;1
361567;202105;352590;M;7020400;1;2;-1
361679;202105;352590;N;8122200;1;0;1
361680;202105;352590;G;4530705;1;0;1
361784;202105;352590;G;4721102;8;3;5
361863;202105;352590;F;4120400;0;4;-4
361904;202105;352590;G;4721102;0;1;-1
363041;202105;352590;G;4781400;1;0;1
363249;202105;352590;I;5611203;0;1;-1
363391;202105;352590;M;7119701;2;1;1
363447;202105;352590;N;8299799;0;1;-1
363457;202105;352590;G;4789002;1;0;1
363609;202105;352590;G;4754701;1;0;1
364134;202105;352590;Q;8630599;1;1;0
364779;202105;352590;G;4642701;0;1;-1
365065;202105;352590;J;6201501;2;0;2
365342;202105;352590;H;4930202;4;4;0
365524;202105;352590;Q;8712300;5;5;0
365957;202105;352590;Q;8630504;1;1;0
366040;202105;352590;Q;8630502;0;2;-2
366381;202105;352590;I;5611201;1;0;1
366838;202105;352590;H;4930202;1;0;1
367022;202105;352590;S;9602502;1;0;1
367271;202105;352590;H;5223100;3;0;3
368188;202105;352590;P;8550302;0;1;-1
368194;202105;352590;P;8599699;1;1;0
368657;202105;352590;H;5320201;0;1;-1
369131;202105;352590;G;4721102;3;0;3
369447;202105;352590;H;4930201;3;2;1
369512;202105;352590;G;4781400;0;4;-4
369694;202105;352590;G;4752100;1;0;1
369727;202105;352590;S;9602502;1;0;1
370048;202105;352590;L;6821801;1;0;1
370790;202105;352590;G;4663000;1;0;1
371246;202105;352590;P;8512100;4;1;3
371635;202105;352590;C;3313902;0;1;-1
371786;202105;352590;G;4781400;0;1;-1
372219;202105;352590;G;4712100;1;1;0
372644;202105;352590;I;5611203;5;2;3
372665;202105;352590;G;4781400;1;2;-1
372739;202105;352590;G;4782202;0;1;-1
372813;202105;352590;S;9499500;0;2;-2
373004;202105;352590;I;5611201;0;2;-2
373116;202105;352590;I;5611201;2;0;2
373189;202105;352590;G;4723700;0;1;-1
373760;202105;352590;N;8299799;0;1;-1
374014;202105;352590;C;2949299;13;9;4
374087;202105;352590;F;4120400;0;1;-1
374097;202105;352590;H;4930202;1;0;1
374138;202105;352590;C;3314707;0;1;-1
375125;202105;352590;M;7319002;0;1;-1
375775;202105;352590;G;4772500;0;6;-6
375787;202105;352590;P;8593700;1;0;1
376079;202105;352590;G;4669999;17;8;9
376095;202105;352590;M;6920601;1;0;1
376098;202105;352590;H;5320201;0;1;-1
376316;202105;352590;G;4712100;1;1;0
376318;202105;352590;L;6821802;1;0;1
376696;202105;352590;S;9511800;1;0;1
377318;202105;352590;G;4672900;1;0;1
378008;202105;352590;J;6209100;2;0;2
378043;202105;352590;N;8220200;0;1;-1
378128;202105;352590;P;8599604;0;2;-2
378751;202105;352590;S;9602501;0;1;-1
378982;202105;352590;Q;8650004;1;0;1
379248;202105;352590;G;4712100;1;0;1
379302;202105;352590;S;9602502;1;1;0
380788;202105;352590;I;5611201;0;1;-1
380793;202105;352590;G;4721102;1;0;1
380918;202105;352590;G;4724500;0;1;-1
381341;202105;352590;H;4930202;16;16;0
381622;202105;352590;C;3312102;0;1;-1
381683;202105;352590;C;1091102;0;1;-1
382412;202105;352590;N;8121400;1;0;1
382444;202105;352590;S;9512600;0;1;-1
382717;202105;352590;G;4763601;2;0;2
382729;202105;352590;F;4120400;2;0;2
382895;202105;352590;G;4744001;0;1;-1
383119;202105;352590;F;4399199;1;0;1
383280;202105;352590;M;6920601;1;1;0
384319;202105;352590;H;4930202;4;2;2
384945;202105;352590;P;8511200;1;0;1
386690;202105;352590;G;4645101;3;3;0
387797;202105;352590;G;4741500;1;0;1
388597;202105;352590;G;4722901;1;0;1
388845;202105;352590;G;4721102;0;1;-1
388904;202105;352590;Q;8630503;1;0;1
389189;202105;352590;N;8121400;4;4;0
389654;202105;352590;G;4789099;0;1;-1
389780;202105;352590;G;4729699;1;0;1
389969;202105;352590;S;9602502;1;0;1
390286;202105;352590;M;6920601;1;2;-1
390618;202105;352590;I;5620104;1;1;0
390821;202105;352590;M;7112000;7;4;3
390998;202105;352590;P;8599603;1;0;1
391033;202105;352590;S;9609208;0;1;-1
391227;202105;352590;H;5212500;4;6;-2
391440;202105;352590;C;1412601;1;0;1
391569;202105;352590;F;4321500;0;1;-1
391611;202105;352590;G;4713004;5;2;3
392231;202105;352590;G;4774100;0;1;-1
392242;202105;352590;N;8219999;1;0;1
392351;202105;352590;C;2950600;1;1;0
392839;202105;352590;G;4752100;1;0;1
394109;202105;352590;Q;8630504;0;1;-1
394134;202105;352590;C;3314719;0;2;-2
394190;202105;352590;G;4754701;1;0;1
394517;202105;352590;G;4731800;0;2;-2
394582;202105;352590;A;139399;1;0;1
394700;202105;352590;R;9313100;1;0;1
395042;202105;352590;P;8599604;2;2;0
395123;202105;352590;M;7020400;0;1;-1
395183;202105;352590;P;8599603;1;0;1
395309;202105;352590;M;7490104;2;1;1
395477;202105;352590;P;8512100;2;1;1
395479;202105;352590;M;7120100;1;2;-1
395508;202105;352590;P;8512100;2;0;2
395743;202105;352590;G;4729699;0;1;-1
396433;202105;352590;I;5611201;1;1;0
396662;202105;352590;G;4781400;1;0;1
396798;202105;352590;Q;8630502;0;1;-1
396799;202105;352590;S;9602502;1;0;1
396874;202105;352590;N;8111700;1;0;1
397409;202105;352590;H;4930202;0;2;-2
397498;202105;352590;F;4319300;2;0;2
397571;202105;352590;F;4291000;2;1;1
397911;202105;352590;H;5250804;3;0;3
398486;202105;352590;C;3321000;2;0;2
398790;202105;352590;F;4120400;1;1;0
398942;202105;352590;N;8112500;2;0;2
399061;202105;352590;I;5620101;7;5;2
399063;202105;352590;I;5620101;0;1;-1
399064;202105;352590;I;5620101;1;2;-1
399067;202105;352590;I;5620101;1;4;-3
399474;202105;352590;G;4520002;1;0;1
400058;202105;352590;S;9529105;1;0;1
401215;202105;352590;J;6209100;0;2;-2
401482;202105;352590;H;5211701;1;1;0
401506;202105;352590;P;8511200;0;1;-1
402166;202105;352590;G;4712100;0;1;-1
402239;202105;352590;M;7490104;1;0;1
402478;202105;352590;F;4330404;0;1;-1
402495;202105;352590;P;8512100;1;2;-1
402968;202105;352590;N;8220200;178;122;56
402971;202105;352590;N;8211300;0;2;-2
403003;202105;352590;I;5611203;0;1;-1
403259;202105;352590;G;4781400;1;0;1
403400;202105;352590;I;5611204;3;0;3
403491;202105;352590;J;6209100;3;6;-3
404205;202105;352590;F;4313400;1;0;1
405176;202105;352590;F;4330404;1;0;1
405301;202105;352590;G;4772500;0;1;-1
405577;202105;352590;H;5212500;5;0;5
405669;202105;352590;I;5620104;0;1;-1
406665;202105;352590;H;4930201;48;16;32
406894;202105;352590;G;4771701;1;0;1
406934;202105;352590;P;8513900;1;0;1
407185;202105;352590;C;2330305;3;1;2
407290;202105;352590;C;3329501;1;0;1
407888;202105;352590;G;4729602;1;0;1
408047;202105;352590;G;4530703;1;0;1
408459;202105;352590;M;6920601;1;0;1
408665;202105;352590;G;4679603;1;2;-1
408953;202105;352590;N;8299799;32;19;13
409019;202105;352590;F;4399103;3;2;1
409036;202105;352590;N;8111700;5;5;0
409346;202105;352590;G;4633801;0;1;-1
409449;202105;352590;H;4930202;4;1;3
409696;202105;352590;F;4110700;1;0;1
409702;202105;352590;G;4530703;2;0;2
410561;202105;352590;N;8299799;0;1;-1
410637;202105;352590;G;4711302;2;2;0
411424;202105;352590;P;8599604;8;7;1
411692;202105;352590;G;4751201;0;1;-1
412383;202105;352590;H;4930202;0;1;-1
412501;202105;352590;G;4639701;3;3;0
412672;202105;352590;G;4530703;1;0;1
412952;202105;352590;N;8111700;4;4;0
413334;202105;352590;F;4330499;0;1;-1
413595;202105;352590;C;1095300;4;11;-7
414241;202105;352590;M;7319003;1;0;1
414278;202105;352590;G;4712100;2;1;1
414737;202105;352590;G;4753900;2;5;-3
414773;202105;352590;G;4530704;2;0;2
415536;202105;352590;G;4781400;1;0;1
415602;202105;352590;H;4930202;0;1;-1
415868;202105;352590;J;6319400;1;1;0
416539;202105;352590;H;4930202;1;0;1
417787;202105;352590;J;6209100;4;0;4
418202;202105;352590;M;7112000;0;1;-1
418361;202105;352590;I;5611201;3;0;3
418647;202105;352590;G;4753900;0;1;-1
418696;202105;352590;P;8592902;0;1;-1
418729;202105;352590;Q;8630502;0;1;-1
418826;202105;352590;F;4312600;0;3;-3
418927;202105;352590;H;4930201;1;0;1
418980;202105;352590;G;4789001;0;1;-1
419023;202105;352590;Q;8640203;1;1;0
419169;202105;352590;I;5611201;0;1;-1
419230;202105;352590;I;5611203;1;0;1
419233;202105;352590;I;5611203;1;5;-4
419234;202105;352590;I;5611203;7;3;4
419236;202105;352590;I;5611203;0;3;-3
419464;202105;352590;G;4530703;0;1;-1
419963;202105;352590;S;9602502;12;0;12
420753;202105;352590;G;4723700;1;0;1
420770;202105;352590;G;4757100;1;0;1
420822;202105;352590;C;3314707;7;2;5
420903;202105;352590;G;4781400;1;0;1
421316;202105;352590;G;4729699;0;1;-1
421399;202105;352590;Q;8630503;0;1;-1
421635;202105;352590;N;8299799;1;0;1
422174;202105;352590;F;4120400;0;1;-1
422352;202105;352590;G;4637199;2;3;-1
422641;202105;352590;J;6319400;2;1;1
423038;202105;352590;Q;8711502;2;2;0
425084;202105;352590;G;4761003;0;1;-1
425745;202105;352590;F;4292801;1;0;1
425991;202105;352590;G;4754702;1;0;1
426200;202105;352590;N;8130300;1;0;1
427111;202105;352590;M;6920601;1;0;1
427184;202105;352590;F;4330404;0;1;-1
427453;202105;352590;F;4321500;0;1;-1
428118;202105;352590;G;4633801;0;1;-1
428307;202105;352590;G;4781400;1;0;1
428764;202105;352590;I;5611201;0;1;-1
429084;202105;352590;P;8593700;1;0;1
429490;202105;352590;N;8111700;0;1;-1
431105;202105;352590;I;5611201;0;2;-2
431260;202105;352590;F;4322302;0;1;-1
431323;202105;352590;G;4511102;1;0;1
432062;202105;352590;G;4520007;0;1;-1
432318;202105;352590;G;4771701;1;0;1
432369;202105;352590;P;8511200;1;0;1
432879;202105;352590;G;4789099;1;1;0
433545;202105;352590;F;4120400;0;1;-1
433919;202105;352590;E;3812200;1;0;1
434668;202105;352590;C;1069400;1;0;1
435137;202105;352590;I;5611201;1;0;1
435160;202105;352590;I;5611201;0;1;-1
435311;202105;352590;G;4729699;0;2;-2
435742;202105;352590;H;5223100;1;0;1
436084;202105;352590;I;5611201;0;2;-2
436137;202105;352590;F;4321500;3;1;2
436149;202105;352590;G;4789099;1;0;1
436783;202105;352590;P;8599604;1;0;1
436881;202105;352590;G;4729699;1;0;1
437046;202105;352590;M;7020400;1;1;0
437092;202105;352590;Q;8690901;1;0;1
437265;202105;352590;P;8513900;1;0;1
437291;202105;352590;H;5250804;10;2;8
437583;202105;352590;G;4774100;1;0;1
437585;202105;352590;M;6911701;0;1;-1
437751;202105;352590;N;7740300;0;1;-1
437845;202105;352590;C;2869100;0;15;-15
437985;202105;352590;G;4721102;2;0;2
438071;202105;352590;Q;8630504;1;0;1
438221;202105;352590;J;6202300;1;0;1
438348;202105;352590;I;5611201;0;1;-1
438442;202105;352590;G;4759899;0;2;-2
438478;202105;352590;M;7500100;1;0;1
438620;202105;352590;S;9602501;1;0;1
438706;202105;352590;G;4724500;0;1;-1
438940;202105;352590;G;4729602;3;1;2
438950;202105;352590;G;4712100;1;1;0
439066;202105;352590;G;4724500;0;2;-2
439406;202105;352590;G;4721103;1;0;1
439823;202105;352590;P;8511200;2;0;2
439859;202105;352590;G;4781400;2;1;1
440647;202105;352590;F;4292802;1;64;-63
440861;202105;352590;I;5611203;3;3;0
440955;202105;352590;G;4520006;1;0;1
441351;202105;352590;G;4721102;1;0;1
441674;202105;352590;H;4930201;1;0;1
441983;202105;352590;G;4729699;2;0;2
442093;202105;352590;F;4322302;1;1;0
442208;202105;352590;J;6319400;1;0;1
442667;202105;352590;N;8219999;1;0;1
442717;202105;352590;M;7319003;3;6;-3
442809;202105;352590;F;4120400;0;2;-2
443109;202105;352590;G;4789001;0;1;-1
443237;202105;352590;F;4330404;0;1;-1
443461;202105;352590;G;4686902;1;0;1
443722;202105;352590;C;3314713;1;2;-1
443841;202105;352590;I;5611201;1;0;1
443864;202105;352590;J;6319400;1;0;1
443985;202105;352590;H;4930202;0;1;-1
444776;202105;352590;G;4771701;1;0;1
444777;202105;352590;G;4771701;1;1;0
444843;202105;352590;M;6920601;1;2;-1
445247;202105;352590;F;4322301;0;1;-1
445416;202105;352590;F;4330403;0;1;-1
445765;202105;352590;H;4930202;1;3;-2
445832;202105;352590;P;8593700;0;1;-1
446397;202105;352590;I;5611201;0;1;-1
447140;202105;352590;F;4321500;2;0;2
447572;202105;352590;N;8299799;2;0;2
447825;202105;352590;G;4781400;1;0;1
447826;202105;352590;G;4781400;1;0;1
448429;202105;352590;H;4930202;4;4;0
448609;202105;352590;K;6462000;0;1;-1
448734;202105;352590;G;4789004;0;2;-2
449067;202105;352590;G;4789004;0;2;-2
449137;202105;352590;N;8122200;1;1;0
449211;202105;352590;H;4930202;0;1;-1
449279;202105;352590;I;5611203;1;0;1
450374;202105;352590;N;8121400;1;0;1
450605;202105;352590;M;7112000;0;1;-1
451382;202105;352590;F;4120400;2;0;2
451900;202105;352590;G;4754701;2;0;2
451955;202105;352590;G;4783101;0;1;-1
451998;202105;352590;G;4722901;1;0;1
452138;202105;352590;G;4722901;2;0;2
452484;202105;352590;J;6201501;3;2;1
452736;202105;352590;G;4687702;0;1;-1
453107;202105;352590;G;4772500;1;0;1
453185;202105;352590;I;5611201;0;1;-1
453326;202105;352590;G;4520003;1;0;1
453362;202105;352590;N;8299799;0;1;-1
453927;202105;352590;G;4771701;1;0;1
454553;202105;352590;Q;8640202;0;2;-2
454565;202105;352590;G;4711302;1;0;1
454687;202105;352590;G;4664800;0;1;-1
454846;202105;352590;C;2539001;1;0;1
454889;202105;352590;G;4721102;1;0;1
454961;202105;352590;N;7820500;10;10;0
455062;202105;352590;I;5611201;0;1;-1
455897;202105;352590;G;4771704;1;0;1
456437;202105;352590;F;4120400;2;0;2
456557;202105;352590;I;5611203;1;0;1
457890;202105;352590;F;4330404;0;1;-1
459207;202105;352590;N;7739099;1;1;0
459390;202105;352590;H;4930202;1;1;0
459520;202105;352590;H;4930202;3;1;2
460152;202105;352590;M;7112000;0;1;-1
460218;202105;352590;J;6319400;0;1;-1
460398;202105;352590;G;4633801;0;1;-1
460556;202105;352590;G;4649410;0;1;-1
460859;202105;352590;N;8121400;1;2;-1
461321;202105;352590;H;5240101;1;1;0
461327;202105;352590;K;6622300;1;0;1
461457;202105;352590;R;9321200;1;0;1
462557;202105;352590;G;4520002;2;1;1
462985;202105;352590;Q;8640202;3;3;0
463048;202105;352590;Q;8630504;4;3;1
463288;202105;352590;G;4729699;1;1;0
465067;202105;352590;G;4789099;1;1;0
465177;202105;352590;I;5611203;0;1;-1
465453;202105;352590;I;5620104;2;1;1
465844;202105;352590;J;6110803;1;1;0
466032;202105;352590;G;4729699;0;1;-1
466264;202105;352590;I;5620104;1;1;0
466592;202105;352590;P;8599604;1;1;0
466750;202105;352590;I;5620101;3;2;1
466859;202105;352590;F;4120400;0;3;-3
467570;202105;352590;G;4729699;4;0;4
468201;202105;352590;P;8512100;0;2;-2
468228;202105;352590;G;4772500;1;0;1
468361;202105;352590;H;5212500;1;5;-4
468549;202105;352590;G;4763601;0;1;-1
468686;202105;352590;C;1053800;1;2;-1
468839;202105;352590;G;4789099;0;1;-1
468841;202105;352590;G;4752100;1;0;1
468849;202105;352590;Q;8630504;1;0;1
468853;202105;352590;G;4729699;0;1;-1
468910;202105;352590;I;5611201;2;0;2
469045;202105;352590;P;8599601;0;1;-1
470535;202105;352590;G;4753900;1;0;1
470849;202105;352590;M;7112000;8;4;4
470888;202105;352590;J;6311900;1;0;1
471315;202105;352590;M;7112000;2;0;2
471596;202105;352590;S;9603304;5;0;5
471740;202105;352590;G;4789099;1;0;1
471742;202105;352590;P;8599605;2;0;2
471938;202105;352590;J;6319400;0;1;-1
472669;202105;352590;G;4782201;1;1;0
472755;202105;352590;G;4781400;1;0;1
473034;202105;352590;P;8593700;1;0;1
473093;202105;352590;I;5611201;1;0;1
473379;202105;352590;G;4772500;5;2;3
473466;202105;352590;I;5611203;0;3;-3
474276;202105;352590;Q;8630504;1;0;1
474393;202105;352590;G;4637106;1;0;1
474441;202105;352590;I;5611203;0;1;-1
474638;202105;352590;G;4721104;1;1;0
474956;202105;352590;M;7112000;0;1;-1
475123;202105;352590;G;4789099;0;1;-1
475162;202105;352590;G;4781400;1;1;0
475163;202105;352590;G;4781400;1;0;1
475722;202105;352590;H;4930201;0;1;-1
475946;202105;352590;I;5611203;0;4;-4
476034;202105;352590;Q;8630503;0;1;-1
476104;202105;352590;H;4930201;1;0;1
476270;202105;352590;J;6209100;1;1;0
476274;202105;352590;G;4781400;0;1;-1
476299;202105;352590;P;8599699;0;1;-1
476552;202105;352590;M;7500100;0;1;-1
476931;202105;352590;Q;8630504;0;1;-1
477097;202105;352590;H;5112901;2;0;2
477260;202105;352590;N;8299799;0;2;-2
477278;202105;352590;G;4744001;1;0;1
477465;202105;352590;Q;8630502;1;0;1
477622;202105;352590;I;5611201;0;2;-2
478459;202105;352590;F;4399103;0;1;-1
478526;202105;352590;N;8111700;3;1;2
478663;202105;352590;N;8291100;0;1;-1
478834;202105;352590;I;5611201;1;0;1
479666;202105;352590;C;2521700;0;1;-1
479761;202105;352590;I;5611201;0;2;-2
479765;202105;352590;G;4755503;0;1;-1
480042;202105;352590;G;4774100;0;1;-1
480055;202105;352590;P;8512100;1;0;1
480807;202105;352590;S;9602502;1;0;1
480831;202105;352590;G;4744099;0;2;-2
480848;202105;352590;G;4511101;1;0;1
481095;202105;352590;C;1821100;1;0;1
482637;202105;352590;F;4321500;1;1;0
483325;202105;352590;J;6110803;3;1;2
483860;202105;352590;N;8291100;0;1;-1
484254;202105;352590;H;4930202;1;1;0
484309;202105;352590;G;4744003;1;1;0
484474;202105;352590;H;4930202;1;0;1
484953;202105;352590;S;9601703;22;12;10
485094;202105;352590;S;9491000;0;2;-2
485353;202105;352590;H;4930202;2;0;2
485987;202105;352590;N;7732201;2;0;2
487083;202105;352590;N;8211300;0;1;-1
487970;202105;352590;G;4784900;1;0;1
488435;202105;352590;S;9601701;0;1;-1
488504;202105;352590;S;9602501;0;2;-2
489194;202105;352590;M;7111100;4;0;4
489731;202105;352590;I;5611201;0;3;-3
489853;202105;352590;M;7112000;0;1;-1
490037;202105;352590;M;7112000;1;1;0
490685;202105;352590;C;1091100;1;0;1
490810;202105;352590;M;7112000;2;0;2
491008;202105;352590;H;4930202;1;0;1
491701;202105;352590;G;4781400;0;1;-1
491732;202105;352590;G;4711301;7;4;3
492577;202105;352590;G;4511102;2;0;2
492624;202105;352590;I;5611201;0;1;-1
493117;202105;352590;G;4774100;0;1;-1
493667;202105;352590;G;4783101;4;1;3
494282;202105;352590;G;4789004;0;1;-1
494364;202105;352590;I;5611202;0;1;-1
494452;202105;352590;M;7119701;0;1;-1
494477;202105;352590;S;9529199;1;0;1
494594;202105;352590;M;7112000;2;2;0
494992;202105;352590;G;4711302;0;2;-2
495233;202105;352590;P;8599699;2;1;1
495343;202105;352590;I;5611201;0;2;-2
495451;202105;352590;G;4783102;0;2;-2
495944;202105;352590;F;4322303;0;2;-2
496438;202105;352590;H;4930202;0;1;-1
496969;202105;352590;G;4754701;0;1;-1
496971;202105;352590;G;4713002;0;1;-1
497062;202105;352590;G;4789099;0;1;-1
497077;202105;352590;G;4520005;0;1;-1
497877;202105;352590;G;4781400;5;0;5
498374;202105;352590;P;8513900;1;1;0
499234;202105;352590;H;5320202;10;2;8
499697;202105;352590;K;6622300;4;3;1
500095;202105;352590;G;4724500;1;1;0
500161;202105;352590;L;6821802;0;1;-1
500269;202105;352590;P;8593700;2;1;1
500598;202105;352590;G;4782201;2;1;1
501165;202105;352590;K;6622300;1;0;1
501694;202105;352590;G;4729699;1;0;1
501701;202105;352590;H;4930202;1;0;1
501973;202105;352590;H;4930201;3;0;3
502179;202105;352590;N;8111700;3;2;1
502323;202105;352590;N;7810800;14;8;6
502570;202105;352590;N;8121400;2;1;1
502933;202105;352590;G;4789001;0;1;-1
503237;202105;352590;F;4299599;5;4;1
503559;202105;352590;G;4639701;2;4;-2
504220;202105;352590;N;7739099;11;12;-1
504241;202105;352590;H;5223100;0;1;-1
504594;202105;352590;G;4637199;11;2;9
505704;202105;352590;S;9602502;1;0;1
505712;202105;352590;I;5620103;0;1;-1
505713;202105;352590;I;5620103;0;1;-1
505737;202105;352590;Q;8630504;0;1;-1
506684;202105;352590;P;8599604;3;1;2
507442;202105;352590;M;7311400;1;0;1
507820;202105;352590;Q;8630503;0;2;-2
508230;202105;352590;H;4930202;0;1;-1
508540;202105;352590;G;4744005;0;1;-1
508615;202105;352590;G;4789099;1;0;1
509728;202105;352590;G;4721104;3;1;2
510167;202105;352590;M;7319002;3;1;2
511760;202105;352590;G;4724500;0;1;-1
512383;202105;352590;I;5620104;1;0;1
512646;202105;352590;M;7490104;3;1;2
512725;202105;352590;I;5611203;1;0;1
512965;202105;352590;C;1413401;0;1;-1
513335;202105;352590;S;9499500;0;4;-4
514050;202105;352590;I;5611203;1;2;-1
514272;202105;352590;C;2222600;2;0;2
514475;202105;352590;G;4713002;2;0;2
514794;202105;352590;G;4789002;1;3;-2
514927;202105;352590;G;4781400;0;1;-1
515853;202105;352590;G;4781400;0;1;-1
516123;202105;352590;P;8511200;2;0;2
516763;202105;352590;G;4781400;0;1;-1
517811;202105;352590;H;4930202;0;3;-3
517826;202105;352590;N;8219901;0;1;-1
518155;202105;352590;G;4712100;3;0;3
518388;202105;352590;G;4781400;1;0;1
518599;202105;352590;Q;8650002;1;1;0
519085;202105;352590;C;2061400;1;0;1
519103;202105;352590;G;4761003;0;1;-1
519133;202105;352590;G;4782201;1;0;1
519391;202105;352590;G;4711302;0;3;-3
519478;202105;352590;G;4520005;1;0;1
519660;202105;352590;M;7112000;3;2;1
521039;202105;352590;G;4773300;4;1;3
522483;202105;352590;G;4530703;1;0;1
522865;202105;352590;H;4930202;2;0;2
523387;202105;352590;N;8211300;1;0;1
523723;202105;352590;I;5611201;1;0;1
523849;202105;352590;N;8121400;2;1;1
525079;202105;352590;N;8219999;1;0;1
525472;202105;352590;G;4752100;1;1;0
525881;202105;352590;H;4930202;11;0;11
526436;202105;352590;P;8599699;0;1;-1
526565;202105;352590;N;8111700;3;1;2
527562;202105;352590;C;3314707;0;1;-1
528697;202105;352590;H;4930201;2;1;1
529551;202105;352590;N;8211300;2;0;2
530166;202105;352590;N;8230001;7;0;7
530167;202105;352590;N;8230001;0;3;-3
530248;202105;352590;G;4711302;4;3;1
530451;202105;352590;N;7722500;3;1;2
531489;202105;352590;I;5611201;0;5;-5
531790;202105;352590;G;4753900;37;13;24
531791;202105;352590;G;4753900;0;1;-1
531792;202105;352590;G;4753900;1;4;-3
532106;202105;352590;G;4753900;9;13;-4
532126;202105;352590;G;4753900;0;1;-1
532165;202105;352590;G;4753900;0;1;-1
532716;202105;352590;N;7820500;32;34;-2
532770;202105;352590;G;4712100;3;1;2
532771;202105;352590;G;4712100;1;0;1
533120;202105;352590;I;5620104;0;1;-1
533288;202105;352590;C;3101200;2;0;2
533458;202105;352590;C;1812100;0;1;-1
534414;202105;352590;I;5611201;1;0;1
534445;202105;352590;H;4930202;72;25;47
534937;202105;352590;G;4781400;2;4;-2
535029;202105;352590;G;4781400;14;3;11
535347;202105;352590;H;4930202;0;1;-1
536190;202105;352590;G;4752100;1;2;-1
536240;202105;352590;G;4520005;0;1;-1
536935;202105;352590;G;4781400;0;1;-1
537096;202105;352590;F;4330404;1;3;-2
537149;202105;352590;N;8020001;0;1;-1
537237;202105;352590;I;5611201;2;0;2
537238;202105;352590;I;5611201;0;1;-1
537450;202105;352590;C;2311700;12;4;8
537657;202105;352590;G;4742300;0;1;-1
537872;202105;352590;F;4330404;0;1;-1
538279;202105;352590;C;2599399;11;5;6
540181;202105;352590;G;4752100;1;0;1
540212;202105;352590;C;3321000;0;2;-2
540828;202105;352590;C;2812700;0;3;-3
540883;202105;352590;G;4752100;1;0;1
541077;202105;352590;C;2062200;1;0;1
541903;202105;352590;C;2099199;1;1;0
541942;202105;352590;I;5611203;1;0;1
542471;202105;352590;R;9313100;0;1;-1
542946;202105;352590;G;4637199;0;1;-1
543119;202105;352590;P;8513900;3;0;3
543371;202105;352590;I;5611203;1;0;1
543630;202105;352590;I;5611203;1;1;0
543883;202105;352590;F;4110700;1;3;-2
544187;202105;352590;H;5112901;0;2;-2
544285;202105;352590;L;6821801;1;0;1
545254;202105;352590;M;6920601;4;0;4
545874;202105;352590;C;2391503;1;0;1
546278;202105;352590;G;4724500;2;1;1
546327;202105;352590;G;4789005;1;1;0
546424;202105;352590;Q;8630504;1;0;1
546518;202105;352590;J;6204000;3;0;3
546633;202105;352590;Q;8711502;0;3;-3
547070;202105;352590;G;4752100;1;0;1
547629;202105;352590;G;4782201;0;1;-1
548496;202105;352590;F;4329199;1;1;0
548609;202105;352590;M;7112000;0;1;-1
549862;202105;352590;I;5611201;1;0;1
550401;202105;352590;G;4783101;1;0;1
551271;202105;352590;G;4520002;1;0;1
551977;202105;352590;G;4763602;5;0;5
552195;202105;352590;Q;8640202;4;2;2
553264;202105;352590;G;4785799;4;0;4
554529;202105;352590;H;5229099;20;5;15
555179;202105;352590;P;8593700;0;1;-1
555209;202105;352590;C;2539001;1;0;1
555491;202105;352590;Q;8630504;0;1;-1
555795;202105;352590;N;8121400;12;1;11
556036;202105;352590;H;5211702;0;1;-1
556191;202105;352590;F;4222701;1;0;1
556194;202105;352590;F;4330404;0;1;-1
556369;202105;352590;C;1721400;2;2;0
556502;202105;352590;G;4771701;0;1;-1
556602;202105;352590;G;4789004;0;2;-2
557558;202105;352590;I;5620103;1;0;1
557871;202105;352590;G;4669999;4;6;-2
557872;202105;352590;G;4669999;3;2;1
557955;202105;352590;G;4729602;2;1;1
558098;202105;352590;I;5620104;2;2;0
558200;202105;352590;G;4754702;0;1;-1
558630;202105;352590;H;4930202;1;0;1
558777;202105;352590;Q;8650003;1;0;1
559526;202105;352590;I;5611203;0;2;-2
559533;202105;352590;F;4321500;0;2;-2
560565;202105;352590;C;2599302;1;8;-7
560632;202105;352590;N;8211300;1;0;1
561028;202105;352590;G;4619200;0;1;-1
561602;202105;352590;I;5611201;2;1;1
561868;202105;352590;M;7119701;1;0;1
562234;202105;352590;G;4782201;1;1;0
562407;202105;352590;J;6319400;0;1;-1
562433;202105;352590;I;5611203;0;1;-1
562759;202105;352590;G;4722901;0;1;-1
562926;202105;352590;G;4511101;0;1;-1
562978;202105;352590;N;8211300;0;1;-1
563442;202105;352590;G;4763602;1;0;1
563939;202105;352590;I;5620101;1;2;-1
564414;202105;352590;G;4520003;1;0;1
564683;202105;352590;N;8230001;23;0;23
564684;202105;352590;N;8230001;0;2;-2
565020;202105;352590;N;8211300;5;1;4
565335;202105;352590;G;4774100;0;1;-1
565809;202105;352590;I;5611201;1;1;0
565879;202105;352590;C;3314799;0;1;-1
565882;202105;352590;G;4774100;1;0;1
565957;202105;352590;G;4781400;3;1;2
566327;202105;352590;G;4721102;0;1;-1
566937;202105;352590;N;8020001;1;0;1
566952;202105;352590;I;5611203;1;1;0
567075;202105;352590;A;121101;1;0;1
567259;202105;352590;P;8593700;0;1;-1
567465;202105;352590;F;4313400;1;1;0
567493;202105;352590;P;8512100;0;1;-1
567959;202105;352590;N;8211300;1;0;1
568261;202105;352590;G;4781400;1;0;1
568289;202105;352590;F;4120400;1;0;1
568570;202105;352590;G;4731800;3;1;2
568600;202105;352590;R;9313100;3;1;2
569350;202105;352590;N;8211300;5;0;5
569454;202105;352590;R;9319199;1;1;0
569781;202105;352590;G;4781400;1;0;1
569782;202105;352590;G;4781400;2;1;1
569886;202105;352590;P;8599604;1;1;0
570015;202105;352590;C;3319800;1;0;1
570333;202105;352590;Q;8630501;1;0;1
572350;202105;352590;H;5320201;3;1;2
572474;202105;352590;I;5611201;2;0;2
573844;202105;352590;I;5611203;0;1;-1
574259;202105;352590;J;6204000;1;0;1
574844;202105;352590;G;4781400;1;0;1
575082;202105;352590;G;4520005;1;0;1
575083;202105;352590;S;9601701;1;0;1
575105;202105;352590;H;4930201;0;1;-1
575242;202105;352590;P;8512100;1;0;1
575449;202105;352590;S;9602502;1;0;1
575835;202105;352590;K;6492100;0;1;-1
576206;202105;352590;N;8111700;0;1;-1
576758;202105;352590;I;5611201;1;4;-3
577055;202105;352590;I;5611201;0;1;-1
577496;202105;352590;N;8292000;1;0;1
577785;202105;352590;N;8111700;0;1;-1
577808;202105;352590;C;1091102;3;2;1
578759;202105;352590;N;8291100;3;19;-16
578823;202105;352590;G;4774100;3;1;2
580116;202105;352590;F;4313400;0;1;-1
580521;202105;352590;G;4723700;1;0;1
580655;202105;352590;H;4930202;9;6;3
580933;202105;352590;G;4789099;2;0;2
581040;202105;352590;G;4781400;0;4;-4
581111;202105;352590;M;7490104;2;0;2
581303;202105;352590;M;7490104;1;0;1
581599;202105;352590;G;4520001;0;1;-1
584951;202105;352590;M;7319002;2;0;2
585130;202105;352590;C;3299003;0;1;-1
585434;202105;352590;G;4771701;1;0;1
585562;202105;352590;C;3329501;1;0;1
585829;202105;352590;G;4782201;1;0;1
586431;202105;352590;G;4530703;0;2;-2
586877;202105;352590;N;8111700;52;6;46
586904;202105;352590;S;9529102;1;0;1
587032;202105;352590;F;4120400;0;2;-2
587043;202105;352590;M;7311400;0;1;-1
587109;202105;352590;F;4399103;0;1;-1
587271;202105;352590;G;4723700;0;1;-1
588376;202105;352590;G;4781400;1;0;1
589972;202105;352590;I;5611203;0;3;-3
590402;202105;352590;I;5611203;1;0;1
591214;202105;352590;G;4789099;2;0;2
591940;202105;352590;P;8599604;0;2;-2
591951;202105;352590;N;8211300;0;3;-3
592626;202105;352590;H;4930202;2;0;2
592756;202105;352590;G;4781400;3;0;3
593042;202105;352590;I;5611201;4;1;3
593326;202105;352590;M;7112000;0;2;-2
594449;202105;352590;G;4781400;1;0;1
594903;202105;352590;G;4759899;1;2;-1
595560;202105;352590;G;4744005;0;3;-3
595964;202105;352590;G;4782201;1;1;0
596114;202105;352590;H;4930201;2;0;2
596241;202105;352590;G;4783101;0;1;-1
596272;202105;352590;J;6209100;1;0;1
596551;202105;352590;S;9602502;0;1;-1
598582;202105;352590;G;4772500;0;1;-1
598805;202105;352590;M;7490104;1;1;0
599089;202105;352590;G;4686902;15;1;14
599167;202105;352590;N;8211300;1;0;1
599209;202105;352590;S;9602502;1;0;1
599255;202105;352590;J;6209100;3;4;-1
599479;202105;352590;S;9602502;2;0;2
599738;202105;352590;I;5611201;0;2;-2
599783;202105;352590;C;2539001;1;1;0
599867;202105;352590;G;4541203;0;1;-1
600815;202105;352590;I;5611204;1;3;-2
600879;202105;352590;G;4723700;1;0;1
601299;202105;352590;I;5620104;1;0;1
602697;202105;352590;P;8599604;3;2;1
603000;202105;352590;G;4637106;0;1;-1
603121;202105;352590;M;7311400;2;0;2
603292;202105;352590;F;4222701;2;0;2
603491;202105;352590;G;4713001;2;1;1
603519;202105;352590;I;5611201;0;1;-1
603773;202105;352590;I;5611201;6;1;5
605543;202105;352590;F;4399103;0;2;-2
605896;202105;352590;P;8593700;1;0;1
606568;202105;352590;P;8512100;1;0;1
606573;202105;352590;S;9602502;1;1;0
606660;202105;352590;G;4744005;1;1;0
607113;202105;352590;H;4930202;0;2;-2
608750;202105;352590;G;4744001;1;0;1
608853;202105;352590;Q;8630504;0;1;-1
609993;202105;352590;G;4772500;1;1;0
610327;202105;352590;I;5611201;0;1;-1
610659;202105;352590;G;4635499;6;2;4
611116;202105;352590;S;9602502;1;1;0
613088;202105;352590;G;4633801;1;2;-1
613375;202105;352590;S;9602502;4;0;4
613663;202105;352590;G;4637107;0;1;-1
613775;202105;352590;I;5611203;2;1;1
615723;202105;352590;G;4669999;3;0;3
615724;202105;352590;G;4669999;0;1;-1
616521;202105;352590;I;5611203;1;0;1
616664;202105;352590;K;6612603;1;0;1
617331;202105;352590;I;5611203;4;1;3
617385;202105;352590;M;7020400;1;1;0
617589;202105;352590;J;6120501;1;1;0
617644;202105;352590;J;6120501;0;2;-2
617709;202105;352590;J;6141800;2;0;2
618724;202105;352590;Q;8630504;0;1;-1
619707;202105;352590;G;4772500;2;0;2
619923;202105;352590;N;8299799;2;0;2
619992;202105;352590;I;5620103;0;1;-1
621411;202105;352590;G;4520005;1;0;1
621574;202105;352590;I;5611201;2;0;2
622228;202105;352590;S;9602502;11;1;10
622327;202105;352590;I;5510801;0;1;-1
622563;202105;352590;I;5620104;1;0;1
623435;202105;352590;C;3314708;3;0;3
623442;202105;352590;I;5611203;1;0;1
623790;202105;352590;N;8111700;6;1;5
623980;202105;352590;G;4763602;5;0;5
625441;202105;352590;G;4721102;0;1;-1
625604;202105;352590;F;4120400;2;2;0
625605;202105;352590;F;4120400;0;1;-1
625606;202105;352590;F;4120400;1;0;1
625881;202105;352590;N;8230001;1;1;0
626543;202105;352590;N;8299799;12;1;11
627360;202105;352590;H;4930202;2;1;1
627950;202105;352590;G;4721104;3;0;3
628825;202105;352590;P;8593700;3;0;3
628928;202105;352590;G;4789001;1;0;1
629193;202105;352590;F;4330499;3;0;3
629345;202105;352590;Q;8630504;3;0;3
629563;202105;352590;S;9609206;1;0;1
629604;202105;352590;I;5611203;4;1;3
629752;202105;352590;I;5611201;2;0;2
629806;202105;352590;H;4930201;2;0;2
630068;202105;352590;G;4752100;4;0;4
630642;202105;352590;I;5620104;1;0;1
630681;202105;352590;N;7733100;1;0;1
631052;202105;352590;M;7112000;0;1;-1
632882;202105;352590;I;5611203;1;0;1
632992;202105;352590;C;1062700;1;14;-13
633603;202105;352590;C;1813099;0;1;-1
634100;202105;352590;G;4774100;1;2;-1
634196;202105;352590;C;2091600;1;1;0
634736;202105;352590;G;4753900;0;1;-1
634789;202105;352590;H;4930202;3;0;3
634794;202105;352590;F;4120400;10;11;-1
634889;202105;352590;G;4772500;1;2;-1
634904;202105;352590;C;2019399;1;1;0
634979;202105;352590;C;2599399;2;1;1
634980;202105;352590;C;2599399;1;0;1
635128;202105;352590;C;2710402;20;10;10
635266;202105;352590;L;6822600;0;1;-1
635819;202105;352590;R;9312300;0;1;-1
635820;202105;352590;Q;8640202;0;1;-1
635821;202105;352590;G;4744005;0;1;-1
635822;202105;352590;N;8230001;0;1;-1
635823;202105;352590;G;4530703;0;1;-1
635824;202105;352590;S;9430800;2;0;2
635828;202105;352590;K;6550200;19;25;-6
635844;202105;352590;K;6550200;1;4;-3
635845;202105;352590;K;6550200;0;1;-1
635903;202105;352590;K;6550200;2;0;2
635938;202105;352590;F;4399105;2;1;1
635939;202105;352590;G;4530703;0;1;-1
635940;202105;352590;C;3313901;1;0;1
635942;202105;352590;R;9312300;1;1;0
635943;202105;352590;S;9420100;1;0;1
636104;202105;352590;C;2013402;4;1;3
636105;202105;352590;C;2013402;2;1;1
636608;202105;352590;I;5611201;0;3;-3
636627;202105;352590;G;4781400;0;3;-3
636751;202105;352590;G;4781400;4;0;4
636891;202105;352590;G;4781400;2;1;1
637177;202105;352590;G;4530703;1;0;1
637180;202105;352590;F;4120400;1;2;-1
637198;202105;352590;C;2862300;0;2;-2
637314;202105;352590;G;4782201;0;1;-1
637318;202105;352590;G;4782201;2;1;1
637394;202105;352590;G;4711301;12;6;6
637506;202105;352590;G;4731800;5;4;1
637630;202105;352590;G;4771701;0;1;-1
637793;202105;352590;G;4744005;0;1;-1
637885;202105;352590;C;2821601;0;29;-29
637895;202105;352590;O;8411600;17;7;10
638491;202105;352590;C;3250705;0;6;-6
638641;202105;352590;C;2063100;2;4;-2
638723;202105;352590;G;4781400;2;1;1
639079;202105;352590;I;5510801;0;1;-1
639094;202105;352590;G;4744002;1;0;1
639111;202105;352590;G;4639701;2;2;0
639132;202105;352590;G;4731800;0;1;-1
639208;202105;352590;G;4781400;0;1;-1
639358;202105;352590;L;6810202;1;0;1
639391;202105;352590;M;6920601;0;1;-1
639609;202105;352590;G;4781400;1;0;1
640052;202105;352590;G;4711302;1;0;1
640441;202105;352590;G;4711302;5;4;1
640733;202105;352590;Q;8640202;2;3;-1
640735;202105;352590;Q;8690999;2;0;2
640751;202105;352590;Q;8690999;1;1;0
640752;202105;352590;Q;8640202;2;2;0
640999;202105;352590;G;4789002;1;0;1
641245;202105;352590;G;4713004;1;2;-1
641466;202105;352590;G;4713004;1;0;1
642434;202105;352590;H;4921301;3;4;-1
642690;202105;352590;G;4731800;0;1;-1
643242;202105;352590;H;5211799;0;1;-1
643275;202105;352590;G;4731800;0;1;-1
643323;202105;352590;Q;8640205;2;1;1
643325;202105;352590;F;4120400;0;2;-2
643326;202105;352590;C;2592602;0;1;-1
643332;202105;352590;C;1412602;0;1;-1
643333;202105;352590;G;4711302;1;0;1
643334;202105;352590;G;4530703;0;1;-1
643382;202105;352590;C;2229399;1;3;-2
643501;202105;352590;M;6920601;3;2;1
643502;202105;352590;G;4712100;1;0;1
643588;202105;352590;G;4731800;1;0;1
643589;202105;352590;I;5611201;1;0;1
643621;202105;352590;G;4781400;1;0;1
643973;202105;352590;I;5620101;1;0;1
644033;202105;352590;I;5620101;1;1;0
644058;202105;352590;I;5620101;2;1;1
644117;202105;352590;I;5620101;1;1;0
644129;202105;352590;I;5620101;0;1;-1
644222;202105;352590;I;5620101;0;1;-1
644284;202105;352590;I;5620101;0;1;-1
644344;202105;352590;I;5620101;1;0;1
644427;202105;352590;I;5620101;1;1;0
644447;202105;352590;I;5620101;0;1;-1
644458;202105;352590;I;5620101;2;2;0
644588;202105;352590;G;4772500;0;1;-1
644597;202105;352590;Q;8630503;0;1;-1
644601;202105;352590;C;1813099;8;6;2
644602;202105;352590;M;6920601;0;1;-1
644603;202105;352590;G;4530703;0;1;-1
644680;202105;352590;P;8599699;19;20;-1
644713;202105;352590;G;4755503;1;0;1
645050;202105;352590;C;1330800;11;16;-5
645053;202105;352590;F;4313400;0;1;-1
645397;202105;352590;K;6550200;2;3;-1
645398;202105;352590;K;6550200;0;1;-1
645399;202105;352590;K;6550200;6;8;-2
645574;202105;352590;F;4120400;2;1;1
645575;202105;352590;G;4731800;2;2;0
645603;202105;352590;H;4921301;3;6;-3
645606;202105;352590;G;4616800;0;3;-3
645608;202105;352590;C;1623400;4;1;3
645610;202105;352590;C;1122401;0;3;-3
645611;202105;352590;G;4711302;2;1;1
645613;202105;352590;C;1112700;5;7;-2
645614;202105;352590;G;4731800;2;0;2
645615;202105;352590;G;4530703;1;0;1
645616;202105;352590;G;4731800;0;1;-1
645620;202105;352590;P;8513900;10;13;-3
645621;202105;352590;G;4511101;0;1;-1
645623;202105;352590;C;2229302;1;5;-4
645626;202105;352590;R;9312300;0;1;-1
645628;202105;352590;C;2219600;10;5;5
645630;202105;352590;G;4689399;0;1;-1
645631;202105;352590;C;1099601;2;1;1
645632;202105;352590;C;1629301;5;1;4
645637;202105;352590;G;4729699;1;1;0
645640;202105;352590;K;6622300;4;2;2
645646;202105;352590;G;4672900;0;2;-2
645647;202105;352590;H;4929902;0;2;-2
645648;202105;352590;Q;8610101;54;26;28
645649;202105;352590;G;4744005;1;0;1
645650;202105;352590;C;1091101;0;1;-1
645655;202105;352590;G;4721102;1;0;1
645657;202105;352590;R;9312300;1;0;1
645658;202105;352590;G;4731800;2;1;1
645659;202105;352590;L;6810202;0;1;-1
645660;202105;352590;G;4711302;1;0;1
645661;202105;352590;G;4711302;6;4;2
645664;202105;352590;G;4711302;2;4;-2
645666;202105;352590;G;4711302;10;5;5
645668;202105;352590;G;4731800;5;0;5
645669;202105;352590;G;4711302;9;5;4
645670;202105;352590;G;4711302;1;2;-1
645671;202105;352590;G;4711302;16;7;9
645672;202105;352590;G;4711302;8;2;6
645674;202105;352590;G;4711302;7;7;0
645675;202105;352590;G;4639701;3;1;2
645677;202105;352590;G;4711302;7;8;-1
645679;202105;352590;G;4711302;2;1;1
645681;202105;352590;G;4711302;5;9;-4
645682;202105;352590;G;4711302;2;6;-4
645683;202105;352590;G;4711302;3;7;-4
645684;202105;352590;H;4921301;1;3;-2
645685;202105;352590;C;1311100;1;2;-1
645686;202105;352590;C;1311100;13;12;1
645687;202105;352590;C;2229301;4;15;-11
645688;202105;352590;C;2229301;0;4;-4
645689;202105;352590;C;2229301;2;12;-10
645690;202105;352590;C;2229301;0;1;-1
645691;202105;352590;C;2229301;0;14;-14
645693;202105;352590;Q;8730102;0;1;-1
645694;202105;352590;Q;8730102;2;0;2
645695;202105;352590;P;8513900;2;1;1
645704;202105;352590;G;4511101;2;2;0
645705;202105;352590;R;9329899;0;2;-2
645715;202105;352590;S;9430800;1;4;-3
645716;202105;352590;C;1813099;3;3;0
645723;202105;352590;Q;8610101;1;0;1
645725;202105;352590;G;4771701;1;1;0
645728;202105;352590;Q;8610101;28;18;10
645730;202105;352590;M;6920601;0;1;-1
645731;202105;352590;C;2342702;1;1;0
645733;202105;352590;P;8511200;1;0;1
645742;202105;352590;Q;8711502;3;1;2
645749;202105;352590;H;4930202;0;1;-1
645752;202105;352590;G;4711302;5;4;1
645753;202105;352590;G;4711302;8;3;5
645754;202105;352590;G;4711302;0;3;-3
645755;202105;352590;G;4711302;2;1;1
645757;202105;352590;G;4711302;6;5;1
645759;202105;352590;M;6920601;1;0;1
645760;202105;352590;S;9420100;0;1;-1
645770;202105;352590;S;9420100;2;1;1
645771;202105;352590;S;9491000;1;0;1
645772;202105;352590;S;9491000;0;1;-1
645773;202105;352590;S;9491000;0;1;-1
645774;202105;352590;S;9491000;3;2;1
645782;202105;352590;S;9491000;0;1;-1
645784;202105;352590;S;9412099;0;1;-1
645786;202105;352590;G;4633801;6;3;3
646107;202105;352590;N;8299706;1;1;0
646108;202105;352590;G;4759899;0;1;-1
646118;202105;352590;G;4541203;1;0;1
646135;202105;352590;C;2071100;1;0;1
646393;202105;352590;C;1013901;0;4;-4
646831;202105;352590;Q;8640202;2;0;2
646832;202105;352590;Q;8640202;2;3;-1
646833;202105;352590;Q;8640202;1;0;1
646834;202105;352590;Q;8640201;1;0;1
646837;202105;352590;Q;8640202;2;0;2
646839;202105;352590;Q;8650004;0;1;-1
646841;202105;352590;Q;8640202;0;1;-1
646843;202105;352590;Q;8640202;1;0;1
646844;202105;352590;Q;8640202;0;1;-1
646845;202105;352590;H;4930202;1;0;1
646869;202105;352590;Q;8610101;9;5;4
646900;202105;352590;P;8520100;1;0;1
646901;202105;352590;S;9499500;2;0;2
646902;202105;352590;M;6920601;1;0;1
646903;202105;352590;Q;8640202;1;0;1
646915;202105;352590;G;4647801;3;2;1
646916;202105;352590;J;6311900;0;1;-1
646917;202105;352590;P;8599601;2;1;1
646992;202105;352590;C;1622699;2;1;1
647016;202105;352590;H;5112901;3;5;-2
647153;202105;352590;C;3250707;5;4;1
647242;202105;352590;C;2342702;6;2;4
647254;202105;352590;G;4661300;5;7;-2
647397;202105;352590;E;3702900;1;0;1
647399;202105;352590;N;8112500;1;0;1
647414;202105;352590;Q;8630502;0;1;-1
647415;202105;352590;N;8112500;2;0;2
647416;202105;352590;N;7820500;0;6;-6
647478;202105;352590;G;4771702;0;1;-1
647492;202105;352590;G;4744099;1;0;1
647516;202105;352590;H;4930202;4;3;1
647531;202105;352590;G;4782201;1;0;1
647691;202105;352590;H;4930202;0;1;-1
647748;202105;352590;G;4771702;5;3;2
647749;202105;352590;N;8211300;2;0;2
647845;202105;352590;G;4755502;0;1;-1
647885;202105;352590;G;4744001;0;1;-1
648091;202105;352590;G;4721102;4;3;1
648114;202105;352590;C;1031700;5;3;2
648182;202105;352590;C;2592601;0;1;-1
648447;202105;352590;G;4789004;6;2;4
648693;202105;352590;G;4669999;1;2;-1
649288;202105;352590;G;4761003;0;1;-1
649463;202105;352590;C;2222600;1;1;0
649566;202105;352590;G;4520006;2;1;1
649614;202105;352590;H;4930201;0;1;-1
649641;202105;352590;G;4781400;1;0;1
649765;202105;352590;I;5611201;1;1;0
649879;202105;352590;Q;8640203;1;1;0
649905;202105;352590;G;4530705;0;1;-1
649930;202105;352590;H;4930202;0;1;-1
649931;202105;352590;Q;8711501;1;1;0
649933;202105;352590;M;7112000;0;4;-4
649934;202105;352590;P;8513900;1;0;1
649935;202105;352590;P;8512100;0;1;-1
650001;202105;352590;G;4520001;2;1;1
650044;202105;352590;G;4712100;2;0;2
650082;202105;352590;I;5611203;0;1;-1
650198;202105;352590;C;3101200;0;1;-1
650521;202105;352590;C;3101200;0;1;-1
650603;202105;352590;G;4520001;0;1;-1
650668;202105;352590;G;4744002;0;2;-2
650675;202105;352590;G;4729699;1;1;0
650711;202105;352590;G;4712100;0;2;-2
650712;202105;352590;G;4712100;1;5;-4
650939;202105;352590;G;4530703;1;1;0
651007;202105;352590;G;4511101;14;10;4
651010;202105;352590;I;5620101;2;1;1
651026;202105;352590;G;4687702;0;1;-1
651137;202105;352590;F;4322301;0;2;-2
651190;202105;352590;S;9529199;2;0;2
651470;202105;352590;G;4789007;2;0;2
652021;202105;352590;G;4520001;1;0;1
652100;202105;352590;C;2539001;0;1;-1
652246;202105;352590;F;4313400;1;0;1
652250;202105;352590;C;2829199;1;3;-2
652403;202105;352590;C;2823200;2;1;1
652584;202105;352590;C;2449199;2;1;1
652757;202105;352590;G;4744005;1;0;1
652786;202105;352590;G;4789099;1;0;1
652951;202105;352590;G;4721102;0;1;-1
653180;202105;352590;G;4781400;0;1;-1
653456;202105;352590;G;4753900;2;2;0
653596;202105;352590;K;6550200;3;2;1
653597;202105;352590;Q;8630502;0;1;-1
653598;202105;352590;Q;8610102;3;1;2
653599;202105;352590;Q;8610101;7;3;4
653600;202105;352590;K;6550200;1;0;1
653820;202105;352590;G;4744005;1;0;1
654005;202105;352590;F;4321500;0;1;-1
654227;202105;352590;G;4530703;0;1;-1
654310;202105;352590;C;3314708;1;1;0
654346;202105;352590;G;4541205;1;1;0
654544;202105;352590;G;4774100;1;0;1
654604;202105;352590;M;7119701;1;0;1
654606;202105;352590;N;8112500;0;1;-1
654893;202105;352590;H;4930202;2;4;-2
654948;202105;352590;F;4313400;0;1;-1
655082;202105;352590;C;2099199;4;3;1
655168;202105;352590;C;2539002;0;1;-1
655173;202105;352590;C;2592602;3;4;-1
655267;202105;352590;H;4930202;7;2;5
655311;202105;352590;G;4771701;1;1;0
655444;202105;352590;K;6493000;2;0;2
655603;202105;352590;K;6422100;1;0;1
655641;202105;352590;J;6204000;3;0;3
655723;202105;352590;G;4712100;0;1;-1
655832;202105;352590;G;4530703;0;2;-2
655951;202105;352590;C;2229302;4;0;4
655956;202105;352590;I;5611203;3;0;3
656007;202105;352590;N;8121400;1;1;0
656009;202105;352590;H;5223100;2;1;1
656010;202105;352590;H;5223100;0;1;-1
656011;202105;352590;H;5223100;1;0;1
656012;202105;352590;P;8599601;0;1;-1
656013;202105;352590;N;8112500;0;2;-2
656202;202105;352590;G;4761003;2;1;1
656275;202105;352590;G;4789099;0;2;-2
656278;202105;352590;G;4763601;0;2;-2
656328;202105;352590;F;4221902;1;4;-3
656371;202105;352590;G;4771702;1;0;1
656378;202105;352590;H;4929902;8;13;-5
656402;202105;352590;I;5611201;1;3;-2
656403;202105;352590;I;5611201;0;2;-2
656441;202105;352590;G;4763601;1;1;0
656657;202105;352590;G;4635402;8;7;1
656757;202105;352590;C;2229399;7;10;-3
656784;202105;352590;H;4930202;1;3;-2
656828;202105;352590;Q;8640205;0;2;-2
656865;202105;352590;M;6920601;1;0;1
656866;202105;352590;P;8512100;1;1;0
656874;202105;352590;Q;8640202;1;0;1
656994;202105;352590;C;2944100;50;14;36
657031;202105;352590;C;1629301;5;1;4
657158;202105;352590;I;5510803;1;0;1
657304;202105;352590;K;6422100;2;0;2
657435;202105;352590;G;4520001;0;1;-1
657457;202105;352590;F;4292802;4;1;3
657534;202105;352590;G;4689399;1;1;0
657592;202105;352590;G;4721102;2;1;1
657702;202105;352590;E;3839401;2;2;0
657805;202105;352590;G;4751201;0;1;-1
657891;202105;352590;H;4930202;0;1;-1
657899;202105;352590;N;7732201;2;2;0
658129;202105;352590;G;4731800;0;2;-2
658167;202105;352590;C;1314600;1;1;0
658168;202105;352590;G;4530703;1;0;1
658691;202105;352590;G;4743100;0;1;-1
658889;202105;352590;G;4729699;1;0;1
658940;202105;352590;C;2032100;1;1;0
659066;202105;352590;M;7210000;0;3;-3
659078;202105;352590;G;4530701;1;0;1
659098;202105;352590;G;4771701;1;0;1
659208;202105;352590;C;2522500;0;22;-22
659483;202105;352590;Q;8610101;6;2;4
659526;202105;352590;C;2014200;7;2;5
659658;202105;352590;C;1412601;3;1;2
659670;202105;352590;C;2599399;1;1;0
659672;202105;352590;C;2599399;0;2;-2
659677;202105;352590;C;2812700;3;0;3
659726;202105;352590;K;6422100;0;1;-1
659884;202105;352590;K;6422100;0;1;-1
659950;202105;352590;K;6422100;1;1;0
660014;202105;352590;K;6422100;1;1;0
661006;202105;352590;K;6422100;1;0;1
661246;202105;352590;C;2222600;3;3;0
661255;202105;352590;G;4744005;0;1;-1
661423;202105;352590;Q;8690999;1;0;1
661476;202105;352590;Q;8640202;2;0;2
661564;202105;352590;C;2539002;1;0;1
661565;202105;352590;C;2539002;2;1;1
661624;202105;352590;B;810099;0;2;-2
661721;202105;352590;P;8513900;0;2;-2
661942;202105;352590;G;4633802;2;1;1
662131;202105;352590;Q;8800600;0;1;-1
662214;202105;352590;C;3104700;1;1;0
662227;202105;352590;P;8513900;0;2;-2
662229;202105;352590;Q;8711502;1;1;0
662230;202105;352590;P;8511200;0;1;-1
662279;202105;352590;I;5611201;0;3;-3
662354;202105;352590;Q;8640212;3;3;0
662363;202105;352590;Q;8640212;0;1;-1
662366;202105;352590;Q;8640212;1;0;1
662406;202105;352590;S;9491000;4;2;2
662451;202105;352590;C;2599399;7;5;2
662662;202105;352590;H;4922102;0;1;-1
662719;202105;352590;C;2949299;3;0;3
662720;202105;352590;C;2949299;2;1;1
663033;202105;352590;G;4713004;4;5;-1
663280;202105;352590;C;2591800;4;11;-7
663354;202105;352590;G;4635402;0;1;-1
663362;202105;352590;C;1122401;35;13;22
663570;202105;352590;C;1721400;3;1;2
663574;202105;352590;G;4647801;5;0;5
663619;202105;352590;C;3299002;0;1;-1
663688;202105;352590;G;4711302;6;4;2
664234;202105;352590;G;4771701;1;1;0
664275;202105;352590;G;4771701;3;3;0
664350;202105;352590;G;4771701;1;1;0
664472;202105;352590;G;4771701;0;1;-1
664650;202105;352590;C;2949299;18;7;11
664983;202105;352590;C;1095300;0;1;-1
665009;202105;352590;N;8211300;6;4;2
665137;202105;352590;C;1411801;40;39;1
665275;202105;352590;G;4771701;1;1;0
665437;202105;352590;G;4771701;2;0;2
665475;202105;352590;G;4771701;1;0;1
665614;202105;352590;G;4771701;1;1;0
665617;202105;352590;G;4771701;2;0;2
665760;202105;352590;G;4771701;1;0;1
665776;202105;352590;G;4771701;1;0;1
665840;202105;352590;G;4771701;0;1;-1
665857;202105;352590;G;4771701;1;2;-1
666054;202105;352590;G;4771701;2;1;1
666134;202105;352590;G;4771701;0;1;-1
666150;202105;352590;G;4771701;1;0;1
666229;202105;352590;G;4771701;1;0;1
666249;202105;352590;G;4771701;1;1;0
666450;202105;352590;G;4771701;1;0;1
666557;202105;352590;Q;8800600;16;17;-1
666891;202105;352590;N;8121400;17;23;-6
666979;202105;352590;G;4743100;1;0;1
667028;202105;352590;G;4782202;3;5;-2
667906;202105;352590;G;4759899;2;1;1
668038;202105;352590;C;2592601;1;1;0
668106;202105;352590;G;4637107;1;1;0
668158;202105;352590;F;4321500;3;4;-1
668837;202105;352590;P;8541400;0;1;-1
668881;202105;352590;P;8532500;6;0;6
669028;202105;352590;G;4789002;15;4;11
669040;202105;352590;C;2229301;3;7;-4
669192;202105;352590;G;4744099;1;0;1
669223;202105;352590;G;4530701;1;2;-1
669269;202105;352590;G;4755503;1;0;1
670089;202105;352590;J;6202300;1;0;1
670099;202105;352590;G;4530703;0;1;-1
670115;202105;352590;C;1096100;1;1;0
670179;202105;352590;J;6209100;1;1;0
670193;202105;352590;Q;8660700;3;10;-7
670305;202105;352590;G;4771701;0;1;-1
670358;202105;352590;F;4120400;0;1;-1
670825;202105;352590;G;4759899;2;0;2
670917;202105;352590;F;4321500;0;1;-1
670929;202105;352590;H;4930202;1;0;1
670965;202105;352590;G;4789099;0;1;-1
671068;202105;352590;C;3314710;15;5;10
671117;202105;352590;G;4731800;1;0;1
671143;202105;352590;G;4782201;0;1;-1
671301;202105;352590;N;8219999;1;0;1
672086;202105;352590;C;2592602;0;1;-1
672155;202105;352590;F;4330401;1;0;1
672183;202105;352590;G;4530701;1;0;1
672219;202105;352590;J;6202300;9;5;4
672263;202105;352590;I;5611203;0;1;-1
672458;202105;352590;B;810099;1;0;1
672465;202105;352590;G;4711302;25;33;-8
672513;202105;352590;C;1099699;3;1;2
672610;202105;352590;F;4211101;1;0;1
672650;202105;352590;N;8112500;0;2;-2
672668;202105;352590;G;4783101;0;1;-1
672727;202105;352590;G;4771702;3;0;3
673264;202105;352590;L;6822600;0;1;-1
673291;202105;352590;G;4684201;0;1;-1
673347;202105;352590;N;7739099;5;5;0
673366;202105;352590;I;5611203;2;0;2
673367;202105;352590;I;5611203;6;2;4
673984;202105;352590;N;8111700;17;33;-16
674000;202105;352590;H;5223100;0;1;-1
674001;202105;352590;P;8512100;4;1;3
674011;202105;352590;N;8112500;0;1;-1
674014;202105;352590;Q;8630504;1;0;1
674016;202105;352590;N;8121400;3;3;0
674091;202105;352590;G;4771701;1;1;0
674092;202105;352590;G;4771701;0;1;-1
674093;202105;352590;G;4771701;2;1;1
674099;202105;352590;G;4754701;1;0;1
674124;202105;352590;J;6311900;0;1;-1
674166;202105;352590;G;4744005;1;0;1
674213;202105;352590;G;4530703;0;1;-1
674359;202105;352590;C;2014200;7;5;2
674383;202105;352590;G;4711302;2;1;1
674384;202105;352590;C;1013901;1;2;-1
674455;202105;352590;F;4120400;7;2;5
674456;202105;352590;F;4120400;22;14;8
674494;202105;352590;C;2222600;0;1;-1
674592;202105;352590;F;4120400;0;1;-1
674691;202105;352590;G;4729699;5;1;4
674772;202105;352590;C;1091100;1;1;0
674860;202105;352590;C;2229399;0;1;-1
675105;202105;352590;I;5620101;1;0;1
675256;202105;352590;G;4721102;0;2;-2
675353;202105;352590;M;6920601;1;1;0
675354;202105;352590;N;8112500;0;1;-1
675443;202105;352590;I;5611201;0;1;-1
675481;202105;352590;G;4781400;1;0;1
675508;202105;352590;G;4623199;0;2;-2
675518;202105;352590;H;4930202;1;0;1
675537;202105;352590;C;2599399;0;1;-1
675649;202105;352590;C;2330302;1;0;1
675852;202105;352590;G;4530703;0;1;-1
675863;202105;352590;G;4763601;2;1;1
675901;202105;352590;G;4520007;1;0;1
675918;202105;352590;I;5611201;0;1;-1
676653;202105;352590;G;4712100;1;0;1
676751;202105;352590;J;6203100;3;4;-1
676909;202105;352590;C;2543800;7;3;4
677089;202105;352590;G;4722901;1;0;1
677253;202105;352590;G;4771702;3;2;1
678426;202105;352590;J;6110801;1;0;1
679051;202105;352590;C;2229301;9;17;-8
679360;202105;352590;N;7739099;1;2;-1
679374;202105;352590;C;3314710;1;2;-1
679465;202105;352590;G;4771701;0;1;-1
679491;202105;352590;I;5611201;0;3;-3
679529;202105;352590;S;9602502;1;1;0
679578;202105;352590;G;4744005;1;0;1
679704;202105;352590;G;4741500;2;1;1
679707;202105;352590;G;4741500;3;1;2
679709;202105;352590;G;4741500;0;1;-1
679713;202105;352590;G;4741500;4;1;3
680755;202105;352590;C;3299099;2;1;1
680993;202105;352590;G;4744005;1;0;1
681028;202105;352590;C;2822402;0;2;-2
681138;202105;352590;I;5611201;1;1;0
681147;202105;352590;G;4663000;1;0;1
681229;202105;352590;G;4761001;1;0;1
681270;202105;352590;G;4789099;0;1;-1
681285;202105;352590;G;4731800;0;1;-1
681296;202105;352590;H;4930202;0;1;-1
681299;202105;352590;G;4692300;6;7;-1
681449;202105;352590;C;1629301;3;0;3
681460;202105;352590;G;4761002;2;0;2
681605;202105;352590;J;5813100;0;1;-1
682117;202105;352590;G;4635402;0;1;-1
683387;202105;352590;H;5310502;2;1;1
683445;202105;352590;H;5310502;1;1;0
683883;202105;352590;C;1330800;1;5;-4
683927;202105;352590;R;9313100;1;0;1
684068;202105;352590;G;4711302;2;1;1
684069;202105;352590;G;4729699;1;0;1
684178;202105;352590;N;7820500;1;2;-1
684345;202105;352590;J;6201501;1;0;1
685071;202105;352590;G;4711301;7;4;3
685731;202105;352590;C;2349401;9;8;1
685737;202105;352590;N;8211300;4;1;3
686269;202105;352590;H;4930202;5;3;2
687441;202105;352590;G;4672900;5;4;1
688196;202105;352590;C;2812700;0;1;-1
688987;202105;352590;H;4930203;0;1;-1
689932;202105;352590;G;4757100;1;0;1
690902;202105;352590;H;4930202;1;2;-1
691050;202105;352590;G;4781400;1;1;0
691737;202105;352590;G;4530703;2;2;0
692240;202105;352590;G;4711301;13;8;5
694559;202105;352590;I;5510801;0;1;-1
697969;202105;352590;H;4930202;5;2;3
698407;202105;352590;G;4639701;9;1;8
699455;202105;352590;G;4679604;9;5;4
701019;202105;352590;G;4541201;3;1;2
701075;202105;352590;G;4783101;0;1;-1
706237;202105;352590;C;2330399;2;1;1
707211;202105;352590;H;4930202;11;3;8
708689;202105;352590;C;1733800;27;5;22
708690;202105;352590;C;1733800;2;3;-1
710120;202105;352590;K;6422100;1;2;-1
710180;202105;352590;K;6422100;1;0;1
710468;202105;352590;K;6422100;0;1;-1
714178;202105;352590;G;4781400;1;1;0
717018;202105;352590;I;5620101;2;1;1
718671;202105;352590;C;1733800;1;3;-2
718851;202105;352590;N;7732201;1;1;0
718901;202105;352590;N;8111700;1;0;1
719202;202105;352590;I;5620104;1;0;1
719316;202105;352590;Q;8630503;1;0;1
719382;202105;352590;C;2829199;0;1;-1
720663;202105;352590;H;5320201;1;1;0
720877;202105;352590;G;4752100;1;1;0
721180;202105;352590;C;2813500;37;71;-34
721181;202105;352590;C;2349401;72;26;46
737687;202105;352590;Q;8630504;0;2;-2
464;202011;352590;G;4751201;1;1;0
544;202011;352590;F;4329103;1;0;1
1286;202011;352590;Q;8640202;1;0;1
1716;202011;352590;G;4752100;1;0;1
2536;202011;352590;C;2599399;6;4;2
2671;202011;352590;L;6810202;1;0;1
2739;202011;352590;G;4744005;1;1;0
3226;202011;352590;C;2812700;3;3;0
3325;202011;352590;C;1091101;0;2;-2
3378;202011;352590;I;5510803;0;1;-1
3690;202011;352590;C;2222600;2;1;1
3692;202011;352590;C;2222600;4;0;4
3808;202011;352590;C;2949299;3;17;-14
3997;202011;352590;I;5611203;3;0;3
4559;202011;352590;N;8219901;1;0;1
4747;202011;352590;C;2040100;2;10;-8
4883;202011;352590;N;7739099;2;1;1
4949;202011;352590;H;4924800;0;1;-1
4982;202011;352590;N;7810800;121;44;77
5166;202011;352590;K;6622300;0;2;-2
5231;202011;352590;C;2539002;2;0;2
5437;202011;352590;G;4744001;1;0;1
5639;202011;352590;K;6423900;0;1;-1
6069;202011;352590;G;4789099;0;2;-2
6070;202011;352590;C;2512800;0;2;-2
6339;202011;352590;J;6201501;1;0;1
6515;202011;352590;C;1732000;3;0;3
6662;202011;352590;K;6436100;1;0;1
6856;202011;352590;H;4930203;0;1;-1
7007;202011;352590;G;4753900;5;0;5
7548;202011;352590;C;2229303;3;1;2
8454;202011;352590;Q;8711502;2;0;2
8499;202011;352590;G;4721102;0;1;-1
8626;202011;352590;I;5620102;0;1;-1
8726;202011;352590;P;8599601;1;1;0
9024;202011;352590;G;4672900;1;0;1
9680;202011;352590;C;1032599;0;1;-1
10272;202011;352590;G;4731800;0;1;-1
10822;202011;352590;N;8299706;1;0;1
11123;202011;352590;P;8599601;0;1;-1
11549;202011;352590;H;5211799;7;10;-3
11859;202011;352590;G;4721102;1;0;1
12080;202011;352590;G;4772500;1;0;1
12371;202011;352590;I;5611203;1;2;-1
12472;202011;352590;Q;8610101;3;1;2
12784;202011;352590;G;4633801;0;2;-2
13088;202011;352590;C;2342702;5;1;4
13625;202011;352590;J;6203100;2;0;2
13732;202011;352590;G;4771702;1;0;1
13737;202011;352590;H;4929902;6;4;2
13917;202011;352590;S;9601703;7;6;1
13921;202011;352590;S;9601703;56;39;17
14178;202011;352590;C;1413401;1;1;0
14326;202011;352590;N;8211300;0;1;-1
14633;202011;352590;C;2341900;1;1;0
14891;202011;352590;G;4616800;1;0;1
14894;202011;352590;M;6920601;1;0;1
15488;202011;352590;I;5611201;3;0;3
16052;202011;352590;G;4772500;0;1;-1
16817;202011;352590;G;4732600;0;1;-1
16848;202011;352590;I;5611203;0;1;-1
16974;202011;352590;S;9601701;1;1;0
17871;202011;352590;F;4321500;3;0;3
18132;202011;352590;C;3240099;0;1;-1
18344;202011;352590;G;4693100;14;10;4
18407;202011;352590;G;4511101;1;2;-1
19051;202011;352590;E;3701100;0;3;-3
19071;202011;352590;G;4742300;2;1;1
19156;202011;352590;G;4644301;22;24;-2
19190;202011;352590;I;5620101;1;1;0
19236;202011;352590;M;7112000;0;3;-3
19306;202011;352590;I;5611201;1;0;1
19415;202011;352590;G;4781400;1;0;1
19827;202011;352590;H;5250804;1;0;1
19926;202011;352590;P;8512100;0;1;-1
19992;202011;352590;G;4771701;0;1;-1
20040;202011;352590;N;8292000;0;1;-1
20096;202011;352590;G;4752100;0;1;-1
20105;202011;352590;I;5611201;1;0;1
20619;202011;352590;N;8299701;18;20;-2
21384;202011;352590;G;4789099;0;1;-1
21676;202011;352590;I;5611203;0;1;-1
21901;202011;352590;G;4721102;0;1;-1
22366;202011;352590;C;2229302;1;4;-3
22575;202011;352590;G;4689399;1;2;-1
23220;202011;352590;M;6920601;2;0;2
23285;202011;352590;G;4652400;2;1;1
23631;202011;352590;C;3102100;8;1;7
24071;202011;352590;H;4930203;12;10;2
24190;202011;352590;K;6622300;0;1;-1
24223;202011;352590;G;4772500;1;0;1
24405;202011;352590;N;8112500;1;0;1
24406;202011;352590;M;6920601;4;2;2
24407;202011;352590;Q;8640299;4;2;2
24412;202011;352590;F;4329104;1;4;-3
24877;202011;352590;C;2452100;0;1;-1
25203;202011;352590;C;2222600;0;1;-1
25504;202011;352590;Q;8630503;0;2;-2
25822;202011;352590;G;4530703;1;0;1
25874;202011;352590;M;6920601;0;12;-12
25928;202011;352590;M;7312200;1;0;1
26536;202011;352590;G;4744001;0;1;-1
26611;202011;352590;F;4399199;0;1;-1
26911;202011;352590;H;4930202;3;2;1
27043;202011;352590;G;4639701;1;1;0
27102;202011;352590;C;1062700;2;1;1
27159;202011;352590;M;7120100;0;2;-2
27160;202011;352590;M;6920601;0;2;-2
27512;202011;352590;K;6520100;1;0;1
27844;202011;352590;P;8511200;1;0;1
27846;202011;352590;C;1081302;10;10;0
28331;202011;352590;M;6920601;4;0;4
28357;202011;352590;G;4755502;0;1;-1
28367;202011;352590;C;2539001;1;0;1
28871;202011;352590;C;3250705;0;1;-1
29119;202011;352590;G;4721104;0;1;-1
29245;202011;352590;C;3101200;1;0;1
30183;202011;352590;N;8211300;17;9;8
30184;202011;352590;G;4634601;66;20;46
30669;202011;352590;G;4712100;0;1;-1
30799;202011;352590;N;8299799;1;0;1
30875;202011;352590;C;2219600;1;2;-1
31051;202011;352590;C;2222600;0;1;-1
31283;202011;352590;G;4763603;0;1;-1
32261;202011;352590;I;5611203;0;1;-1
32503;202011;352590;G;4744005;1;2;-1
32668;202011;352590;I;5611201;0;1;-1
32863;202011;352590;C;2949299;1;0;1
33183;202011;352590;G;4530701;2;1;1
33684;202011;352590;G;4530702;1;3;-2
33754;202011;352590;I;5510803;1;1;0
33810;202011;352590;C;2539001;1;0;1
33938;202011;352590;G;4687703;1;2;-1
34150;202011;352590;C;2599399;9;2;7
34161;202011;352590;C;1412601;1;0;1
34419;202011;352590;C;2640000;1;0;1
34493;202011;352590;C;1610202;0;2;-2
34625;202011;352590;G;4763601;2;0;2
35230;202011;352590;H;4930202;2;2;0
35342;202011;352590;C;2099199;2;0;2
35685;202011;352590;F;4313400;0;10;-10
35856;202011;352590;J;6209100;2;0;2
37018;202011;352590;I;5611201;2;0;2
37049;202011;352590;G;4639701;8;6;2
37221;202011;352590;S;9430800;2;0;2
37549;202011;352590;C;2511000;2;0;2
37625;202011;352590;R;9312300;0;1;-1
37745;202011;352590;G;4751201;0;1;-1
38060;202011;352590;C;2869100;0;1;-1
38599;202011;352590;G;4763602;1;2;-1
38994;202011;352590;C;1081302;5;10;-5
39245;202011;352590;N;8011101;2;2;0
39591;202011;352590;N;7820500;2;0;2
40201;202011;352590;K;6424703;1;0;1
41004;202011;352590;G;4781400;2;0;2
41206;202011;352590;M;6920601;0;1;-1
41215;202011;352590;G;4511101;4;3;1
41254;202011;352590;H;5221400;39;34;5
41378;202011;352590;C;2941700;7;1;6
41379;202011;352590;C;2941700;1;1;0
41392;202011;352590;R;9313100;1;0;1
41462;202011;352590;I;5510801;0;1;-1
42094;202011;352590;G;4731800;1;0;1
42288;202011;352590;G;4619200;0;1;-1
42694;202011;352590;C;2751100;2;2;0
43100;202011;352590;C;2229302;3;0;3
43151;202011;352590;Q;8630502;0;1;-1
43428;202011;352590;J;6110801;0;2;-2
44150;202011;352590;C;1099604;4;1;3
44930;202011;352590;G;4731800;0;2;-2
45440;202011;352590;G;4541205;1;0;1
45652;202011;352590;M;6920601;0;1;-1
46355;202011;352590;N;7820500;2;2;0
46418;202011;352590;G;4511101;4;5;-1
46732;202011;352590;G;4511101;1;2;-1
46751;202011;352590;Q;8640205;1;1;0
46903;202011;352590;G;4511102;0;1;-1
46960;202011;352590;C;2219600;1;1;0
47543;202011;352590;G;4721104;1;1;0
47721;202011;352590;G;4744005;0;1;-1
47806;202011;352590;C;2091600;5;3;2
47807;202011;352590;G;4684299;0;1;-1
47971;202011;352590;P;8512100;0;2;-2
48031;202011;352590;G;4772500;3;0;3
48537;202011;352590;G;4781400;4;0;4
48617;202011;352590;H;4930202;10;14;-4
48642;202011;352590;Q;8800600;1;0;1
48928;202011;352590;C;2391503;3;1;2
49045;202011;352590;H;5211799;68;7;61
49224;202011;352590;G;4731800;0;1;-1
49235;202011;352590;C;2949299;1;1;0
49246;202011;352590;N;8211300;6;4;2
49851;202011;352590;C;2532201;0;2;-2
50457;202011;352590;I;5620103;3;1;2
50516;202011;352590;H;4930202;0;2;-2
50811;202011;352590;C;1013901;22;23;-1
51370;202011;352590;G;4754701;1;0;1
51511;202011;352590;H;5223100;0;3;-3
51577;202011;352590;P;8599602;1;0;1
51974;202011;352590;G;4789099;0;1;-1
52389;202011;352590;G;4754702;0;1;-1
52894;202011;352590;G;4713001;2;0;2
53000;202011;352590;G;4679601;5;0;5
53142;202011;352590;C;3312103;1;0;1
54056;202011;352590;H;4930202;20;10;10
54332;202011;352590;G;4789001;2;0;2
54338;202011;352590;G;4789001;2;0;2
54339;202011;352590;G;4789001;0;2;-2
54453;202011;352590;M;7119701;1;0;1
54458;202011;352590;G;4789099;0;1;-1
54572;202011;352590;N;8121400;30;25;5
54911;202011;352590;C;2222600;6;8;-2
55265;202011;352590;G;4771701;1;0;1
55413;202011;352590;G;4752100;4;4;0
55414;202011;352590;G;4752100;2;1;1
55454;202011;352590;I;5611201;0;1;-1
55660;202011;352590;G;4724500;0;1;-1
55661;202011;352590;G;4724500;0;1;-1
55790;202011;352590;G;4771701;0;1;-1
56020;202011;352590;C;2539001;3;1;2
56302;202011;352590;G;4639701;1;0;1
56387;202011;352590;K;6622300;1;0;1
56645;202011;352590;G;4744002;0;1;-1
56937;202011;352590;F;4330499;1;0;1
57986;202011;352590;I;5612100;2;0;2
58051;202011;352590;H;5229002;0;4;-4
58502;202011;352590;G;4646001;7;7;0
59076;202011;352590;I;5620101;1;1;0
59098;202011;352590;Q;8720401;29;1;28
59102;202011;352590;C;1623400;1;0;1
59247;202011;352590;G;4772500;3;0;3
59332;202011;352590;H;4930203;1;1;0
60044;202011;352590;I;5611201;0;1;-1
60594;202011;352590;I;5611201;0;1;-1
62002;202011;352590;G;4744099;2;1;1
62048;202011;352590;G;4781400;1;0;1
62397;202011;352590;G;4754701;1;0;1
62900;202011;352590;G;4711302;1;0;1
63071;202011;352590;G;4711302;0;2;-2
63523;202011;352590;F;4391600;5;0;5
64426;202011;352590;G;4520005;2;0;2
64618;202011;352590;C;2539002;2;2;0
64772;202011;352590;H;4930202;2;2;0
64856;202011;352590;G;4520001;2;0;2
65451;202011;352590;E;3600601;2;8;-6
65470;202011;352590;I;5611203;4;1;3
65783;202011;352590;C;1093702;0;5;-5
66165;202011;352590;N;7820500;171;322;-151
66232;202011;352590;F;4120400;2;0;2
66236;202011;352590;N;8211300;1;1;0
67470;202011;352590;G;4744001;1;0;1
67504;202011;352590;Q;8800600;0;1;-1
67655;202011;352590;G;4751201;0;2;-2
67717;202011;352590;G;4724500;0;1;-1
68216;202011;352590;C;3314703;1;0;1
68519;202011;352590;C;2829199;0;1;-1
68730;202011;352590;N;7820500;638;473;165
69277;202011;352590;C;1062700;0;1;-1
69660;202011;352590;G;4754701;0;1;-1
69835;202011;352590;P;8599699;0;1;-1
70174;202011;352590;P;8599699;1;1;0
70175;202011;352590;P;8599699;0;1;-1
70638;202011;352590;I;5611203;1;0;1
71097;202011;352590;G;4633801;0;3;-3
71374;202011;352590;N;8129000;33;20;13
71386;202011;352590;G;4781400;0;1;-1
71426;202011;352590;G;4744005;1;0;1
71480;202011;352590;C;2222600;1;5;-4
72190;202011;352590;G;4789099;0;2;-2
72228;202011;352590;H;4930202;24;3;21
72229;202011;352590;H;4930202;20;4;16
72492;202011;352590;H;5120000;1;1;0
72494;202011;352590;H;5211701;1;0;1
72496;202011;352590;H;5120000;0;1;-1
72563;202011;352590;K;6622300;0;1;-1
72604;202011;352590;N;8122200;1;0;1
73245;202011;352590;I;5611203;2;1;1
73247;202011;352590;G;4637106;4;7;-3
73270;202011;352590;G;4774100;1;0;1
74668;202011;352590;I;5510803;2;0;2
75544;202011;352590;G;4649499;3;0;3
75704;202011;352590;Q;8630503;1;2;-1
75968;202011;352590;N;8211300;0;1;-1
76204;202011;352590;N;8291100;0;2;-2
76688;202011;352590;G;4781400;1;0;1
76703;202011;352590;G;4530703;4;1;3
76834;202011;352590;G;4774100;0;1;-1
77216;202011;352590;I;5611201;10;10;0
77218;202011;352590;I;5611201;12;3;9
77477;202011;352590;N;8299799;9;5;4
77536;202011;352590;Q;8711502;3;3;0
77811;202011;352590;J;6203100;0;1;-1
77920;202011;352590;G;4661300;0;1;-1
78020;202011;352590;N;7820500;0;2;-2
78045;202011;352590;G;4742300;2;0;2
78424;202011;352590;F;4120400;3;0;3
78470;202011;352590;F;4120400;5;1;4
78685;202011;352590;D;3514000;0;1;-1
78711;202011;352590;H;4930202;3;0;3
78872;202011;352590;Q;8650004;1;1;0
78982;202011;352590;K;6622300;1;0;1
79708;202011;352590;H;4930202;11;0;11
80071;202011;352590;H;4930201;1;3;-2
80296;202011;352590;G;4530703;1;0;1
80655;202011;352590;H;5112901;1;1;0
81016;202011;352590;G;4520001;2;0;2
81286;202011;352590;C;2945000;2;0;2
81567;202011;352590;I;5510803;2;1;1
81712;202011;352590;P;8532500;0;1;-1
81801;202011;352590;P;8599699;6;3;3
83806;202011;352590;G;4782202;1;0;1
83811;202011;352590;G;4782202;1;0;1
84025;202011;352590;C;3314721;14;1;13
84439;202011;352590;G;4511101;1;0;1
84657;202011;352590;N;7711000;1;0;1
84892;202011;352590;F;4299599;28;0;28
84895;202011;352590;F;4299599;2;13;-11
85326;202011;352590;Q;8640210;0;1;-1
85327;202011;352590;Q;8640210;0;1;-1
85524;202011;352590;M;6920601;2;0;2
85638;202011;352590;G;4743100;1;2;-1
85827;202011;352590;G;4731800;5;2;3
85881;202011;352590;C;2599399;1;0;1
85896;202011;352590;G;4639701;6;8;-2
86442;202011;352590;G;4731800;1;0;1
86843;202011;352590;C;2869100;1;0;1
87055;202011;352590;I;5611201;0;1;-1
87083;202011;352590;H;5250804;2;0;2
87700;202011;352590;N;8299799;2;5;-3
88567;202011;352590;C;1099699;31;0;31
89607;202011;352590;P;8512100;0;2;-2
89755;202011;352590;H;5250801;0;1;-1
89878;202011;352590;I;5611203;1;1;0
90067;202011;352590;G;4789007;1;0;1
90349;202011;352590;K;6622300;0;2;-2
90352;202011;352590;M;6920601;1;0;1
90380;202011;352590;G;4731800;0;1;-1
90410;202011;352590;H;5250804;45;26;19
90673;202011;352590;G;4789099;0;2;-2
90898;202011;352590;C;3299004;2;0;2
91323;202011;352590;G;4731800;1;1;0
92168;202011;352590;J;6203100;0;1;-1
92228;202011;352590;I;5611201;1;0;1
92241;202011;352590;H;4930202;0;1;-1
93321;202011;352590;Q;8630504;1;0;1
93390;202011;352590;G;4520001;1;0;1
93912;202011;352590;Q;8650099;11;10;1
94115;202011;352590;G;4789007;8;1;7
94134;202011;352590;C;2949299;0;1;-1
94164;202011;352590;G;4686902;0;1;-1
94201;202011;352590;G;4753900;1;1;0
94610;202011;352590;I;5611201;0;3;-3
94615;202011;352590;F;4120400;2;0;2
94940;202011;352590;H;5223100;1;0;1
94998;202011;352590;J;6202300;0;1;-1
95780;202011;352590;N;8299706;1;0;1
95931;202011;352590;K;6612603;0;1;-1
96318;202011;352590;H;4930201;8;2;6
97335;202011;352590;C;2222600;2;3;-1
97430;202011;352590;G;4724500;19;4;15
97928;202011;352590;R;9313100;1;0;1
98081;202011;352590;G;4712100;1;1;0
98776;202011;352590;G;4511101;1;1;0
99250;202011;352590;Q;8640210;1;0;1
100020;202011;352590;G;4712100;0;1;-1
100042;202011;352590;Q;8630501;0;2;-2
100191;202011;352590;C;1412601;1;0;1
100237;202011;352590;G;4731800;0;1;-1
100243;202011;352590;F;4299599;0;3;-3
100327;202011;352590;C;2229303;0;1;-1
100598;202011;352590;G;4789099;1;0;1
100936;202011;352590;G;4520002;0;1;-1
101024;202011;352590;S;9430800;3;2;1
101515;202011;352590;S;9430800;1;2;-1
102212;202011;352590;N;8299706;1;0;1
102237;202011;352590;Q;8630504;0;1;-1
102447;202011;352590;G;4729699;2;3;-1
102782;202011;352590;H;4930202;1;0;1
103458;202011;352590;R;9311500;1;0;1
103992;202011;352590;G;4729699;1;0;1
103993;202011;352590;I;5611201;0;1;-1
104505;202011;352590;G;4530703;2;3;-1
104527;202011;352590;F;4110700;1;0;1
104534;202011;352590;C;2950600;0;1;-1
104688;202011;352590;P;8599602;0;1;-1
104798;202011;352590;H;4930202;1;0;1
105006;202011;352590;G;4782201;16;5;11
105034;202011;352590;F;4313400;12;3;9
105051;202011;352590;G;4784900;0;1;-1
105053;202011;352590;G;4724500;0;1;-1
105205;202011;352590;G;4789099;1;0;1
105508;202011;352590;F;4313400;3;11;-8
105577;202011;352590;P;8512100;0;1;-1
105658;202011;352590;G;4511101;3;2;1
106023;202011;352590;F;4330404;1;1;0
106191;202011;352590;P;8513900;1;0;1
106246;202011;352590;H;4929902;0;1;-1
107217;202011;352590;G;4789001;1;0;1
107563;202011;352590;J;6201501;2;0;2
107935;202011;352590;M;6920601;1;0;1
108418;202011;352590;G;4729699;1;1;0
108845;202011;352590;G;4722901;0;1;-1
108906;202011;352590;N;7820500;131;93;38
109719;202011;352590;F;4399105;3;0;3
109788;202011;352590;C;2592601;0;1;-1
109935;202011;352590;Q;8712300;4;0;4
110105;202011;352590;G;4781400;1;1;0
110381;202011;352590;H;5240199;1;1;0
110561;202011;352590;J;6202300;3;1;2
111151;202011;352590;G;4755502;2;0;2
111152;202011;352590;G;4755502;0;1;-1
111158;202011;352590;C;2599399;0;15;-15
111687;202011;352590;Q;8650099;0;1;-1
111898;202011;352590;G;4731800;2;0;2
112012;202011;352590;G;4752100;1;0;1
112436;202011;352590;M;7311400;1;0;1
112871;202011;352590;G;4639701;1;0;1
112990;202011;352590;G;4712100;1;0;1
113491;202011;352590;P;8511200;1;0;1
114133;202011;352590;G;4774100;2;0;2
114404;202011;352590;N;8299799;3;5;-2
114533;202011;352590;I;5611203;1;0;1
114600;202011;352590;J;6201501;1;0;1
114609;202011;352590;C;2222600;0;6;-6
114719;202011;352590;G;4744003;0;1;-1
114771;202011;352590;N;8299799;2;1;1
115878;202011;352590;G;4693100;2;2;0
116041;202011;352590;G;4711302;11;15;-4
116071;202011;352590;G;4774100;2;0;2
116189;202011;352590;G;4753900;1;0;1
116192;202011;352590;Q;8640204;0;1;-1
116305;202011;352590;G;4649499;1;1;0
116364;202011;352590;G;4771701;1;1;0
116371;202011;352590;G;4721104;1;0;1
117962;202011;352590;C;2823200;1;1;0
118177;202011;352590;C;2825900;1;0;1
118241;202011;352590;G;4772500;3;0;3
118249;202011;352590;G;4772500;3;0;3
118398;202011;352590;H;4929902;0;1;-1
118588;202011;352590;M;7500100;0;1;-1
118927;202011;352590;G;4781400;1;1;0
119165;202011;352590;G;4639701;2;0;2
119307;202011;352590;C;2399101;0;2;-2
119309;202011;352590;C;2539001;0;1;-1
119543;202011;352590;C;3250701;0;1;-1
119594;202011;352590;P;8512100;0;1;-1
119777;202011;352590;G;4759899;6;4;2
119779;202011;352590;G;4759899;1;0;1
119786;202011;352590;G;4649499;2;0;2
119828;202011;352590;M;6920601;0;1;-1
120051;202011;352590;G;4520001;1;1;0
120501;202011;352590;G;4753900;0;1;-1
120693;202011;352590;H;4930203;6;2;4
120784;202011;352590;N;8299799;0;5;-5
121185;202011;352590;C;1099699;8;5;3
121442;202011;352590;G;4645101;3;0;3
121867;202011;352590;C;1091102;1;0;1
122247;202011;352590;G;4711302;12;6;6
122388;202011;352590;G;4711301;29;12;17
122579;202011;352590;G;4711302;0;1;-1
122624;202011;352590;G;4511102;1;0;1
122645;202011;352590;F;4322302;1;2;-1
123096;202011;352590;C;2829199;2;3;-1
123148;202011;352590;I;5611201;1;0;1
123433;202011;352590;P;8531700;0;2;-2
124487;202011;352590;G;4530703;1;1;0
124629;202011;352590;C;2591800;4;3;1
125291;202011;352590;K;6424703;1;0;1
125336;202011;352590;G;4761001;3;1;2
125465;202011;352590;G;4530703;1;0;1
127080;202011;352590;G;4530703;1;0;1
127201;202011;352590;F;4313400;2;10;-8
127216;202011;352590;G;4721102;1;0;1
127266;202011;352590;G;4753900;1;0;1
127971;202011;352590;C;1013902;3;4;-1
129154;202011;352590;G;4712100;4;2;2
129325;202011;352590;G;4789002;3;5;-2
129778;202011;352590;G;4763602;2;2;0
130171;202011;352590;H;4930202;11;7;4
131191;202011;352590;J;6209100;0;1;-1
131963;202011;352590;I;5611201;2;0;2
132639;202011;352590;N;8299799;28;11;17
133385;202011;352590;G;4781400;3;0;3
134230;202011;352590;G;4687702;0;1;-1
134432;202011;352590;C;2710402;3;0;3
134596;202011;352590;G;4520001;1;1;0
134634;202011;352590;G;4633801;1;0;1
134659;202011;352590;G;4711302;11;7;4
134991;202011;352590;H;4930202;0;1;-1
135352;202011;352590;H;4930202;0;1;-1
136240;202011;352590;G;4731800;1;1;0
136372;202011;352590;I;5611201;0;2;-2
136570;202011;352590;N;8211300;0;1;-1
136672;202011;352590;N;8011101;17;17;0
136945;202011;352590;G;4649410;1;0;1
137325;202011;352590;G;4771701;1;0;1
137326;202011;352590;G;4771701;0;1;-1
137484;202011;352590;K;6424703;1;0;1
137934;202011;352590;H;4930202;0;2;-2
138347;202011;352590;N;8211300;4;2;2
138511;202011;352590;G;4729699;1;1;0
139092;202011;352590;G;4781400;0;3;-3
139646;202011;352590;C;2790299;17;14;3
139651;202011;352590;G;4530703;1;1;0
139708;202011;352590;N;7820500;0;1;-1
140580;202011;352590;E;3701100;1;3;-2
140636;202011;352590;C;1053800;2;1;1
140785;202011;352590;C;3250706;0;2;-2
140820;202011;352590;Q;8630501;9;5;4
140825;202011;352590;G;4774100;1;0;1
141121;202011;352590;G;4722901;2;0;2
141122;202011;352590;P;8511200;0;1;-1
141214;202011;352590;G;4633801;5;11;-6
142599;202011;352590;M;7120100;1;1;0
143390;202011;352590;M;7120100;0;1;-1
143394;202011;352590;N;8111700;2;2;0
143944;202011;352590;F;4299599;0;1;-1
143958;202011;352590;F;4299599;1;3;-2
144023;202011;352590;G;4687703;1;0;1
144031;202011;352590;G;4685100;1;1;0
144148;202011;352590;G;4713002;1;0;1
144487;202011;352590;G;4731800;1;1;0
144708;202011;352590;C;2790299;2;0;2
144935;202011;352590;S;9430800;5;13;-8
144944;202011;352590;G;4530703;0;1;-1
145559;202011;352590;G;4771701;4;2;2
145705;202011;352590;I;5620101;2;0;2
145762;202011;352590;I;5611201;1;2;-1
145772;202011;352590;G;4744003;0;1;-1
146363;202011;352590;G;4652400;1;0;1
146384;202011;352590;H;4930202;0;2;-2
146782;202011;352590;I;5611201;1;1;0
146915;202011;352590;G;4744003;1;0;1
147375;202011;352590;H;4930202;1;1;0
147696;202011;352590;C;2219600;2;0;2
147731;202011;352590;G;4722901;0;1;-1
147827;202011;352590;Q;8630503;0;1;-1
147829;202011;352590;G;4781400;1;0;1
148098;202011;352590;G;4741500;0;2;-2
148099;202011;352590;G;4741500;1;0;1
148100;202011;352590;G;4741500;1;1;0
148121;202011;352590;G;4731800;1;2;-1
148155;202011;352590;N;8211300;3;0;3
148392;202011;352590;C;2029100;18;4;14
148419;202011;352590;G;4635402;4;11;-7
148449;202011;352590;G;4744002;0;1;-1
148924;202011;352590;G;4520001;1;0;1
149850;202011;352590;H;4930202;2;3;-1
150032;202011;352590;M;6920601;1;2;-1
150146;202011;352590;G;4772500;0;2;-2
150345;202011;352590;R;9313100;2;0;2
150398;202011;352590;R;9313100;1;1;0
150515;202011;352590;G;4520001;1;0;1
150525;202011;352590;G;4754703;4;0;4
151153;202011;352590;G;4617600;0;2;-2
151370;202011;352590;H;4923002;1;0;1
151913;202011;352590;N;8112500;1;0;1
151921;202011;352590;G;4721102;3;1;2
151979;202011;352590;G;4731800;1;1;0
152022;202011;352590;G;4722901;2;0;2
152538;202011;352590;H;4929902;0;1;-1
152615;202011;352590;F;4313400;2;0;2
153526;202011;352590;G;4771702;1;2;-1
153651;202011;352590;J;6203100;0;1;-1
153664;202011;352590;G;4761003;0;1;-1
153667;202011;352590;H;4930202;1;0;1
153883;202011;352590;C;2543800;0;2;-2
154650;202011;352590;N;8112500;0;2;-2
154678;202011;352590;C;1053800;3;2;1
154706;202011;352590;S;9499500;1;0;1
156044;202011;352590;G;4712100;1;1;0
156138;202011;352590;C;1099601;7;1;6
156225;202011;352590;I;5611201;0;1;-1
156286;202011;352590;Q;8630503;0;2;-2
156537;202011;352590;C;1042200;3;1;2
156914;202011;352590;Q;8650004;0;1;-1
157135;202011;352590;H;4930202;3;1;2
157294;202011;352590;N;8122200;0;1;-1
157331;202011;352590;G;4712100;0;1;-1
157389;202011;352590;G;4789099;2;0;2
157469;202011;352590;G;4781400;1;0;1
157722;202011;352590;H;5212500;4;0;4
158278;202011;352590;K;6619399;2;1;1
158847;202011;352590;N;8219901;0;1;-1
158880;202011;352590;C;1062700;0;1;-1
159361;202011;352590;G;4511101;1;1;0
159644;202011;352590;M;6920601;1;0;1
159729;202011;352590;M;7112000;0;2;-2
160320;202011;352590;I;5611203;1;0;1
160324;202011;352590;I;5611203;2;0;2
160939;202011;352590;N;8130300;2;0;2
161415;202011;352590;G;4782201;1;0;1
161416;202011;352590;G;4782201;1;0;1
161839;202011;352590;G;4729699;1;0;1
162312;202011;352590;N;7732201;1;0;1
162748;202011;352590;G;4530703;1;0;1
162945;202011;352590;G;4753900;10;0;10
162946;202011;352590;G;4753900;1;0;1
163505;202011;352590;G;4789002;0;1;-1
163797;202011;352590;G;4639701;1;1;0
164350;202011;352590;J;6209100;0;1;-1
164654;202011;352590;G;4781400;1;0;1
164901;202011;352590;G;4731800;0;1;-1
165345;202011;352590;G;4744001;1;1;0
165476;202011;352590;N;8299799;1;1;0
165714;202011;352590;G;4755502;1;0;1
166042;202011;352590;C;2621300;5;22;-17
166043;202011;352590;C;2632900;107;48;59
166096;202011;352590;N;8299799;102;94;8
166700;202011;352590;G;4520001;1;0;1
166838;202011;352590;H;5239799;0;1;-1
166918;202011;352590;G;4729699;0;1;-1
167208;202011;352590;Q;8630503;1;1;0
167606;202011;352590;C;2229303;1;0;1
167701;202011;352590;H;5212500;7;9;-2
167869;202011;352590;G;4761001;0;1;-1
168055;202011;352590;H;4930201;1;0;1
168155;202011;352590;M;7311400;1;0;1
168186;202011;352590;G;4729699;1;1;0
168456;202011;352590;G;4723700;1;0;1
168461;202011;352590;M;6920601;2;1;1
168826;202011;352590;G;4752100;0;1;-1
168836;202011;352590;G;4752100;1;0;1
169197;202011;352590;G;4731800;1;0;1
169220;202011;352590;I;5611203;1;0;1
169521;202011;352590;G;4771701;0;1;-1
169523;202011;352590;I;5611201;0;1;-1
169605;202011;352590;F;4321500;1;1;0
169679;202011;352590;N;7732201;2;0;2
170164;202011;352590;N;7733100;0;1;-1
170386;202011;352590;P;8513900;1;1;0
170480;202011;352590;C;3313999;0;1;-1
170490;202011;352590;H;4930202;0;1;-1
170987;202011;352590;J;6201501;0;2;-2
171609;202011;352590;H;4930202;2;0;2
171851;202011;352590;F;4399199;3;0;3
171959;202011;352590;K;6491300;0;1;-1
172777;202011;352590;Q;8630501;0;1;-1
173139;202011;352590;J;5829800;2;1;1
173291;202011;352590;F;4120400;3;2;1
173711;202011;352590;G;4530703;3;6;-3
174176;202011;352590;G;4744001;4;2;2
174914;202011;352590;G;4763603;1;0;1
175498;202011;352590;F;4213800;2;7;-5
175953;202011;352590;C;2840200;3;0;3
175964;202011;352590;G;4729699;1;1;0
176255;202011;352590;K;6424703;1;0;1
176408;202011;352590;H;5212500;3;10;-7
176509;202011;352590;N;8111700;3;11;-8
176547;202011;352590;G;4721104;0;2;-2
177566;202011;352590;N;7820500;3;7;-4
177620;202011;352590;G;4511101;1;0;1
178037;202011;352590;H;4930202;2;0;2
178798;202011;352590;Q;8640212;0;1;-1
179075;202011;352590;G;4782201;2;1;1
179181;202011;352590;M;6920601;0;2;-2
179248;202011;352590;Q;8630503;1;0;1
179807;202011;352590;G;4729699;1;2;-1
180351;202011;352590;F;4110700;1;1;0
180549;202011;352590;G;4789002;1;0;1
180954;202011;352590;G;4774100;0;1;-1
181316;202011;352590;G;4744001;1;0;1
181509;202011;352590;H;4930202;0;1;-1
181663;202011;352590;F;4222701;11;0;11
181664;202011;352590;F;4222701;0;1;-1
182107;202011;352590;G;4686902;5;7;-2
182577;202011;352590;Q;8711502;0;1;-1
182625;202011;352590;E;3832700;3;0;3
182968;202011;352590;I;5611201;3;3;0
182994;202011;352590;I;5611201;3;1;2
183003;202011;352590;I;5611201;6;3;3
183168;202011;352590;G;4759899;2;1;1
183373;202011;352590;C;2222600;6;3;3
183605;202011;352590;G;4781400;0;1;-1
184137;202011;352590;G;4511101;9;2;7
184974;202011;352590;G;4789099;0;1;-1
185323;202011;352590;N;7740300;0;1;-1
185444;202011;352590;G;4774100;0;1;-1
185824;202011;352590;N;8111700;1;0;1
186259;202011;352590;G;4754701;0;3;-3
186266;202011;352590;G;4754701;3;0;3
186722;202011;352590;H;4930201;3;0;3
186723;202011;352590;H;4930201;0;1;-1
187205;202011;352590;H;4930203;2;0;2
187633;202011;352590;I;5611201;7;3;4
188122;202011;352590;I;5611201;1;0;1
188260;202011;352590;I;5611203;4;1;3
188451;202011;352590;I;5611201;1;0;1
189177;202011;352590;G;4759899;1;1;0
189681;202011;352590;G;4789005;3;1;2
189892;202011;352590;F;4330404;1;0;1
189895;202011;352590;N;7830200;16;19;-3
190144;202011;352590;G;4754701;0;1;-1
190339;202011;352590;M;6920601;2;0;2
190410;202011;352590;G;4782201;0;1;-1
191039;202011;352590;M;7112000;1;0;1
191040;202011;352590;J;6204000;5;4;1
192078;202011;352590;G;4530703;1;0;1
193139;202011;352590;F;4321500;1;1;0
193478;202011;352590;I;5611201;4;4;0
194237;202011;352590;N;8011101;0;1;-1
194477;202011;352590;G;4663000;1;0;1
194512;202011;352590;G;4713002;2;0;2
194583;202011;352590;I;5611201;1;0;1
194823;202011;352590;G;4711302;1;0;1
194841;202011;352590;G;4511102;0;1;-1
194849;202011;352590;G;4511101;2;0;2
195263;202011;352590;N;7739099;1;0;1
195519;202011;352590;I;5620101;3;0;3
195691;202011;352590;Q;8610101;14;9;5
196218;202011;352590;G;4686902;2;0;2
196281;202011;352590;G;4724500;13;14;-1
196282;202011;352590;G;4633801;2;3;-1
196283;202011;352590;G;4724500;14;16;-2
196363;202011;352590;I;5611201;0;1;-1
196448;202011;352590;G;4781400;1;0;1
197002;202011;352590;P;8592901;0;1;-1
197685;202011;352590;C;2222600;1;2;-1
198302;202011;352590;G;4721102;0;2;-2
198378;202011;352590;J;5914600;0;2;-2
198501;202011;352590;C;1112700;0;1;-1
198748;202011;352590;P;8599601;0;1;-1
199208;202011;352590;I;5611201;0;1;-1
199273;202011;352590;I;5510801;4;0;4
199447;202011;352590;H;5250805;1;2;-1
199490;202011;352590;C;2621300;2;5;-3
199748;202011;352590;G;4772500;1;0;1
200006;202011;352590;G;4691500;5;3;2
200144;202011;352590;I;5611202;2;0;2
200408;202011;352590;C;3291400;0;1;-1
200539;202011;352590;Q;8650003;0;1;-1
200755;202011;352590;G;4721103;0;1;-1
201333;202011;352590;F;4399103;1;0;1
201371;202011;352590;C;2511000;2;2;0
202179;202011;352590;C;1352900;0;1;-1
202376;202011;352590;G;4689399;0;1;-1
202383;202011;352590;G;4761003;1;0;1
202384;202011;352590;N;7732201;1;0;1
202524;202011;352590;I;5611201;3;0;3
203072;202011;352590;M;6920601;1;0;1
203212;202011;352590;I;5611201;3;0;3
203490;202011;352590;G;4520007;1;0;1
203600;202011;352590;N;8299799;1;0;1
203763;202011;352590;G;4520005;0;1;-1
203848;202011;352590;M;7111100;1;2;-1
204043;202011;352590;G;4618402;13;3;10
204621;202011;352590;N;8299799;2;0;2
204635;202011;352590;G;4771701;0;1;-1
204908;202011;352590;G;4712100;2;0;2
206123;202011;352590;G;4511101;1;2;-1
206423;202011;352590;H;5211701;0;1;-1
207032;202011;352590;G;4731800;1;1;0
207054;202011;352590;G;4782201;3;0;3
207076;202011;352590;H;4930202;1;0;1
207709;202011;352590;C;2539001;0;1;-1
207888;202011;352590;G;4754701;52;7;45
208244;202011;352590;N;8211300;7;2;5
208517;202011;352590;G;4789004;0;1;-1
208964;202011;352590;N;8220200;2;0;2
210505;202011;352590;M;7112000;0;1;-1
210915;202011;352590;P;8599601;1;0;1
210916;202011;352590;P;8599601;0;1;-1
211063;202011;352590;N;8122200;2;0;2
211281;202011;352590;N;7739099;1;0;1
211356;202011;352590;G;4772500;1;0;1
213116;202011;352590;M;7500100;1;0;1
213328;202011;352590;H;4930202;4;2;2
213445;202011;352590;M;6920601;1;2;-1
213447;202011;352590;Q;8630503;1;0;1
213573;202011;352590;J;6204000;1;0;1
213763;202011;352590;G;4789099;1;0;1
215103;202011;352590;J;6399200;0;2;-2
215128;202011;352590;C;2222600;8;14;-6
215274;202011;352590;K;6619399;1;0;1
215283;202011;352590;F;4292802;0;1;-1
215699;202011;352590;G;4771701;1;0;1
215712;202011;352590;C;3314707;7;4;3
216868;202011;352590;K;6462000;1;1;0
216994;202011;352590;H;4930202;1;0;1
217843;202011;352590;C;1629301;0;3;-3
218040;202011;352590;G;4731800;2;0;2
218881;202011;352590;S;9609299;2;0;2
218895;202011;352590;G;4712100;0;2;-2
218896;202011;352590;N;8299799;2;0;2
219443;202011;352590;H;4930202;1;0;1
219672;202011;352590;I;5611203;1;0;1
220654;202011;352590;Q;8630502;4;1;3
220851;202011;352590;F;4321500;3;3;0
220970;202011;352590;I;5611203;0;1;-1
221237;202011;352590;H;4930202;3;0;3
221379;202011;352590;M;6920601;1;1;0
221671;202011;352590;H;4930202;1;0;1
222671;202011;352590;I;5611201;0;1;-1
223504;202011;352590;H;4930202;12;14;-2
223684;202011;352590;F;4213800;0;3;-3
224321;202011;352590;G;4645101;1;1;0
224904;202011;352590;M;7020400;1;0;1
225057;202011;352590;C;1099699;2;0;2
225200;202011;352590;G;4646001;1;1;0
225357;202011;352590;G;4530703;1;0;1
225865;202011;352590;G;4712100;0;1;-1
226066;202011;352590;G;4520001;0;1;-1
226824;202011;352590;G;4623109;3;2;1
226825;202011;352590;G;4623109;2;0;2
226848;202011;352590;G;4781400;0;13;-13
226859;202011;352590;G;4511104;3;1;2
226883;202011;352590;N;8130300;12;9;3
226884;202011;352590;G;4789099;4;3;1
226962;202011;352590;S;9602501;0;1;-1
227484;202011;352590;S;9601701;0;1;-1
227559;202011;352590;G;4761003;0;1;-1
227777;202011;352590;C;2840200;1;0;1
228318;202011;352590;C;3250706;1;0;1
228498;202011;352590;G;4782201;3;0;3
228499;202011;352590;G;4781400;6;0;6
228501;202011;352590;G;4781400;7;0;7
228760;202011;352590;G;4633801;0;1;-1
228763;202011;352590;A;132600;1;0;1
228821;202011;352590;H;4930202;1;0;1
228976;202011;352590;M;6920601;0;1;-1
229132;202011;352590;L;6821802;0;1;-1
229511;202011;352590;N;8299799;8;0;8
229842;202011;352590;C;2311700;0;1;-1
229843;202011;352590;G;4744002;1;0;1
230084;202011;352590;I;5611203;0;1;-1
230382;202011;352590;G;4663000;0;3;-3
230544;202011;352590;H;5212500;18;5;13
230932;202011;352590;C;2349401;6;2;4
231415;202011;352590;I;5611201;0;1;-1
231419;202011;352590;Q;8630501;0;4;-4
231516;202011;352590;G;4789005;1;0;1
231739;202011;352590;M;7500100;0;1;-1
232047;202011;352590;S;9602502;0;1;-1
232461;202011;352590;G;4744005;0;2;-2
232621;202011;352590;I;5611202;1;0;1
232776;202011;352590;S;9430800;1;0;1
232778;202011;352590;G;4773300;1;0;1
232900;202011;352590;F;4321500;0;1;-1
233160;202011;352590;N;8211300;1;0;1
233228;202011;352590;Q;8630506;0;1;-1
234140;202011;352590;J;5911102;1;0;1
234668;202011;352590;C;2072000;15;7;8
234702;202011;352590;N;8011101;1;8;-7
234740;202011;352590;G;4781400;1;0;1
235435;202011;352590;G;4633801;1;0;1
235550;202011;352590;G;4771701;0;1;-1
235672;202011;352590;G;4731800;0;1;-1
235778;202011;352590;Q;8711502;1;0;1
235883;202011;352590;G;4649499;1;3;-2
236291;202011;352590;I;5611201;0;1;-1
237383;202011;352590;G;4649401;0;1;-1
237408;202011;352590;C;2599399;3;2;1
237471;202011;352590;J;6209100;0;1;-1
237533;202011;352590;G;4782201;3;1;2
237534;202011;352590;G;4782201;5;0;5
237535;202011;352590;G;4782201;9;0;9
238252;202011;352590;Q;8712300;1;1;0
238486;202011;352590;C;1091101;3;4;-1
239591;202011;352590;J;6204000;1;1;0
239924;202011;352590;R;9313100;0;1;-1
240317;202011;352590;C;1733800;0;1;-1
240897;202011;352590;G;4721102;0;1;-1
240919;202011;352590;P;8599603;2;1;1
240949;202011;352590;H;4930202;1;0;1
241141;202011;352590;C;3314799;4;5;-1
241177;202011;352590;I;5611202;2;0;2
241333;202011;352590;I;5611201;0;1;-1
241336;202011;352590;H;4930202;0;1;-1
241516;202011;352590;N;8121400;1;0;1
241896;202011;352590;N;8299799;1;0;1
242668;202011;352590;G;4789002;0;1;-1
243200;202011;352590;G;4781400;0;1;-1
243302;202011;352590;F;4120400;3;2;1
243648;202011;352590;H;5250805;4;4;0
244019;202011;352590;G;4722901;1;0;1
244539;202011;352590;F;4322302;1;0;1
244979;202011;352590;G;4781400;1;0;1
245248;202011;352590;G;4789004;1;0;1
245289;202011;352590;I;5611201;1;1;0
245491;202011;352590;I;5611202;1;0;1
245819;202011;352590;S;9609203;1;0;1
245821;202011;352590;G;4511102;1;1;0
245823;202011;352590;G;4713002;0;1;-1
245943;202011;352590;G;4729699;0;1;-1
246045;202011;352590;C;1733800;2;2;0
246276;202011;352590;F;4322301;1;0;1
246532;202011;352590;S;9601701;0;3;-3
246591;202011;352590;G;4530703;1;0;1
247112;202011;352590;G;4781400;3;1;2
247237;202011;352590;J;6203100;0;1;-1
247397;202011;352590;M;6920601;0;1;-1
247793;202011;352590;N;8112500;2;1;1
247862;202011;352590;F;4330404;4;0;4
248305;202011;352590;J;6209100;1;0;1
248316;202011;352590;G;4761001;3;0;3
248712;202011;352590;F;4399103;1;0;1
248967;202011;352590;G;4781400;7;1;6
249113;202011;352590;C;1066000;21;4;17
249558;202011;352590;G;4781400;28;7;21
249559;202011;352590;G;4781400;8;3;5
249622;202011;352590;H;4930202;150;10;140
249648;202011;352590;S;9521500;4;2;2
250074;202011;352590;Q;8650004;2;0;2
250171;202011;352590;G;4712100;0;1;-1
250232;202011;352590;C;3250705;1;1;0
250264;202011;352590;G;4772500;2;0;2
250803;202011;352590;M;7490199;0;2;-2
250833;202011;352590;E;3821100;6;15;-9
250835;202011;352590;I;5611201;1;0;1
250871;202011;352590;K;6462000;2;0;2
250914;202011;352590;N;8111700;19;15;4
250980;202011;352590;J;6319400;0;1;-1
251087;202011;352590;F;4330499;5;1;4
251120;202011;352590;G;4752100;1;0;1
251127;202011;352590;Q;8650003;1;1;0
251569;202011;352590;N;7911200;1;0;1
252119;202011;352590;F;4120400;2;2;0
252688;202011;352590;G;4783101;1;1;0
252712;202011;352590;I;5510801;1;0;1
252745;202011;352590;G;4711302;2;0;2
253027;202011;352590;I;5611201;8;5;3
253223;202011;352590;G;4755503;1;0;1
253266;202011;352590;G;4772500;1;2;-1
253314;202011;352590;L;6822600;1;0;1
253917;202011;352590;G;4781400;1;0;1
254089;202011;352590;G;4744099;2;0;2
254342;202011;352590;Q;8800600;0;1;-1
254474;202011;352590;N;8111700;0;1;-1
255323;202011;352590;N;8121400;1;0;1
255330;202011;352590;G;4520005;0;2;-2
255428;202011;352590;C;2342702;0;1;-1
256199;202011;352590;I;5620104;1;0;1
256305;202011;352590;G;4771701;0;1;-1
256662;202011;352590;G;4729699;0;2;-2
257077;202011;352590;P;8541400;1;0;1
257078;202011;352590;L;6821801;0;1;-1
257492;202011;352590;R;9329804;1;0;1
259588;202011;352590;P;8511200;2;0;2
259593;202011;352590;G;4743100;1;0;1
259997;202011;352590;G;4781400;1;0;1
260124;202011;352590;G;4772500;1;0;1
260125;202011;352590;H;4930202;7;1;6
261454;202011;352590;Q;8650004;0;2;-2
262044;202011;352590;G;4772500;1;0;1
262191;202011;352590;S;9512600;0;1;-1
262364;202011;352590;S;9511800;1;0;1
262743;202011;352590;Q;8711501;0;3;-3
262788;202011;352590;G;4530701;1;1;0
262957;202011;352590;N;8111700;6;0;6
262958;202011;352590;N;8111700;0;1;-1
263694;202011;352590;G;4691500;10;8;2
263746;202011;352590;I;5620104;0;1;-1
264181;202011;352590;N;8299706;1;0;1
264183;202011;352590;G;4743100;0;1;-1
264922;202011;352590;G;4637199;1;0;1
265206;202011;352590;M;7311400;0;1;-1
265263;202011;352590;I;5611203;4;4;0
265331;202011;352590;I;5611203;1;0;1
265340;202011;352590;I;5611203;2;3;-1
265824;202011;352590;I;5611203;4;2;2
266012;202011;352590;C;1091102;1;0;1
266062;202011;352590;M;7500100;0;1;-1
266440;202011;352590;C;3314704;1;0;1
266441;202011;352590;C;3314704;0;1;-1
266844;202011;352590;F;4330403;1;0;1
266846;202011;352590;F;4330499;0;1;-1
268417;202011;352590;N;7733100;1;0;1
268461;202011;352590;G;4637199;0;3;-3
269118;202011;352590;I;5611201;3;1;2
269149;202011;352590;I;5611201;0;1;-1
269336;202011;352590;G;4619200;1;0;1
269667;202011;352590;N;8299706;0;1;-1
269670;202011;352590;Q;8630502;1;0;1
269866;202011;352590;G;4712100;1;1;0
269867;202011;352590;G;4761003;6;0;6
270262;202011;352590;G;4689399;4;0;4
270373;202011;352590;P;8511200;0;1;-1
270465;202011;352590;G;4520002;1;0;1
270511;202011;352590;H;4930201;1;0;1
270983;202011;352590;F;4399101;0;1;-1
271092;202011;352590;G;4669999;4;2;2
271831;202011;352590;H;4930202;1;0;1
271924;202011;352590;G;4763601;0;1;-1
272027;202011;352590;G;4781400;1;0;1
272334;202011;352590;M;6920601;2;0;2
272711;202011;352590;I;5611203;2;2;0
273947;202011;352590;G;4744005;1;0;1
273981;202011;352590;D;3511502;2;0;2
275107;202011;352590;G;4781400;1;1;0
275316;202011;352590;J;6110803;1;1;0
275563;202011;352590;G;4781400;2;0;2
276187;202011;352590;G;4686902;2;0;2
276207;202011;352590;G;4772500;5;2;3
276360;202011;352590;G;4530703;1;1;0
277100;202011;352590;M;7020400;3;0;3
277301;202011;352590;K;6619399;2;0;2
277302;202011;352590;K;6622300;2;2;0
277430;202011;352590;G;4731800;0;1;-1
277555;202011;352590;G;4763603;2;1;1
277556;202011;352590;G;4763603;2;1;1
277695;202011;352590;G;4646001;1;0;1
277887;202011;352590;N;8230001;0;1;-1
278276;202011;352590;G;4763601;0;1;-1
278494;202011;352590;M;6911701;2;0;2
278600;202011;352590;C;2731700;1;1;0
278644;202011;352590;J;6190601;0;1;-1
278830;202011;352590;C;2532201;0;1;-1
279056;202011;352590;G;4789099;4;2;2
279061;202011;352590;Q;8640205;1;1;0
279696;202011;352590;N;8112500;0;1;-1
279722;202011;352590;H;5211701;19;15;4
280630;202011;352590;G;4672900;1;0;1
280838;202011;352590;G;4530704;5;1;4
281370;202011;352590;C;2399101;0;1;-1
281408;202011;352590;G;4530705;1;0;1
281621;202011;352590;G;4771701;1;1;0
282382;202011;352590;C;3314702;3;0;3
282387;202011;352590;G;4744001;0;1;-1
282597;202011;352590;G;4754701;29;11;18
283246;202011;352590;G;4771702;2;1;1
283248;202011;352590;C;1091101;1;3;-2
283252;202011;352590;C;2599399;6;4;2
283415;202011;352590;C;3314708;10;0;10
284407;202011;352590;N;8211300;1;0;1
284506;202011;352590;C;1413401;0;4;-4
284582;202011;352590;H;4930202;0;1;-1
285286;202011;352590;G;4759899;6;0;6
286011;202011;352590;G;4781400;1;0;1
286516;202011;352590;I;5620102;1;0;1
286952;202011;352590;G;4721102;1;0;1
287376;202011;352590;C;1749400;3;0;3
288033;202011;352590;F;4399199;11;0;11
288458;202011;352590;F;4399103;1;0;1
288593;202011;352590;G;4530703;1;1;0
288707;202011;352590;G;4761001;3;3;0
289639;202011;352590;G;4724500;0;1;-1
289864;202011;352590;G;4623109;1;1;0
290179;202011;352590;G;4763601;1;3;-2
290250;202011;352590;F;4322303;1;2;-1
291768;202011;352590;G;4772500;0;2;-2
292420;202011;352590;G;4741500;1;0;1
293346;202011;352590;G;4774100;1;0;1
293591;202011;352590;G;4520001;1;0;1
293622;202011;352590;N;7810800;36;4;32
293628;202011;352590;G;4721104;1;5;-4
293710;202011;352590;C;3101200;0;2;-2
293712;202011;352590;G;4754701;0;2;-2
293838;202011;352590;J;6209100;0;2;-2
294116;202011;352590;I;5611203;0;1;-1
294221;202011;352590;G;4752100;3;0;3
294995;202011;352590;C;1053800;12;1;11
295644;202011;352590;F;4120400;0;1;-1
296080;202011;352590;G;4757100;0;1;-1
296092;202011;352590;G;4721104;1;0;1
296184;202011;352590;N;8121400;1;0;1
296897;202011;352590;I;5611201;1;0;1
297309;202011;352590;G;4783101;1;0;1
297949;202011;352590;H;4930202;0;1;-1
298288;202011;352590;M;7112000;0;3;-3
298298;202011;352590;G;4772500;1;0;1
298970;202011;352590;F;4399104;1;2;-1
299228;202011;352590;C;2229303;3;0;3
299339;202011;352590;G;4782201;1;4;-3
299351;202011;352590;I;5611201;1;0;1
299607;202011;352590;G;4771701;4;0;4
299958;202011;352590;I;5611203;1;0;1
300117;202011;352590;G;4781400;1;0;1
300203;202011;352590;G;4520002;2;1;1
300282;202011;352590;F;4120400;0;4;-4
300383;202011;352590;M;7112000;43;1;42
300539;202011;352590;N;7711000;3;0;3
300719;202011;352590;S;9529105;1;0;1
300929;202011;352590;Q;8630503;2;0;2
301593;202011;352590;G;4712100;1;0;1
302111;202011;352590;M;7311400;1;0;1
302349;202011;352590;I;5611201;1;0;1
302383;202011;352590;N;8111700;0;2;-2
302731;202011;352590;E;3811400;0;1;-1
302765;202011;352590;H;4930202;1;1;0
302822;202011;352590;G;4782201;5;0;5
303279;202011;352590;I;5620102;0;1;-1
303391;202011;352590;G;4782201;3;2;1
303686;202011;352590;S;9601701;0;1;-1
303725;202011;352590;N;8111700;3;0;3
303901;202011;352590;H;4930202;33;22;11
303907;202011;352590;F;4321500;6;0;6
304039;202011;352590;H;5211701;2;0;2
304331;202011;352590;G;4759899;0;1;-1
304347;202011;352590;P;8511200;0;1;-1
304917;202011;352590;H;4930201;0;1;-1
306162;202011;352590;H;4930202;1;0;1
306222;202011;352590;G;4721102;0;1;-1
306412;202011;352590;N;8219999;0;1;-1
306425;202011;352590;H;4930202;1;2;-1
306428;202011;352590;P;8512100;0;1;-1
307261;202011;352590;C;2229302;0;1;-1
307427;202011;352590;N;8112500;1;0;1
307529;202011;352590;I;5611201;1;0;1
307531;202011;352590;R;9313100;2;0;2
307657;202011;352590;S;9602502;1;0;1
307775;202011;352590;S;9603301;1;2;-1
308603;202011;352590;C;1093701;1;0;1
309058;202011;352590;M;6920601;2;0;2
309743;202011;352590;I;5611201;0;3;-3
309834;202011;352590;G;4789099;1;0;1
311313;202011;352590;I;5620103;0;1;-1
311788;202011;352590;Q;8630503;1;0;1
312046;202011;352590;M;7112000;3;1;2
313530;202011;352590;G;4774100;2;0;2
313662;202011;352590;G;4751201;1;0;1
313872;202011;352590;G;4781400;1;0;1
314129;202011;352590;G;4520005;0;3;-3
314240;202011;352590;H;4930201;0;1;-1
314319;202011;352590;G;4781400;1;0;1
314453;202011;352590;M;7120100;0;1;-1
314755;202011;352590;N;8219999;5;0;5
314878;202011;352590;G;4721104;1;0;1
314927;202011;352590;G;4721104;1;0;1
315327;202011;352590;N;7911200;1;0;1
315910;202011;352590;F;4120400;8;8;0
316154;202011;352590;H;4930202;1;0;1
316565;202011;352590;F;4321500;1;0;1
316713;202011;352590;H;4930202;1;1;0
317773;202011;352590;G;4752100;1;0;1
318551;202011;352590;F;4120400;1;1;0
318616;202011;352590;C;3250701;0;1;-1
318842;202011;352590;N;8111700;1;0;1
320085;202011;352590;G;4741500;1;0;1
320118;202011;352590;G;4614100;1;0;1
320126;202011;352590;G;4771702;1;2;-1
320203;202011;352590;N;8299799;3;1;2
320774;202011;352590;F;4222701;1;0;1
320775;202011;352590;F;4222701;0;1;-1
321108;202011;352590;G;4789099;1;1;0
322155;202011;352590;S;9609299;1;0;1
322690;202011;352590;G;4744002;1;0;1
322694;202011;352590;G;4618499;0;1;-1
322732;202011;352590;G;4789099;1;0;1
323368;202011;352590;J;6209100;1;1;0
323442;202011;352590;H;4930201;0;5;-5
323444;202011;352590;H;4930201;7;3;4
323460;202011;352590;H;4930202;0;1;-1
323772;202011;352590;I;5611201;1;0;1
324210;202011;352590;G;4754701;0;1;-1
324747;202011;352590;G;4789004;4;2;2
324888;202011;352590;M;7319003;1;0;1
324941;202011;352590;F;4399199;4;4;0
325131;202011;352590;Q;8711502;1;1;0
325660;202011;352590;G;4687702;1;1;0
326377;202011;352590;H;4930201;2;2;0
326738;202011;352590;H;4930202;1;1;0
327223;202011;352590;F;4292802;1;0;1
327382;202011;352590;G;4732600;2;2;0
327454;202011;352590;G;4782201;0;1;-1
327455;202011;352590;G;4782201;1;1;0
327607;202011;352590;I;5611201;1;0;1
327875;202011;352590;G;4642701;1;0;1
328209;202011;352590;G;4751201;1;0;1
328515;202011;352590;C;2033900;1;0;1
328673;202011;352590;N;8011101;1;0;1
328864;202011;352590;G;4530703;1;0;1
329463;202011;352590;G;4774100;2;0;2
330978;202011;352590;H;4930202;4;2;2
331240;202011;352590;N;8111700;2;0;2
331246;202011;352590;G;4722901;1;1;0
331591;202011;352590;N;7912100;0;1;-1
331735;202011;352590;N;7911200;0;1;-1
332413;202011;352590;G;4724500;2;1;1
332551;202011;352590;G;4772500;1;0;1
332552;202011;352590;G;4772500;2;0;2
333959;202011;352590;C;1013901;1;7;-6
334141;202011;352590;F;4321500;1;1;0
334310;202011;352590;N;8219999;0;2;-2
334878;202011;352590;G;4781400;1;0;1
334879;202011;352590;G;4781400;0;1;-1
335235;202011;352590;I;5611203;0;1;-1
335579;202011;352590;I;5611203;0;1;-1
336913;202011;352590;I;5611201;5;0;5
337687;202011;352590;N;8112500;1;0;1
337974;202011;352590;C;2222600;1;0;1
338326;202011;352590;G;4789004;1;0;1
338462;202011;352590;G;4721102;1;0;1
338526;202011;352590;H;4930202;0;1;-1
338744;202011;352590;M;7119701;1;0;1
338991;202011;352590;G;4530703;1;1;0
339212;202011;352590;G;4771701;1;1;0
339535;202011;352590;G;4752100;0;1;-1
340118;202011;352590;G;4520001;1;1;0
340127;202011;352590;R;9313100;1;0;1
340365;202011;352590;C;3212400;1;0;1
340488;202011;352590;N;8291100;1;1;0
341251;202011;352590;N;8220200;109;51;58
342005;202011;352590;F;4399103;0;8;-8
342122;202011;352590;M;6920601;1;1;0
342749;202011;352590;G;4753900;1;1;0
343841;202011;352590;H;4930202;3;1;2
343942;202011;352590;M;6920601;1;0;1
344562;202011;352590;C;1091102;1;0;1
345630;202011;352590;I;5611201;2;0;2
345745;202011;352590;G;4789001;3;0;3
346167;202011;352590;I;5611201;0;1;-1
346709;202011;352590;C;2610800;0;1;-1
346776;202011;352590;M;7119703;2;0;2
347200;202011;352590;P;8599604;1;0;1
347529;202011;352590;G;4637199;1;1;0
347909;202011;352590;S;9602502;0;2;-2
348586;202011;352590;G;4722901;0;1;-1
348669;202011;352590;I;5611201;2;2;0
349340;202011;352590;P;8593700;2;1;1
349687;202011;352590;N;8130300;11;3;8
349795;202011;352590;G;4752100;2;0;2
349797;202011;352590;G;4752100;3;1;2
350069;202011;352590;F;4321500;11;2;9
350168;202011;352590;F;4120400;27;34;-7
350570;202011;352590;S;9602502;1;0;1
351840;202011;352590;F;4330405;8;3;5
352136;202011;352590;M;7490199;1;0;1
352168;202011;352590;G;4530703;1;0;1
352510;202011;352590;C;3092000;1;1;0
352583;202011;352590;G;4729699;1;0;1
352814;202011;352590;M;7020400;2;0;2
352927;202011;352590;G;4530705;1;0;1
352930;202011;352590;H;4930201;3;2;1
353015;202011;352590;G;4721102;2;1;1
353090;202011;352590;M;7112000;5;0;5
353137;202011;352590;G;4721102;1;0;1
354185;202011;352590;G;4781400;2;2;0
354377;202011;352590;I;5611203;1;1;0
355207;202011;352590;G;4781400;1;0;1
356359;202011;352590;H;4930202;7;5;2
356552;202011;352590;Q;8712300;1;2;-1
357146;202011;352590;I;5611203;1;0;1
357475;202011;352590;C;2222600;1;0;1
357749;202011;352590;F;4299599;1;0;1
357890;202011;352590;H;4930202;1;0;1
359172;202011;352590;P;8550302;1;2;-1
360126;202011;352590;L;6810202;1;1;0
360459;202011;352590;H;4930201;1;0;1
360516;202011;352590;G;4781400;2;1;1
360649;202011;352590;N;8211300;2;0;2
360696;202011;352590;G;4752100;1;0;1
362246;202011;352590;P;8512100;1;0;1
362790;202011;352590;G;4781400;4;0;4
363616;202011;352590;I;5611203;1;2;-1
363643;202011;352590;G;4781400;0;1;-1
363721;202011;352590;G;4782202;1;0;1
364001;202011;352590;I;5611201;2;1;1
364086;202011;352590;G;4731800;3;1;2
364911;202011;352590;C;3329599;1;1;0
365520;202011;352590;I;5611203;0;1;-1
366104;202011;352590;G;4713002;0;1;-1
366632;202011;352590;N;8111700;1;3;-2
366889;202011;352590;G;4669999;7;4;3
367127;202011;352590;G;4712100;0;1;-1
367456;202011;352590;S;9511800;1;0;1
368673;202011;352590;G;4754701;1;0;1
368777;202011;352590;J;6209100;1;0;1
369905;202011;352590;G;4712100;0;1;-1
371325;202011;352590;I;5611201;2;1;1
371880;202011;352590;H;4930202;27;9;18
372220;202011;352590;C;1091102;2;0;2
372959;202011;352590;N;8121400;0;1;-1
372987;202011;352590;S;9512600;1;0;1
373029;202011;352590;Q;8630503;0;1;-1
373116;202011;352590;G;4789001;1;0;1
373243;202011;352590;F;4120400;1;0;1
373305;202011;352590;G;4712100;1;0;1
373525;202011;352590;N;8130300;1;1;0
373623;202011;352590;F;4399199;3;0;3
373834;202011;352590;I;5611203;1;0;1
373993;202011;352590;G;4789003;1;0;1
374655;202011;352590;I;5611203;0;1;-1
374817;202011;352590;H;4930202;4;1;3
376219;202011;352590;G;4530703;1;3;-2
376557;202011;352590;I;5611203;1;0;1
376595;202011;352590;G;4789002;2;0;2
377129;202011;352590;G;4645101;1;3;-2
377512;202011;352590;C;1413403;1;0;1
377518;202011;352590;C;1099699;1;0;1
377855;202011;352590;H;4930202;0;1;-1
378195;202011;352590;G;4741500;1;0;1
378987;202011;352590;G;4722901;2;0;2
379209;202011;352590;G;4721102;2;0;2
379419;202011;352590;G;4530703;2;0;2
379549;202011;352590;N;8121400;4;1;3
379684;202011;352590;L;6822600;1;1;0
380179;202011;352590;I;5611201;2;1;1
380582;202011;352590;M;6920601;1;1;0
380895;202011;352590;G;4744099;0;1;-1
381137;202011;352590;M;7112000;3;3;0
381528;202011;352590;H;5212500;23;17;6
381579;202011;352590;M;7020400;0;1;-1
381640;202011;352590;G;4731800;2;0;2
381734;202011;352590;C;1412601;2;0;2
381920;202011;352590;G;4713001;22;4;18
382659;202011;352590;C;2950600;2;2;0
382923;202011;352590;M;7119701;0;1;-1
383195;202011;352590;G;4783101;0;1;-1
384392;202011;352590;C;1042200;6;21;-15
384407;202011;352590;Q;8630504;1;0;1
384437;202011;352590;C;3314719;1;1;0
384812;202011;352590;G;4731800;0;2;-2
384895;202011;352590;G;4751201;1;0;1
384983;202011;352590;R;9313100;1;1;0
385365;202011;352590;G;4520001;1;0;1
385384;202011;352590;M;7020400;0;1;-1
385430;202011;352590;P;8599604;1;0;1
385665;202011;352590;N;8211300;1;1;0
385733;202011;352590;M;7120100;0;1;-1
386030;202011;352590;G;4729699;12;44;-32
386159;202011;352590;G;4520001;3;0;3
386274;202011;352590;N;7721700;1;0;1
386602;202011;352590;G;4789099;0;1;-1
387117;202011;352590;S;9602502;1;0;1
387194;202011;352590;N;8111700;1;0;1
387896;202011;352590;R;9321200;1;0;1
388875;202011;352590;L;6821802;1;0;1
389285;202011;352590;N;8112500;4;1;3
389389;202011;352590;I;5620101;34;11;23
389391;202011;352590;I;5620101;1;1;0
389392;202011;352590;I;5620101;4;3;1
389393;202011;352590;I;5620101;0;1;-1
389398;202011;352590;I;5620101;4;1;3
389598;202011;352590;G;4744003;0;1;-1
389701;202011;352590;G;4742300;3;0;3
390368;202011;352590;S;9529105;1;0;1
391791;202011;352590;H;5211701;4;3;1
391817;202011;352590;P;8511200;1;0;1
392837;202011;352590;H;4930202;0;1;-1
393193;202011;352590;N;8220200;247;122;125
393289;202011;352590;G;4729699;2;0;2
393301;202011;352590;G;4782201;3;2;1
393486;202011;352590;G;4781400;1;2;-1
393625;202011;352590;C;1113502;0;1;-1
393707;202011;352590;J;6209100;5;1;4
394400;202011;352590;G;4783101;0;1;-1
394776;202011;352590;C;2229399;0;1;-1
395527;202011;352590;G;4772500;0;1;-1
395821;202011;352590;H;4930202;4;0;4
395894;202011;352590;G;4633801;0;1;-1
396747;202011;352590;F;4120400;2;0;2
397006;202011;352590;Q;8630502;1;1;0
397084;202011;352590;F;4221904;8;10;-2
397147;202011;352590;I;5611201;1;1;0
397498;202011;352590;C;2330305;6;2;4
398163;202011;352590;I;5611203;1;0;1
398722;202011;352590;M;6920601;1;0;1
399192;202011;352590;N;8299799;22;10;12
399262;202011;352590;C;3321000;1;0;1
399277;202011;352590;N;8111700;8;10;-2
399666;202011;352590;H;4930202;9;4;5
399930;202011;352590;G;4530703;1;0;1
400369;202011;352590;G;4781400;1;0;1
400927;202011;352590;G;4711302;1;2;-1
401741;202011;352590;P;8599604;20;11;9
402369;202011;352590;S;9601701;0;1;-1
402812;202011;352590;G;4639701;22;7;15
403013;202011;352590;G;4520007;0;1;-1
403290;202011;352590;N;8111700;3;3;0
403877;202011;352590;C;1095300;1;13;-12
404508;202011;352590;G;4712100;1;1;0
404916;202011;352590;I;5611202;1;0;1
404953;202011;352590;G;4753900;3;5;-2
405159;202011;352590;C;3321000;0;1;-1
405320;202011;352590;N;8291100;0;1;-1
406086;202011;352590;J;6319400;1;0;1
407161;202011;352590;N;8219999;1;0;1
407665;202011;352590;C;2943300;1;0;1
407971;202011;352590;J;6209100;2;1;1
408053;202011;352590;C;2941700;6;1;5
408511;202011;352590;I;5611201;1;0;1
408524;202011;352590;N;8211300;0;1;-1
408782;202011;352590;G;4753900;1;0;1
408913;202011;352590;G;4731800;1;0;1
408951;202011;352590;F;4312600;0;1;-1
409350;202011;352590;I;5611203;1;0;1
409353;202011;352590;I;5611203;0;2;-2
409354;202011;352590;I;5611203;0;1;-1
409356;202011;352590;I;5611203;8;4;4
410571;202011;352590;M;6920601;0;1;-1
410907;202011;352590;G;4520005;0;1;-1
410908;202011;352590;C;3314707;1;0;1
410998;202011;352590;G;4781400;9;0;9
411093;202011;352590;G;4712100;0;1;-1
411499;202011;352590;Q;8630503;1;0;1
412473;202011;352590;G;4789002;2;1;1
412731;202011;352590;J;6319400;3;1;2
412757;202011;352590;K;6462000;0;1;-1
413115;202011;352590;G;4782201;1;1;0
413123;202011;352590;Q;8711502;2;1;1
413814;202011;352590;G;4723700;1;0;1
415477;202011;352590;G;4722901;0;1;-1
415498;202011;352590;I;5611203;2;0;2
415678;202011;352590;K;6462000;1;0;1
416039;202011;352590;G;4744099;2;0;2
416488;202011;352590;R;9313100;2;0;2
417157;202011;352590;M;6920601;1;0;1
417229;202011;352590;F;4330404;0;1;-1
417232;202011;352590;S;9602502;1;0;1
417977;202011;352590;P;8599603;1;1;0
418108;202011;352590;G;4633801;0;1;-1
418292;202011;352590;G;4781400;1;1;0
418377;202011;352590;G;4755502;2;0;2
418815;202011;352590;I;5611201;1;2;-1
419109;202011;352590;P;8593700;0;1;-1
419528;202011;352590;N;8111700;0;1;-1
420973;202011;352590;G;4744099;2;0;2
421051;202011;352590;H;5212500;0;4;-4
421101;202011;352590;I;5611201;0;1;-1
421186;202011;352590;G;4722901;1;0;1
422131;202011;352590;S;9602501;0;2;-2
422509;202011;352590;G;4781400;1;0;1
422510;202011;352590;G;4781400;0;1;-1
422890;202011;352590;G;4789099;1;0;1
423543;202011;352590;F;4120400;6;1;5
423589;202011;352590;G;4646001;3;1;2
424665;202011;352590;C;1069400;4;3;1
425283;202011;352590;G;4530703;2;1;1
425890;202011;352590;G;4755502;2;1;1
426083;202011;352590;I;5611201;1;0;1
426129;202011;352590;F;4321500;1;2;-1
426141;202011;352590;G;4789099;1;0;1
426589;202011;352590;Q;8630503;0;1;-1
426801;202011;352590;I;5611203;1;0;1
426895;202011;352590;G;4729699;1;1;0
427059;202011;352590;M;7020400;1;0;1
427262;202011;352590;S;9603301;0;1;-1
427300;202011;352590;H;5250804;1;3;-2
427601;202011;352590;G;4774100;2;1;1
427730;202011;352590;C;1821100;0;1;-1
427747;202011;352590;N;7740300;1;1;0
427998;202011;352590;G;4530703;0;1;-1
428116;202011;352590;N;8111700;1;0;1
428343;202011;352590;I;5611201;5;2;3
428350;202011;352590;H;5223100;1;2;-1
428439;202011;352590;G;4759899;3;0;3
428737;202011;352590;G;4724500;1;0;1
429117;202011;352590;G;4729699;2;1;1
429385;202011;352590;G;4713002;0;1;-1
429414;202011;352590;G;4721103;2;0;2
429523;202011;352590;I;5611201;0;1;-1
429788;202011;352590;P;8511200;0;1;-1
429822;202011;352590;G;4781400;3;1;2
429910;202011;352590;R;9313100;1;0;1
430011;202011;352590;G;4729699;0;1;-1
430231;202011;352590;G;4721104;0;1;-1
430738;202011;352590;R;9313100;1;0;1
430797;202011;352590;I;5611203;1;1;0
430872;202011;352590;G;4520006;0;2;-2
431054;202011;352590;N;8111700;1;0;1
431312;202011;352590;G;4721102;1;2;-1
432401;202011;352590;I;5611203;0;1;-1
432621;202011;352590;M;7319003;3;6;-3
432718;202011;352590;F;4120400;2;0;2
433332;202011;352590;G;4686902;2;0;2
433607;202011;352590;C;3313901;2;3;-1
433851;202011;352590;H;4930202;2;0;2
435111;202011;352590;F;4322301;1;0;1
435265;202011;352590;F;4330403;0;2;-2
435269;202011;352590;F;4292801;0;4;-4
435629;202011;352590;H;4930202;1;5;-4
437206;202011;352590;R;9321200;2;3;-1
437681;202011;352590;G;4781400;1;0;1
437682;202011;352590;G;4781400;1;0;1
438286;202011;352590;H;4930202;1;2;-1
438470;202011;352590;K;6462000;10;6;4
438587;202011;352590;G;4789004;2;1;1
439005;202011;352590;N;8122200;1;0;1
439953;202011;352590;G;4782201;1;0;1
440377;202011;352590;M;7112000;1;0;1
441153;202011;352590;F;4120400;0;3;-3
441592;202011;352590;F;4330404;4;2;2
442131;202011;352590;C;2511000;11;0;11
442447;202011;352590;G;4687702;3;0;3
442507;202011;352590;G;4772500;1;1;0
442537;202011;352590;G;4713001;1;0;1
442712;202011;352590;M;7020400;1;0;1
442759;202011;352590;G;4783101;3;0;3
442887;202011;352590;I;5611201;2;0;2
443026;202011;352590;G;4520003;0;1;-1
443059;202011;352590;N;8299799;1;0;1
443798;202011;352590;C;2740602;1;0;1
444204;202011;352590;Q;8640202;2;0;2
444578;202011;352590;N;7820500;7;6;1
444661;202011;352590;I;5611201;1;0;1
445174;202011;352590;I;5611201;0;1;-1
445649;202011;352590;N;7729299;1;1;0
445745;202011;352590;P;8599604;0;1;-1
445951;202011;352590;G;4789004;0;1;-1
446779;202011;352590;G;4729699;1;0;1
447092;202011;352590;I;5611201;2;0;2
447313;202011;352590;F;4120400;0;1;-1
448596;202011;352590;G;4543900;1;0;1
448687;202011;352590;N;7739099;2;0;2
449052;202011;352590;P;8599604;1;1;0
450288;202011;352590;N;8121400;2;1;1
450751;202011;352590;H;4930201;1;0;1
451840;202011;352590;I;5611203;0;1;-1
452273;202011;352590;C;3314707;1;1;0
452368;202011;352590;Q;8640202;3;2;1
452369;202011;352590;Q;8640202;2;0;2
452432;202011;352590;Q;8630504;3;1;2
452690;202011;352590;G;4729699;3;0;3
452691;202011;352590;G;4729699;0;5;-5
453069;202011;352590;G;4722901;0;1;-1
453523;202011;352590;Q;8711502;0;3;-3
454244;202011;352590;G;4732600;1;0;1
454406;202011;352590;G;4789099;1;0;1
454477;202011;352590;L;6822600;0;1;-1
454511;202011;352590;I;5611203;2;0;2
454772;202011;352590;N;8111700;0;9;-9
454872;202011;352590;P;8599699;1;0;1
455140;202011;352590;J;6110803;2;1;1
455336;202011;352590;G;4729699;1;0;1
455645;202011;352590;G;4721104;1;1;0
456057;202011;352590;I;5620101;3;3;0
456175;202011;352590;F;4120400;10;10;0
456497;202011;352590;G;4783102;1;0;1
457467;202011;352590;P;8512100;1;0;1
457491;202011;352590;G;4772500;1;0;1
457515;202011;352590;G;4520002;1;0;1
457609;202011;352590;F;4322302;1;0;1
457660;202011;352590;H;5212500;15;8;7
457832;202011;352590;L;6821801;1;0;1
457968;202011;352590;C;1053800;2;0;2
458159;202011;352590;G;4789099;1;0;1
458160;202011;352590;G;4752100;1;0;1
458228;202011;352590;I;5611201;2;1;1
459144;202011;352590;I;5611203;1;0;1
459222;202011;352590;F;4391600;1;0;1
459523;202011;352590;I;5620101;1;0;1
459524;202011;352590;I;5620101;1;0;1
459918;202011;352590;R;9313100;1;1;0
460187;202011;352590;M;7112000;5;1;4
460980;202011;352590;S;9603304;1;2;-1
461374;202011;352590;G;4781400;0;1;-1
461908;202011;352590;N;8111700;1;0;1
461993;202011;352590;G;4782201;3;0;3
462356;202011;352590;P;8593700;0;1;-1
462471;202011;352590;C;3101200;1;0;1
462713;202011;352590;G;4772500;4;0;4
462794;202011;352590;I;5611203;0;1;-1
462999;202011;352590;I;5611203;0;1;-1
463523;202011;352590;Q;8650003;0;1;-1
464233;202011;352590;M;7112000;1;0;1
464431;202011;352590;G;4789099;2;3;-1
464748;202011;352590;G;4789004;0;1;-1
464871;202011;352590;F;4399199;1;1;0
465248;202011;352590;I;5611203;0;1;-1
465531;202011;352590;I;5611203;3;0;3
465561;202011;352590;J;6209100;1;2;-1
465565;202011;352590;G;4781400;1;0;1
465950;202011;352590;G;4721102;1;2;-1
466515;202011;352590;N;8299799;0;2;-2
466875;202011;352590;I;5611201;0;1;-1
467694;202011;352590;N;8111700;3;0;3
467832;202011;352590;N;8291100;1;1;0
467937;202011;352590;Q;8630503;1;1;0
467983;202011;352590;N;8211300;1;1;0
467995;202011;352590;I;5611201;3;2;1
468573;202011;352590;H;4930202;1;0;1
468905;202011;352590;I;5611201;3;0;3
469158;202011;352590;G;4763601;1;0;1
469964;202011;352590;S;9602502;0;1;-1
470030;202011;352590;G;4511101;1;2;-1
470087;202011;352590;S;9499500;0;1;-1
470558;202011;352590;H;4930202;1;0;1
471107;202011;352590;N;8299799;3;1;2
471382;202011;352590;G;4530705;2;3;-1
471509;202011;352590;G;4721104;1;0;1
471510;202011;352590;C;1091102;1;1;0
471559;202011;352590;G;4772500;1;0;1
471709;202011;352590;F;4321500;2;1;1
471959;202011;352590;G;4723700;2;2;0
472054;202011;352590;G;4784900;0;1;-1
472270;202011;352590;I;5611201;0;1;-1
472406;202011;352590;J;6110803;0;1;-1
473679;202011;352590;G;4692300;1;0;1
474004;202011;352590;S;9601703;20;12;8
474638;202011;352590;C;3314799;9;2;7
474659;202011;352590;G;4781400;1;0;1
475924;202011;352590;S;9602501;1;0;1
476030;202011;352590;N;8211300;0;1;-1
477320;202011;352590;S;9601701;1;0;1
477904;202011;352590;G;4781400;1;0;1
478360;202011;352590;G;4729699;0;1;-1
478618;202011;352590;I;5611201;0;1;-1
478729;202011;352590;M;7112000;0;2;-2
479172;202011;352590;G;4771701;1;0;1
479629;202011;352590;M;7112000;5;3;2
480334;202011;352590;F;4299599;0;1;-1
480416;202011;352590;I;5620101;6;0;6
480548;202011;352590;G;4711301;6;6;0
480908;202011;352590;F;4321500;2;1;1
480938;202011;352590;Q;8630504;1;0;1
481128;202011;352590;G;4781400;1;1;0
481382;202011;352590;I;5611201;1;1;0
481432;202011;352590;I;5611201;1;1;0
482433;202011;352590;G;4783101;1;0;1
482992;202011;352590;C;1091100;0;1;-1
483050;202011;352590;G;4789004;1;1;0
483226;202011;352590;S;9529199;2;0;2
483685;202011;352590;G;4711302;2;1;1
483917;202011;352590;P;8599699;1;0;1
484017;202011;352590;I;5611201;0;2;-2
484571;202011;352590;F;4322303;3;0;3
484746;202011;352590;Q;8640299;1;2;-1
485031;202011;352590;G;4712100;0;1;-1
485070;202011;352590;H;4930202;2;0;2
485247;202011;352590;G;4731800;1;2;-1
485715;202011;352590;G;4520005;2;4;-2
485721;202011;352590;C;1099699;0;6;-6
486508;202011;352590;G;4781400;0;1;-1
486581;202011;352590;G;4781400;1;1;0
487122;202011;352590;Q;8650003;1;0;1
487789;202011;352590;H;5320202;11;0;11
487895;202011;352590;G;4782202;1;1;0
488356;202011;352590;F;4321500;1;1;0
488691;202011;352590;L;6821802;2;2;0
489330;202011;352590;G;4530703;1;1;0
489734;202011;352590;J;6209100;2;0;2
490085;202011;352590;G;4781400;1;1;0
490522;202011;352590;H;4930201;1;1;0
490714;202011;352590;N;8111700;1;0;1
490839;202011;352590;N;7810800;2;2;0
491063;202011;352590;N;8121400;2;0;2
491538;202011;352590;G;4774100;1;0;1
491579;202011;352590;Q;8630504;1;2;-1
491761;202011;352590;F;4299599;1;1;0
492123;202011;352590;N;8211300;1;0;1
492179;202011;352590;N;8112500;0;1;-1
492203;202011;352590;G;4520001;0;1;-1
492706;202011;352590;N;7739099;5;2;3
493061;202011;352590;G;4637199;7;0;7
494458;202011;352590;S;9602502;0;1;-1
495090;202011;352590;P;8599604;2;1;1
496266;202011;352590;G;4723700;1;0;1
496560;202011;352590;H;4930201;1;0;1
496925;202011;352590;G;4744005;1;0;1
497028;202011;352590;G;4729699;0;1;-1
497587;202011;352590;N;7732201;2;3;-1
498116;202011;352590;G;4511101;0;1;-1
498450;202011;352590;C;2222600;1;2;-1
498521;202011;352590;M;7319002;1;1;0
499007;202011;352590;H;5229099;0;1;-1
499049;202011;352590;G;4781400;0;1;-1
499362;202011;352590;G;4642701;1;0;1
499707;202011;352590;H;4930201;1;0;1
499842;202011;352590;H;5223100;4;4;0
500974;202011;352590;K;6619302;0;1;-1
501052;202011;352590;I;5611203;1;0;1
501107;202011;352590;N;8111700;0;1;-1
501294;202011;352590;C;1413401;0;1;-1
501395;202011;352590;Q;8630504;1;1;0
501842;202011;352590;C;2539001;0;1;-1
502224;202011;352590;M;7112000;0;2;-2
502784;202011;352590;G;4713002;1;1;0
503098;202011;352590;G;4789002;3;0;3
503222;202011;352590;G;4781400;3;0;3
503439;202011;352590;N;8211300;0;1;-1
504008;202011;352590;G;4781400;1;0;1
504168;202011;352590;G;4781400;1;0;1
504657;202011;352590;M;6920601;2;0;2
504908;202011;352590;G;4742300;2;1;1
505017;202011;352590;G;4530703;0;1;-1
506474;202011;352590;G;4712100;1;0;1
507107;202011;352590;G;4771701;2;0;2
507279;202011;352590;G;4742300;4;0;4
507371;202011;352590;C;2061400;1;0;1
507636;202011;352590;G;4711302;0;1;-1
507715;202011;352590;G;4520005;1;0;1
507902;202011;352590;M;7112000;3;0;3
508276;202011;352590;H;5320202;1;0;1
508972;202011;352590;I;5611203;0;1;-1
509289;202011;352590;G;4773300;2;0;2
510677;202011;352590;G;4530703;1;0;1
510946;202011;352590;G;4744099;1;0;1
511021;202011;352590;H;4930202;1;3;-2
511050;202011;352590;N;8219999;3;0;3
511826;202011;352590;I;5611201;1;0;1
512537;202011;352590;I;5611203;0;1;-1
512842;202011;352590;S;9601701;1;0;1
513859;202011;352590;H;4930202;1;0;1
514085;202011;352590;H;4930202;1;1;0
514497;202011;352590;N;8111700;2;1;1
514805;202011;352590;J;6311900;1;0;1
514911;202011;352590;A;163600;23;196;-173
514952;202011;352590;H;4930202;2;2;0
515417;202011;352590;N;8219999;0;1;-1
515507;202011;352590;C;3314707;0;1;-1
515847;202011;352590;G;4729699;1;0;1
516643;202011;352590;H;4930201;0;1;-1
516864;202011;352590;G;4520006;4;0;4
517501;202011;352590;N;8211300;1;2;-1
518201;202011;352590;N;8230001;3;4;-1
518289;202011;352590;G;4711302;11;1;10
518556;202011;352590;N;7722500;4;0;4
519080;202011;352590;G;4711302;5;0;5
520380;202011;352590;G;4753900;1;1;0
520603;202011;352590;G;4753900;49;56;-7
520604;202011;352590;G;4753900;9;1;8
520605;202011;352590;G;4753900;11;5;6
520606;202011;352590;G;4753900;2;1;1
521094;202011;352590;G;4753900;17;20;-3
521124;202011;352590;G;4753900;2;0;2
521191;202011;352590;G;4753900;2;1;1
521757;202011;352590;G;4712100;1;0;1
521758;202011;352590;G;4712100;3;2;1
522441;202011;352590;C;1812100;0;7;-7
522864;202011;352590;C;1013901;1;0;1
523355;202011;352590;I;5611201;1;0;1
523393;202011;352590;H;4930202;1;73;-72
523844;202011;352590;G;4781400;3;3;0
523943;202011;352590;G;4781400;5;2;3
524255;202011;352590;H;4930202;1;1;0
524320;202011;352590;G;4744001;0;1;-1
524610;202011;352590;G;4781400;1;0;1
525063;202011;352590;G;4752100;2;2;0
525213;202011;352590;H;4930202;2;0;2
525764;202011;352590;G;4781400;5;0;5
525843;202011;352590;G;4773300;1;1;0
525930;202011;352590;F;4330404;9;0;9
525976;202011;352590;N;8020001;1;2;-1
526083;202011;352590;I;5611201;5;5;0
526509;202011;352590;G;4530703;1;0;1
527142;202011;352590;M;7112000;0;1;-1
529234;202011;352590;C;3321000;2;2;0
529267;202011;352590;C;1013901;3;0;3
529859;202011;352590;C;2812700;0;1;-1
530093;202011;352590;C;2062200;0;1;-1
530865;202011;352590;I;5611203;2;0;2
532045;202011;352590;I;5611201;2;1;1
532242;202011;352590;I;5611203;3;1;2
532344;202011;352590;G;4781400;0;1;-1
532730;202011;352590;F;4110700;3;1;2
534131;202011;352590;N;8219999;1;1;0
535054;202011;352590;Q;8630504;0;4;-4
535170;202011;352590;G;4721104;1;0;1
535256;202011;352590;Q;8711502;12;1;11
535671;202011;352590;G;4752100;2;0;2
536207;202011;352590;G;4782201;1;0;1
537470;202011;352590;N;7739099;1;0;1
538660;202011;352590;I;5611201;1;0;1
539933;202011;352590;G;4731800;2;1;1
540207;202011;352590;N;8020001;0;1;-1
540754;202011;352590;G;4763602;4;2;2
540971;202011;352590;Q;8640202;5;1;4
541118;202011;352590;N;8291100;2;0;2
541696;202011;352590;H;4930203;0;1;-1
541956;202011;352590;G;4785799;1;1;0
542158;202011;352590;G;4781400;1;2;-1
542719;202011;352590;G;4511102;1;0;1
543154;202011;352590;H;5229099;9;10;-1
543425;202011;352590;G;4753900;1;0;1
544084;202011;352590;G;4781400;3;0;3
544427;202011;352590;N;8121400;2;0;2
544984;202011;352590;C;1721400;2;1;1
545443;202011;352590;F;4120400;2;0;2
546140;202011;352590;I;5620103;1;1;0
546392;202011;352590;I;5611202;2;0;2
546435;202011;352590;G;4669999;3;6;-3
546437;202011;352590;G;4669999;2;0;2
546516;202011;352590;G;4729602;1;0;1
546642;202011;352590;I;5620104;4;1;3
547997;202011;352590;I;5611203;5;2;3
548970;202011;352590;C;2599302;0;2;-2
549169;202011;352590;G;4772500;2;1;1
549433;202011;352590;I;5611201;1;0;1
549839;202011;352590;I;5620104;1;0;1
549988;202011;352590;I;5611201;1;0;1
550588;202011;352590;G;4782201;1;0;1
550679;202011;352590;G;4771701;0;1;-1
551472;202011;352590;H;4930202;0;1;-1
551769;202011;352590;G;4763602;1;1;0
552241;202011;352590;I;5620101;0;1;-1
552971;202011;352590;G;4771701;1;0;1
552995;202011;352590;N;8230001;19;8;11
553326;202011;352590;N;8211300;4;4;0
553607;202011;352590;G;4774100;0;1;-1
553847;202011;352590;R;9313100;1;0;1
553911;202011;352590;G;4713002;0;1;-1
554142;202011;352590;G;4774100;2;0;2
554144;202011;352590;G;4774100;2;0;2
554212;202011;352590;G;4781400;3;0;3
554606;202011;352590;G;4721102;0;1;-1
555382;202011;352590;I;5611201;0;1;-1
555496;202011;352590;P;8593700;3;0;3
555730;202011;352590;F;4313400;1;0;1
555912;202011;352590;I;5611201;0;1;-1
556513;202011;352590;F;4120400;2;0;2
556799;202011;352590;G;4731800;2;0;2
556823;202011;352590;R;9313100;7;2;5
556954;202011;352590;G;4723700;2;0;2
557178;202011;352590;L;6810201;1;0;1
557564;202011;352590;N;8211300;1;0;1
557651;202011;352590;R;9319199;6;2;4
558797;202011;352590;P;8541400;1;0;1
558996;202011;352590;C;2014200;1;0;1
560494;202011;352590;H;5320201;2;2;0
560618;202011;352590;I;5611201;2;0;2
561908;202011;352590;I;5611203;0;2;-2
563152;202011;352590;S;9601701;1;0;1
563309;202011;352590;G;4633801;3;0;3
563484;202011;352590;G;4772500;2;0;2
563834;202011;352590;K;6492100;0;2;-2
563915;202011;352590;G;4712100;0;1;-1
564592;202011;352590;J;6203100;1;1;0
564699;202011;352590;I;5611201;11;0;11
564966;202011;352590;I;5611201;4;1;3
565345;202011;352590;N;8292000;8;0;8
565474;202011;352590;G;4781400;1;0;1
565585;202011;352590;N;8111700;12;8;4
565792;202011;352590;G;4713002;1;0;1
566447;202011;352590;N;8291100;7;4;3
567843;202011;352590;I;5611203;2;2;0
567959;202011;352590;G;4520007;0;1;-1
568117;202011;352590;G;4723700;3;4;-1
568233;202011;352590;H;4930202;0;9;-9
568235;202011;352590;G;4761003;1;0;1
568601;202011;352590;G;4781400;3;0;3
568758;202011;352590;I;5611201;1;0;1
568761;202011;352590;Q;8711502;1;2;-1
569148;202011;352590;G;4520001;0;1;-1
570679;202011;352590;C;1094500;1;0;1
571062;202011;352590;Q;8630503;1;0;1
571664;202011;352590;G;4721104;0;1;-1
572165;202011;352590;M;7319002;3;3;0
572623;202011;352590;G;4771701;2;0;2
573970;202011;352590;N;8111700;6;4;2
574103;202011;352590;F;4120400;3;5;-2
574113;202011;352590;M;7311400;1;0;1
574155;202011;352590;G;4771701;1;0;1
574321;202011;352590;G;4723700;0;1;-1
574635;202011;352590;I;5611201;14;0;14
575987;202011;352590;G;4744001;3;1;2
576545;202011;352590;G;4781400;0;1;-1
576748;202011;352590;G;4789099;1;0;1
577162;202011;352590;G;4789001;0;1;-1
577166;202011;352590;I;5611203;3;2;1
577461;202011;352590;H;5320201;2;0;2
577730;202011;352590;G;4721104;1;0;1
578479;202011;352590;I;5611203;2;0;2
578596;202011;352590;N;8211300;1;0;1
579295;202011;352590;N;8291100;1;0;1
579792;202011;352590;G;4752100;1;0;1
579898;202011;352590;G;4763601;0;2;-2
580123;202011;352590;G;4729602;0;2;-2
580270;202011;352590;I;5611203;1;0;1
581836;202011;352590;G;4744005;5;0;5
582100;202011;352590;G;4781400;2;2;0
582425;202011;352590;G;4783101;1;0;1
583191;202011;352590;G;4744001;1;0;1
584193;202011;352590;Q;8630506;1;0;1
584322;202011;352590;Q;8650005;1;0;1
584923;202011;352590;G;4686902;5;0;5
584987;202011;352590;N;8211300;2;0;2
585024;202011;352590;S;9602502;2;1;1
585068;202011;352590;J;6209100;19;3;16
585264;202011;352590;S;9602502;1;0;1
585494;202011;352590;I;5611201;2;0;2
585874;202011;352590;Q;8630503;0;1;-1
585988;202011;352590;K;6622300;0;1;-1
586180;202011;352590;C;1091102;4;0;4
586486;202011;352590;G;4530703;1;1;0
586676;202011;352590;I;5611203;1;1;0
587127;202011;352590;G;4781400;1;0;1
587733;202011;352590;G;4782201;4;0;4
588052;202011;352590;G;4761001;2;0;2
588169;202011;352590;P;8599604;2;1;1
588444;202011;352590;G;4637106;2;0;2
588497;202011;352590;G;4781400;0;1;-1
588687;202011;352590;F;4222701;0;1;-1
588688;202011;352590;F;4222701;2;0;2
588756;202011;352590;G;4789099;0;1;-1
588890;202011;352590;I;5611201;2;1;1
590846;202011;352590;G;4781400;3;0;3
590932;202011;352590;P;8593700;4;1;3
591004;202011;352590;Q;8630504;1;0;1
591099;202011;352590;G;4729699;4;0;4
592316;202011;352590;G;4755501;2;0;2
592766;202011;352590;I;5611201;4;0;4
593789;202011;352590;G;4771701;1;0;1
594603;202011;352590;J;6120501;1;1;0
594657;202011;352590;J;6120501;3;0;3
595775;202011;352590;H;4930202;2;1;1
597694;202011;352590;I;5611203;2;2;0
597792;202011;352590;C;1062700;1;2;-1
597793;202011;352590;C;1062700;0;4;-4
598377;202011;352590;C;1813099;11;4;7
598573;202011;352590;H;5222200;0;1;-1
598964;202011;352590;C;2091600;0;1;-1
599052;202011;352590;S;9412099;0;1;-1
599154;202011;352590;Q;8640202;2;0;2
599271;202011;352590;G;4721104;0;1;-1
599546;202011;352590;G;4753900;5;1;4
599557;202011;352590;G;4753900;1;1;0
599614;202011;352590;H;4930202;1;2;-1
599620;202011;352590;F;4120400;20;6;14
599821;202011;352590;C;2019399;1;1;0
599876;202011;352590;C;2599399;2;1;1
599877;202011;352590;C;2599399;0;1;-1
600012;202011;352590;C;2710402;10;8;2
600597;202011;352590;C;2512800;1;0;1
600669;202011;352590;R;9312300;1;0;1
600671;202011;352590;G;4744005;2;2;0
600672;202011;352590;S;9430800;3;2;1
600673;202011;352590;C;2592602;2;0;2
600675;202011;352590;Q;8630504;0;1;-1
600676;202011;352590;S;9430800;2;1;1
600679;202011;352590;K;6550200;13;11;2
600694;202011;352590;K;6550200;9;5;4
600695;202011;352590;Q;8690999;0;1;-1
600706;202011;352590;K;6550200;0;1;-1
600744;202011;352590;K;6550200;16;1;15
600768;202011;352590;F;4399105;5;3;2
600769;202011;352590;C;1013901;0;1;-1
600770;202011;352590;Q;8650004;0;1;-1
600771;202011;352590;M;6920601;1;0;1
600772;202011;352590;S;9521500;1;1;0
600773;202011;352590;I;5611201;1;0;1
600774;202011;352590;G;4755502;0;1;-1
600938;202011;352590;C;2013402;8;3;5
600939;202011;352590;C;2013402;2;0;2
601567;202011;352590;G;4781400;9;7;2
601732;202011;352590;G;4781400;8;4;4
602036;202011;352590;C;2862300;0;1;-1
602149;202011;352590;G;4782201;3;2;1
602151;202011;352590;G;4782201;4;0;4
602154;202011;352590;G;4782201;1;1;0
602158;202011;352590;G;4782201;0;5;-5
602159;202011;352590;G;4782201;1;1;0
602244;202011;352590;G;4711301;13;15;-2
602365;202011;352590;G;4731800;2;2;0
602498;202011;352590;G;4771701;0;1;-1
602721;202011;352590;C;2821601;5;3;2
602731;202011;352590;G;4672900;0;1;-1
602732;202011;352590;G;4713002;1;0;1
602735;202011;352590;O;8411600;8;0;8
603326;202011;352590;C;3250705;7;7;0
603460;202011;352590;C;3101200;0;1;-1
603461;202011;352590;S;9529199;1;0;1
603465;202011;352590;C;2063100;5;4;1
603480;202011;352590;C;2651500;1;0;1
603540;202011;352590;G;4781400;4;1;3
603620;202011;352590;G;4646001;1;0;1
603893;202011;352590;I;5510801;0;2;-2
603908;202011;352590;G;4744002;3;0;3
603930;202011;352590;J;6010100;0;3;-3
603931;202011;352590;H;4930202;2;1;1
603932;202011;352590;G;4639701;2;1;1
603948;202011;352590;G;4754701;1;0;1
603949;202011;352590;F;4313400;0;8;-8
603950;202011;352590;H;4929902;0;1;-1
604009;202011;352590;G;4781400;2;0;2
604111;202011;352590;N;8111700;1;1;0
604173;202011;352590;H;4930202;0;1;-1
604410;202011;352590;G;4781400;6;1;5
604921;202011;352590;G;4711302;1;2;-1
605274;202011;352590;G;4711302;0;2;-2
605546;202011;352590;Q;8640202;4;1;3
605548;202011;352590;Q;8690999;3;2;1
605563;202011;352590;Q;8640299;6;0;6
605568;202011;352590;Q;8640202;2;2;0
605832;202011;352590;G;4789002;1;2;-1
606151;202011;352590;G;4713001;4;0;4
606515;202011;352590;G;4713001;4;1;3
607175;202011;352590;G;4530703;1;0;1
607552;202011;352590;G;4774100;1;0;1
607553;202011;352590;G;4774100;1;0;1
607554;202011;352590;C;2330302;1;0;1
607567;202011;352590;H;4921301;1;5;-4
607814;202011;352590;G;4731800;2;0;2
608384;202011;352590;S;9521500;0;1;-1
608425;202011;352590;Q;8640205;4;5;-1
608478;202011;352590;C;2229399;3;7;-4
608640;202011;352590;S;9430800;0;1;-1
608664;202011;352590;G;4784900;1;0;1
608667;202011;352590;G;4731800;1;0;1
608760;202011;352590;G;4781400;3;1;2
609169;202011;352590;I;5620101;0;1;-1
609247;202011;352590;I;5620101;0;1;-1
609248;202011;352590;I;5620101;1;0;1
609249;202011;352590;I;5620101;0;1;-1
609277;202011;352590;I;5620101;1;0;1
609328;202011;352590;I;5620101;2;0;2
609331;202011;352590;I;5620101;0;1;-1
609390;202011;352590;I;5620101;0;1;-1
609421;202011;352590;I;5620101;0;1;-1
609513;202011;352590;I;5620101;1;0;1
609533;202011;352590;I;5620101;0;1;-1
609666;202011;352590;I;5620101;1;0;1
609672;202011;352590;I;5620101;1;0;1
609683;202011;352590;I;5620101;8;0;8
609818;202011;352590;Q;8630503;2;1;1
609819;202011;352590;H;5223100;0;1;-1
609821;202011;352590;G;4789099;0;1;-1
609823;202011;352590;M;6920601;0;1;-1
609824;202011;352590;G;4530703;1;0;1
609898;202011;352590;P;8599699;6;1;5
609925;202011;352590;G;4755503;1;0;1
610221;202011;352590;C;1330800;25;29;-4
610224;202011;352590;F;4313400;7;0;7
610546;202011;352590;K;6550200;1;0;1
610549;202011;352590;K;6550200;1;1;0
610550;202011;352590;K;6550200;11;7;4
610724;202011;352590;F;4120400;2;0;2
610750;202011;352590;H;4921301;1;1;0
610753;202011;352590;C;1623400;2;1;1
610755;202011;352590;C;1122401;1;2;-1
610756;202011;352590;G;4711302;2;0;2
610758;202011;352590;C;1081302;3;1;2
610760;202011;352590;M;6920601;0;1;-1
610761;202011;352590;C;1112700;3;5;-2
610763;202011;352590;G;4731800;1;0;1
610764;202011;352590;G;4783101;1;0;1
610765;202011;352590;G;4744099;0;1;-1
610766;202011;352590;K;6463800;2;0;2
610767;202011;352590;G;4530703;1;1;0
610768;202011;352590;G;4731800;0;1;-1
610770;202011;352590;P;8513900;2;7;-5
610771;202011;352590;G;4511101;1;1;0
610773;202011;352590;C;2229302;2;1;1
610774;202011;352590;R;9312300;5;1;4
610775;202011;352590;G;4721102;1;0;1
610776;202011;352590;I;5510801;0;1;-1
610781;202011;352590;C;2219600;11;9;2
610783;202011;352590;G;4689399;3;1;2
610785;202011;352590;C;1099601;0;3;-3
610786;202011;352590;C;1629301;2;4;-2
610788;202011;352590;G;4729699;0;2;-2
610790;202011;352590;K;6622300;1;6;-5
610794;202011;352590;C;2212900;2;0;2
610796;202011;352590;G;4672900;0;3;-3
610797;202011;352590;H;4929902;2;4;-2
610799;202011;352590;Q;8610101;29;36;-7
610800;202011;352590;C;2391501;0;1;-1
610806;202011;352590;G;4711302;6;0;6
610808;202011;352590;G;4711302;21;1;20
610811;202011;352590;G;4711302;4;3;1
610813;202011;352590;G;4711302;4;11;-7
610815;202011;352590;G;4711302;9;8;1
610816;202011;352590;G;4711302;2;2;0
610817;202011;352590;G;4711302;19;11;8
610818;202011;352590;G;4711302;4;3;1
610820;202011;352590;G;4711302;10;12;-2
610822;202011;352590;G;4711302;5;4;1
610824;202011;352590;G;4711302;1;1;0
610826;202011;352590;G;4711302;3;4;-1
610827;202011;352590;G;4711302;5;4;1
610828;202011;352590;G;4711302;11;8;3
610829;202011;352590;H;4921301;1;3;-2
610830;202011;352590;C;1311100;0;1;-1
610831;202011;352590;C;1311100;12;25;-13
610832;202011;352590;C;2229301;28;50;-22
610833;202011;352590;C;2229301;21;19;2
610834;202011;352590;C;2229301;61;24;37
610835;202011;352590;C;2229301;5;1;4
610836;202011;352590;C;2229301;6;19;-13
610839;202011;352590;Q;8730102;1;1;0
610842;202011;352590;Q;8800600;0;1;-1
610847;202011;352590;G;4511101;4;7;-3
610855;202011;352590;S;9430800;1;1;0
610856;202011;352590;C;1813099;1;0;1
610860;202011;352590;Q;8610101;2;1;1
610862;202011;352590;M;6920601;1;1;0
610864;202011;352590;Q;8610101;0;12;-12
610868;202011;352590;M;6920601;0;1;-1
610869;202011;352590;C;2342702;1;1;0
610871;202011;352590;G;4721102;2;0;2
610879;202011;352590;Q;8711502;6;4;2
610888;202011;352590;G;4711302;1;9;-8
610889;202011;352590;G;4711302;2;0;2
610890;202011;352590;G;4711302;3;3;0
610891;202011;352590;G;4711302;4;2;2
610893;202011;352590;G;4711302;2;1;1
610895;202011;352590;M;6920601;0;1;-1
610896;202011;352590;S;9420100;0;1;-1
610904;202011;352590;S;9420100;0;1;-1
610905;202011;352590;S;9491000;1;0;1
610906;202011;352590;S;9491000;2;0;2
610907;202011;352590;S;9491000;0;1;-1
610910;202011;352590;S;9491000;0;1;-1
610913;202011;352590;S;9491000;1;0;1
610916;202011;352590;G;4633801;0;2;-2
610919;202011;352590;H;4929902;1;1;0
610921;202011;352590;P;8531700;0;1;-1
610928;202011;352590;S;9491000;3;1;2
610932;202011;352590;G;4771701;1;0;1
610989;202011;352590;C;1053800;1;0;1
611186;202011;352590;N;8211300;1;1;0
611243;202011;352590;N;8299706;1;0;1
611252;202011;352590;G;4789099;1;0;1
611253;202011;352590;F;4313400;0;1;-1
611254;202011;352590;P;8513900;0;1;-1
611257;202011;352590;G;4541203;2;0;2
611276;202011;352590;C;2071100;1;0;1
611534;202011;352590;C;1013901;1;4;-3
611818;202011;352590;G;4744099;0;1;-1
611936;202011;352590;F;4120400;1;0;1
611937;202011;352590;Q;8640202;1;0;1
611939;202011;352590;Q;8640202;0;1;-1
611941;202011;352590;Q;8650004;1;0;1
611943;202011;352590;S;9601701;0;1;-1
611944;202011;352590;S;9491000;1;0;1
611945;202011;352590;Q;8640202;0;4;-4
611946;202011;352590;Q;8640202;0;1;-1
611947;202011;352590;H;4930202;0;2;-2
611949;202011;352590;Q;8650099;0;1;-1
611968;202011;352590;S;9430800;0;1;-1
611969;202011;352590;Q;8610101;6;7;-1
611998;202011;352590;S;9430800;1;2;-1
611999;202011;352590;S;9499500;3;1;2
612007;202011;352590;G;4647801;3;2;1
612119;202011;352590;H;5112901;1;0;1
612169;202011;352590;G;4771701;0;1;-1
612247;202011;352590;C;3250707;3;2;1
612326;202011;352590;C;2342702;3;3;0
612340;202011;352590;G;4661300;10;4;6
612487;202011;352590;P;8512100;0;1;-1
612501;202011;352590;Q;8630502;2;0;2
612502;202011;352590;N;7820500;4;2;2
612551;202011;352590;G;4639701;4;1;3
612567;202011;352590;G;4744099;2;0;2
612592;202011;352590;H;4930202;6;3;3
612611;202011;352590;G;4782201;3;0;3
612612;202011;352590;G;4782201;8;2;6
612752;202011;352590;H;4930202;4;4;0
612814;202011;352590;G;4771702;8;3;5
612930;202011;352590;G;4744001;1;0;1
612980;202011;352590;G;4530703;1;0;1
613000;202011;352590;G;4530701;0;1;-1
613001;202011;352590;G;4530701;3;0;3
613124;202011;352590;G;4721102;2;1;1
613154;202011;352590;C;1031700;8;12;-4
613216;202011;352590;C;2592601;0;1;-1
613486;202011;352590;G;4789004;1;1;0
613733;202011;352590;G;4669999;0;1;-1
613834;202011;352590;G;4789004;1;1;0
614207;202011;352590;G;4663000;0;1;-1
614208;202011;352590;G;4663000;1;0;1
614222;202011;352590;G;4771703;0;1;-1
614330;202011;352590;G;4712100;0;1;-1
614451;202011;352590;C;2222600;1;0;1
614651;202011;352590;G;4781400;0;3;-3
614893;202011;352590;Q;8640203;1;1;0
614942;202011;352590;Q;8711501;1;0;1
614945;202011;352590;M;7112000;2;3;-1
614946;202011;352590;S;9420100;2;0;2
614947;202011;352590;P;8513900;1;0;1
614948;202011;352590;K;6622300;0;1;-1
615028;202011;352590;G;4520001;1;0;1
615209;202011;352590;C;3101200;0;1;-1
615475;202011;352590;C;3101200;1;0;1
615542;202011;352590;G;4520001;1;1;0
615651;202011;352590;G;4712100;0;2;-2
615652;202011;352590;G;4712100;2;1;1
615890;202011;352590;G;4530703;0;1;-1
615891;202011;352590;L;6821801;0;1;-1
615892;202011;352590;R;9313100;1;0;1
615893;202011;352590;N;8112500;1;0;1
615894;202011;352590;Q;8630502;1;0;1
615896;202011;352590;N;8112500;1;1;0
615953;202011;352590;G;4511101;3;0;3
615975;202011;352590;G;4687702;0;1;-1
616082;202011;352590;F;4322301;2;0;2
616607;202011;352590;H;4923002;1;1;0
616655;202011;352590;C;2821602;1;2;-1
616822;202011;352590;G;4761001;0;1;-1
616998;202011;352590;H;4930202;0;1;-1
617045;202011;352590;G;4781400;1;0;1
617158;202011;352590;G;4731800;1;1;0
617184;202011;352590;C;2829199;0;3;-3
617326;202011;352590;G;4712100;0;1;-1
617335;202011;352590;G;4649499;2;0;2
617340;202011;352590;C;2823200;3;0;3
617430;202011;352590;G;4661300;3;1;2
617524;202011;352590;C;2449199;3;0;3
617575;202011;352590;H;4930203;1;0;1
617700;202011;352590;G;4763604;1;0;1
617900;202011;352590;G;4721102;1;1;0
617905;202011;352590;I;5510803;3;1;2
618442;202011;352590;G;4753900;0;2;-2
618472;202011;352590;G;4753900;2;1;1
618628;202011;352590;K;6550200;3;0;3
618629;202011;352590;Q;8610102;1;0;1
618630;202011;352590;Q;8621601;0;1;-1
618631;202011;352590;Q;8610101;3;9;-6
618632;202011;352590;Q;8610102;1;1;0
618855;202011;352590;G;4744005;1;1;0
618857;202011;352590;G;4761003;1;0;1
619026;202011;352590;F;4321500;3;1;2
619271;202011;352590;G;4731800;1;0;1
619397;202011;352590;G;4783101;1;0;1
619515;202011;352590;G;4774100;1;1;0
619880;202011;352590;H;4930202;1;0;1
619918;202011;352590;G;4530703;0;1;-1
620106;202011;352590;C;2099199;6;4;2
620190;202011;352590;C;2539002;2;2;0
620198;202011;352590;C;2592602;0;1;-1
620228;202011;352590;G;4781400;2;0;2
620305;202011;352590;H;4930202;1;0;1
620476;202011;352590;K;6493000;3;2;1
620632;202011;352590;K;6422100;1;0;1
620698;202011;352590;N;8299706;0;1;-1
620799;202011;352590;I;5611201;2;2;0
620873;202011;352590;N;8219901;0;2;-2
620889;202011;352590;I;5611201;5;0;5
620899;202011;352590;G;4781400;0;1;-1
620956;202011;352590;C;2229302;1;0;1
620964;202011;352590;I;5611203;2;0;2
620987;202011;352590;P;8512100;1;0;1
621003;202011;352590;N;8121400;1;4;-3
621005;202011;352590;H;5223100;0;1;-1
621006;202011;352590;H;5223100;0;1;-1
621007;202011;352590;H;5223100;1;2;-1
621158;202011;352590;G;4761003;1;1;0
621269;202011;352590;F;4221902;1;1;0
621329;202011;352590;H;4929902;47;8;39
621359;202011;352590;I;5611201;1;0;1
621404;202011;352590;G;4763601;1;0;1
621684;202011;352590;G;4635402;8;10;-2
621784;202011;352590;C;2229399;5;7;-2
621815;202011;352590;H;4930202;10;1;9
621848;202011;352590;Q;8640205;2;1;1
621884;202011;352590;M;6920601;1;0;1
621886;202011;352590;P;8512100;0;1;-1
621894;202011;352590;Q;8640202;2;1;1
621895;202011;352590;S;9430800;0;2;-2
622016;202011;352590;C;2944100;27;20;7
622050;202011;352590;C;1629301;0;3;-3
622354;202011;352590;G;4744099;0;1;-1
622436;202011;352590;F;4292802;19;3;16
622538;202011;352590;H;4930202;2;1;1
622566;202011;352590;G;4721102;1;0;1
622801;202011;352590;G;4751201;0;1;-1
622805;202011;352590;G;4755502;1;1;0
622824;202011;352590;H;4930202;0;1;-1
622895;202011;352590;H;4930202;0;3;-3
622903;202011;352590;N;7732201;1;0;1
622930;202011;352590;G;4741500;1;1;0
623156;202011;352590;C;1314600;2;1;1
623471;202011;352590;G;4530703;0;1;-1
624021;202011;352590;M;7210000;0;12;-12
624036;202011;352590;G;4530701;1;0;1
624151;202011;352590;C;2522500;10;7;3
624414;202011;352590;Q;8610101;6;10;-4
624455;202011;352590;C;2014200;0;2;-2
624584;202011;352590;C;2599399;1;0;1
624587;202011;352590;C;2812700;5;1;4
624646;202011;352590;K;6422100;0;1;-1
625266;202011;352590;K;6422100;0;1;-1
625309;202011;352590;K;6422100;0;1;-1
625545;202011;352590;K;6422100;0;2;-2
625740;202011;352590;K;6422100;0;2;-2
626447;202011;352590;K;6422100;0;1;-1
626569;202011;352590;C;2222600;1;3;-2
626745;202011;352590;Q;8690999;1;0;1
626795;202011;352590;Q;8640202;0;1;-1
626827;202011;352590;G;4744005;0;1;-1
626835;202011;352590;G;4511104;2;1;1
626866;202011;352590;C;2539000;0;1;-1
626922;202011;352590;B;810099;0;1;-1
626923;202011;352590;C;2330302;3;2;1
627012;202011;352590;P;8513900;1;3;-2
627171;202011;352590;G;4633802;0;1;-1
627203;202011;352590;C;1099603;1;0;1
627345;202011;352590;Q;8800600;1;1;0
627421;202011;352590;C;3104700;1;0;1
627428;202011;352590;P;8513900;0;1;-1
627472;202011;352590;I;5611201;0;1;-1
627539;202011;352590;Q;8640212;2;0;2
627577;202011;352590;S;9491000;1;0;1
627618;202011;352590;C;2599399;1;0;1
627995;202011;352590;G;4713001;5;1;4
628274;202011;352590;G;4713004;7;4;3
628311;202011;352590;G;4646001;0;1;-1
628489;202011;352590;C;2591800;6;3;3
628556;202011;352590;G;4635402;3;2;1
628563;202011;352590;C;1122401;15;7;8
628711;202011;352590;G;4781400;2;3;-1
629065;202011;352590;G;4711302;6;7;-1
629522;202011;352590;C;2099199;1;0;1
629577;202011;352590;G;4771701;1;0;1
629657;202011;352590;G;4771701;1;0;1
629988;202011;352590;G;4771701;1;1;0
630093;202011;352590;G;4771701;0;1;-1
630139;202011;352590;G;4771701;1;0;1
630257;202011;352590;C;2949299;3;12;-9
630324;202011;352590;G;4645101;1;0;1
630636;202011;352590;N;8211300;15;5;10
630720;202011;352590;C;1412601;0;1;-1
630794;202011;352590;C;1411801;2;13;-11
630912;202011;352590;G;4771701;2;1;1
630982;202011;352590;G;4771701;2;0;2
631098;202011;352590;G;4771701;0;2;-2
631133;202011;352590;G;4771701;1;0;1
631352;202011;352590;G;4771701;1;0;1
631405;202011;352590;G;4771701;0;1;-1
631419;202011;352590;G;4771701;2;1;1
631499;202011;352590;G;4771701;0;1;-1
631694;202011;352590;G;4771701;1;0;1
631771;202011;352590;G;4771701;0;1;-1
631780;202011;352590;G;4771701;2;0;2
632146;202011;352590;Q;8800600;1;18;-17
632205;202011;352590;G;4635402;2;3;-1
632452;202011;352590;J;6202300;2;1;1
632457;202011;352590;N;8121400;22;10;12
632587;202011;352590;G;4782202;1;1;0
632588;202011;352590;G;4782202;2;1;1
633532;202011;352590;C;2592601;0;1;-1
633631;202011;352590;F;4321500;5;0;5
634015;202011;352590;G;4633801;0;1;-1
634282;202011;352590;P;8532500;0;1;-1
634376;202011;352590;G;4789002;9;5;4
634386;202011;352590;C;2229301;12;1;11
634531;202011;352590;G;4744099;4;2;2
634565;202011;352590;G;4530701;1;1;0
635427;202011;352590;C;1096100;0;1;-1
635505;202011;352590;J;6209100;4;1;3
635514;202011;352590;Q;8660700;3;4;-1
635567;202011;352590;J;5829800;1;0;1
635620;202011;352590;G;4771701;2;0;2
635635;202011;352590;H;4930202;1;0;1
635659;202011;352590;G;4731800;1;1;0
636170;202011;352590;H;4930202;0;1;-1
636206;202011;352590;G;4789099;3;0;3
636321;202011;352590;C;3314710;5;4;1
636460;202011;352590;G;4752100;0;1;-1
637390;202011;352590;H;4930202;0;2;-2
637403;202011;352590;F;4330401;1;1;0
637499;202011;352590;G;4789099;1;0;1
637536;202011;352590;C;1813099;1;0;1
637733;202011;352590;G;4711302;41;32;9
637776;202011;352590;C;1099699;4;3;1
637877;202011;352590;F;4211101;4;3;1
637911;202011;352590;Q;8650099;1;0;1
637926;202011;352590;G;4783101;0;1;-1
638002;202011;352590;G;4771702;1;0;1
638553;202011;352590;L;6822600;1;0;1
638579;202011;352590;G;4684201;1;0;1
638639;202011;352590;N;7739099;6;7;-1
638663;202011;352590;I;5611203;4;0;4
638664;202011;352590;I;5611203;8;4;4
638749;202011;352590;G;4773300;1;0;1
638770;202011;352590;I;5611201;2;0;2
639338;202011;352590;P;8512100;0;2;-2
639339;202011;352590;N;8111700;32;8;24
639356;202011;352590;Q;8690999;0;2;-2
639365;202011;352590;N;8112500;0;1;-1
639368;202011;352590;N;8112500;1;1;0
639370;202011;352590;N;8121400;2;0;2
639371;202011;352590;Q;8640207;0;2;-2
639451;202011;352590;G;4771701;1;3;-2
639452;202011;352590;G;4771701;0;1;-1
639453;202011;352590;G;4771701;1;0;1
639454;202011;352590;G;4771701;0;1;-1
639486;202011;352590;C;2731700;2;0;2
639535;202011;352590;G;4744005;2;2;0
639721;202011;352590;C;2014200;1;1;0
639749;202011;352590;C;1013901;0;1;-1
639750;202011;352590;G;4722901;3;2;1
639814;202011;352590;F;4120400;1;0;1
639815;202011;352590;F;4120400;23;14;9
639849;202011;352590;C;2222600;0;1;-1
639961;202011;352590;F;4120400;4;1;3
640059;202011;352590;G;4729699;8;2;6
640245;202011;352590;G;4637199;1;0;1
640405;202011;352590;I;5620101;0;1;-1
640414;202011;352590;I;5620101;0;1;-1
640415;202011;352590;I;5620101;0;1;-1
640466;202011;352590;I;5620101;3;2;1
640646;202011;352590;M;6920601;1;0;1
640647;202011;352590;N;8112500;1;0;1
640785;202011;352590;G;4530703;0;1;-1
640810;202011;352590;G;4744005;2;0;2
640847;202011;352590;G;4623199;2;0;2
640859;202011;352590;H;4930202;2;3;-1
640877;202011;352590;C;2599399;0;1;-1
640970;202011;352590;C;2330302;1;0;1
641161;202011;352590;G;4530703;1;0;1
641175;202011;352590;G;4763601;2;0;2
641218;202011;352590;I;5611203;0;1;-1
641941;202011;352590;G;4530703;0;1;-1
641952;202011;352590;G;4712100;1;0;1
642063;202011;352590;J;6203100;1;2;-1
642213;202011;352590;C;2543800;2;0;2
642234;202011;352590;C;2330302;1;1;0
642389;202011;352590;G;4712100;0;1;-1
642391;202011;352590;G;4712100;0;4;-4
642557;202011;352590;G;4771702;2;1;1
644234;202011;352590;G;4511101;0;1;-1
644384;202011;352590;C;2229301;42;19;23
644570;202011;352590;F;4299599;0;2;-2
644603;202011;352590;F;4110700;1;0;1
644679;202011;352590;N;7739099;3;1;2
644685;202011;352590;C;3314710;0;1;-1
644757;202011;352590;G;4771701;0;1;-1
645005;202011;352590;G;4741500;1;1;0
645006;202011;352590;G;4741500;1;2;-1
645010;202011;352590;G;4741500;1;0;1
645015;202011;352590;G;4741500;1;2;-1
645021;202011;352590;G;4741500;4;1;3
646307;202011;352590;C;2822402;2;1;1
646396;202011;352590;G;4744002;1;0;1
646431;202011;352590;G;4530703;0;1;-1
646467;202011;352590;G;4774100;1;0;1
646521;202011;352590;I;5611201;0;2;-2
646566;202011;352590;G;4731800;1;0;1
646581;202011;352590;C;2099199;0;1;-1
646582;202011;352590;G;4692300;1;3;-2
646583;202011;352590;G;4692300;2;0;2
646722;202011;352590;G;4520005;16;1;15
646771;202011;352590;G;4781400;2;0;2
646874;202011;352590;J;5813100;0;3;-3
647390;202011;352590;G;4635402;1;3;-2
648615;202011;352590;H;5310502;2;0;2
649086;202011;352590;C;1330800;1;4;-3
649125;202011;352590;R;9313100;1;0;1
649268;202011;352590;G;4711302;1;1;0
649269;202011;352590;G;4729699;0;1;-1
649307;202011;352590;C;2869100;1;0;1
649354;202011;352590;I;5510801;0;1;-1
649376;202011;352590;N;7820500;18;0;18
649435;202011;352590;H;4930202;1;0;1
649455;202011;352590;G;4721102;2;0;2
649529;202011;352590;J;6201501;0;1;-1
650242;202011;352590;G;4711301;9;16;-7
650882;202011;352590;C;2349401;84;18;66
650888;202011;352590;N;8211300;7;2;5
651444;202011;352590;H;4930202;2;2;0
652524;202011;352590;G;4672900;1;4;-3
652552;202011;352590;H;4930202;1;1;0
653942;202011;352590;H;4930203;4;0;4
654912;202011;352590;G;4757100;0;2;-2
655944;202011;352590;G;4781400;1;1;0
656675;202011;352590;G;4530703;4;4;0
657164;202011;352590;G;4711301;10;6;4
659459;202011;352590;I;5510801;1;1;0
662262;202011;352590;K;6424703;2;1;1
662460;202011;352590;G;4645101;1;0;1
662842;202011;352590;H;4930202;4;3;1
663253;202011;352590;G;4639701;0;2;-2
664212;202011;352590;G;4679604;12;12;0
664726;202011;352590;C;3314710;52;10;42
665728;202011;352590;G;4541201;0;1;-1
665792;202011;352590;G;4783101;1;0;1
669622;202011;352590;G;4661300;0;3;-3
670843;202011;352590;C;2330399;0;1;-1
671843;202011;352590;H;4930202;2;7;-5
673227;202011;352590;C;1733800;18;10;8
673228;202011;352590;C;1733800;5;2;3
674607;202011;352590;K;6422100;0;3;-3
674608;202011;352590;K;6422100;0;1;-1
674643;202011;352590;K;6422100;0;1;-1
677712;202011;352590;G;4744001;3;2;1
678505;202011;352590;G;4781400;1;1;0
678612;202011;352590;G;4781400;2;1;1
681319;202011;352590;I;5620101;1;1;0
682831;202011;352590;C;1733800;11;3;8
683010;202011;352590;N;7732201;1;0;1
683031;202011;352590;G;4759801;0;2;-2
683053;202011;352590;N;8111700;0;1;-1
683351;202011;352590;E;3832700;1;0;1
683352;202011;352590;I;5620101;5;0;5
683370;202011;352590;G;4771702;1;0;1
683467;202011;352590;Q;8630503;1;0;1
684627;202011;352590;H;5229002;1;0;1
684883;202011;352590;G;4752100;2;0;2
685169;202011;352590;C;2813500;11;14;-3
685170;202011;352590;C;2349401;34;22;12
693496;202011;352590;M;6912500;1;0;1
701863;202011;352590;M;6912500;1;1;0
703254;202011;352590;Q;8630503;0;1;-1
