competencia;municipio;secao;subclasse;admitidos;desligados;saldo
202007;352590;G;4751201;3;1;2
202007;352590;G;4772500;1;0;1
202007;352590;G;4771701;0;1;-1
202007;352590;G;4744005;1;0;1
202007;352590;G;4753900;14;1;13
202007;352590;G;4712100;1;0;1
202007;352590;G;4530703;0;1;-1
202007;352590;G;4789099;1;0;1
202007;352590;G;4530703;1;1;0
202007;352590;G;4772500;0;1;-1
202007;352590;G;4530703;0;1;-1
202007;352590;G;4771702;1;2;-1
202007;352590;G;4789099;2;0;2
202007;352590;G;4755502;1;1;0
202007;352590;G;4753900;0;1;-1
202007;352590;G;4781400;0;1;-1
202007;352590;G;4693100;17;5;12
202007;352590;G;4511101;5;2;3
202007;352590;G;4644301;31;22;9
202007;352590;G;4752100;2;0;2
202007;352590;G;4724500;0;2;-2
202007;352590;G;4781400;0;1;-1
202007;352590;G;4689301;1;1;0
202007;352590;G;4751201;0;1;-1
202007;352590;G;4649499;0;2;-2
202007;352590;G;4789099;1;0;1
202007;352590;G;4755502;1;1;0
202007;352590;G;4721104;1;0;1
202007;352590;G;4687703;0;1;-1
202007;352590;G;4634601;4;10;-6
202007;352590;G;4712100;1;1;0
202007;352590;G;4530702;0;2;-2
202007;352590;G;4687703;1;0;1
202007;352590;G;4637106;0;1;-1
202007;352590;G;4731800;0;2;-2
202007;352590;G;4639701;4;1;3
202007;352590;G;4751201;0;1;-1
202007;352590;G;4771701;1;1;0
202007;352590;G;4744001;0;1;-1
202007;352590;G;4511101;0;1;-1
202007;352590;G;4784900;1;2;-1
202007;352590;G;4619200;1;0;1
202007;352590;G;4789099;1;0;1
202007;352590;G;4673700;0;1;-1
202007;352590;G;4530703;0;1;-1
202007;352590;G;4511101;0;1;-1
202007;352590;G;4511101;0;1;-1
202007;352590;G;4511102;0;1;-1
202007;352590;G;4789099;0;1;-1
202007;352590;G;4721102;2;0;2
202007;352590;G;4722901;0;1;-1
202007;352590;G;4754701;1;0;1
202007;352590;G;4754701;2;0;2
202007;352590;G;4754701;0;1;-1
202007;352590;G;4781400;0;1;-1
202007;352590;G;4789099;2;0;2
202007;352590;G;4511102;0;1;-1
202007;352590;G;4781400;0;1;-1
202007;352590;G;4741500;1;0;1
202007;352590;G;4782201;0;1;-1
202007;352590;G;4789099;1;0;1
202007;352590;G;4771701;1;0;1
202007;352590;G;4689399;1;0;1
202007;352590;G;4639701;1;0;1
202007;352590;G;4729699;0;1;-1
202007;352590;G;4633801;0;1;-1
202007;352590;G;4646001;1;7;-6
202007;352590;G;4754703;0;1;-1
202007;352590;G;4789099;0;1;-1
202007;352590;G;4744099;0;1;-1
202007;352590;G;4781400;0;2;-2
202007;352590;G;4711302;1;0;1
202007;352590;G;4754701;1;0;1
202007;352590;G;4633801;0;1;-1
202007;352590;G;4520005;1;0;1
202007;352590;G;4751201;2;1;1
202007;352590;G;4633801;0;2;-2
202007;352590;G;4744005;0;3;-3
202007;352590;G;4721104;1;0;1
202007;352590;G;4731800;0;1;-1
202007;352590;G;4637106;7;3;4
202007;352590;G;4744005;0;1;-1
202007;352590;G;4649499;1;0;1
202007;352590;G;4530703;2;0;2
202007;352590;G;4672900;6;5;1
202007;352590;G;4723700;0;1;-1
202007;352590;G;4781400;1;0;1
202007;352590;G;4541202;1;0;1
202007;352590;G;4639701;9;9;0
202007;352590;G;4789001;1;0;1
202007;352590;G;4789002;1;0;1
202007;352590;G;4789099;0;1;-1
202007;352590;G;4520001;1;0;1
202007;352590;G;4789007;0;1;-1
202007;352590;G;4753900;1;1;0
202007;352590;G;4771701;1;1;0
202007;352590;G;4712100;2;0;2
202007;352590;G;4511101;1;0;1
202007;352590;G;4672900;1;0;1
202007;352590;G;4520002;1;1;0
202007;352590;G;4729699;1;0;1
202007;352590;G;4530703;8;2;6
202007;352590;G;4687701;0;1;-1
202007;352590;G;4731800;1;0;1
202007;352590;G;4784900;3;0;3
202007;352590;G;4723700;0;2;-2
202007;352590;G;4511101;4;6;-2
202007;352590;G;4687703;0;1;-1
202007;352590;G;4722901;1;0;1
202007;352590;G;4755502;0;1;-1
202007;352590;G;4731800;0;1;-1
202007;352590;G;4639701;1;0;1
202007;352590;G;4633801;0;1;-1
202007;352590;G;4744099;0;1;-1
202007;352590;G;4711302;13;4;9
202007;352590;G;4774100;2;0;2
202007;352590;G;4774100;2;0;2
202007;352590;G;4649499;0;1;-1
202007;352590;G;4771701;0;2;-2
202007;352590;G;4751201;0;1;-1
202007;352590;G;4686902;1;1;0
202007;352590;G;4741500;0;1;-1
202007;352590;G;4530703;0;1;-1
202007;352590;G;4759899;0;1;-1
202007;352590;G;4649499;0;2;-2
202007;352590;G;4761001;1;0;1
202007;352590;G;4744099;1;1;0
202007;352590;G;4520001;0;2;-2
202007;352590;G;4753900;2;0;2
202007;352590;G;4744002;1;0;1
202007;352590;G;4645101;2;0;2
202007;352590;G;4711302;19;2;17
202007;352590;G;4711301;181;14;167
202007;352590;G;4689399;0;1;-1
202007;352590;G;4754702;1;1;0
202007;352590;G;4530703;1;0;1
202007;352590;G;4744002;1;0;1
202007;352590;G;4530703;1;0;1
202007;352590;G;4530703;0;1;-1
202007;352590;G;4789001;1;0;1
202007;352590;G;4781400;0;1;-1
202007;352590;G;4712100;4;2;2
202007;352590;G;4789002;0;1;-1
202007;352590;G;4763602;5;0;5
202007;352590;G;4530703;0;1;-1
202007;352590;G;4652400;0;8;-8
202007;352590;G;4633801;1;0;1
202007;352590;G;4633801;0;1;-1
202007;352590;G;4711302;22;15;7
202007;352590;G;4763603;2;0;2
202007;352590;G;4731800;1;1;0
202007;352590;G;4729699;1;2;-1
202007;352590;G;4530703;1;0;1
202007;352590;G;4781400;7;7;0
202007;352590;G;4530703;1;0;1
202007;352590;G;4633801;12;7;5
202007;352590;G;4781400;2;0;2
202007;352590;G;4520005;0;1;-1
202007;352590;G;4713002;0;1;-1
202007;352590;G;4731800;2;1;1
202007;352590;G;4781400;1;0;1
202007;352590;G;4530703;1;0;1
202007;352590;G;4771701;0;2;-2
202007;352590;G;4771701;1;1;0
202007;352590;G;4744003;1;0;1
202007;352590;G;4741500;0;2;-2
202007;352590;G;4741500;1;0;1
202007;352590;G;4741500;0;1;-1
202007;352590;G;4741500;0;1;-1
202007;352590;G;4731800;3;3;0
202007;352590;G;4635402;2;0;2
202007;352590;G;4520004;0;1;-1
202007;352590;G;4789005;1;0;1
202007;352590;G;4520001;0;1;-1
202007;352590;G;4754703;0;1;-1
202007;352590;G;4520005;0;1;-1
202007;352590;G;4781400;0;1;-1
202007;352590;G;4754702;2;0;2
202007;352590;G;4712100;0;1;-1
202007;352590;G;4530703;0;1;-1
202007;352590;G;4617600;2;0;2
202007;352590;G;4511101;0;1;-1
202007;352590;G;4782201;0;1;-1
202007;352590;G;4753900;8;0;8
202007;352590;G;4753900;3;0;3
202007;352590;G;4639701;2;1;1
202007;352590;G;4721104;1;0;1
202007;352590;G;4530703;0;1;-1
202007;352590;G;4751201;1;0;1
202007;352590;G;4731800;0;1;-1
202007;352590;G;4781400;0;1;-1
202007;352590;G;4530703;0;1;-1
202007;352590;G;4712100;0;1;-1
202007;352590;G;4744001;2;2;0
202007;352590;G;4772500;0;1;-1
202007;352590;G;4530703;1;0;1
202007;352590;G;4729699;2;1;1
202007;352590;G;4663000;0;3;-3
202007;352590;G;4729699;0;1;-1
202007;352590;G;4511101;2;1;1
202007;352590;G;4752100;0;1;-1
202007;352590;G;4754701;3;0;3
202007;352590;G;4729699;0;5;-5
202007;352590;G;4520002;0;3;-3
202007;352590;G;4789099;2;0;2
202007;352590;G;4686902;2;4;-2
202007;352590;G;4743100;5;0;5
202007;352590;G;4511101;3;4;-1
202007;352590;G;4669901;1;0;1
202007;352590;G;4774100;1;0;1
202007;352590;G;4754701;30;5;25
202007;352590;G;4754701;6;0;6
202007;352590;G;4530703;0;1;-1
202007;352590;G;4731800;0;1;-1
202007;352590;G;4763603;1;0;1
202007;352590;G;4731800;0;1;-1
202007;352590;G;4771701;1;0;1
202007;352590;G;4722901;0;1;-1
202007;352590;G;4711302;2;0;2
202007;352590;G;4724500;5;19;-14
202007;352590;G;4633801;1;0;1
202007;352590;G;4724500;10;18;-8
202007;352590;G;4721102;1;1;0
202007;352590;G;4781400;2;0;2
202007;352590;G;4772500;0;1;-1
202007;352590;G;4691500;8;2;6
202007;352590;G;4635402;0;1;-1
202007;352590;G;4731800;1;0;1
202007;352590;G;4520005;1;0;1
202007;352590;G;4781400;0;1;-1
202007;352590;G;4757100;1;0;1
202007;352590;G;4712100;0;1;-1
202007;352590;G;4633801;1;1;0
202007;352590;G;4530703;0;1;-1
202007;352590;G;4782201;0;1;-1
202007;352590;G;4520004;1;0;1
202007;352590;G;4744002;1;0;1
202007;352590;G;4744099;1;3;-2
202007;352590;G;4772500;1;1;0
202007;352590;G;4742300;1;0;1
202007;352590;G;4759899;0;1;-1
202007;352590;G;4771701;1;1;0
202007;352590;G;4731800;3;0;3
202007;352590;G;4712100;4;2;2
202007;352590;G;4771701;1;0;1
202007;352590;G;4645103;0;1;-1
202007;352590;G;4687703;1;0;1
202007;352590;G;4646001;1;0;1
202007;352590;G;4712100;1;1;0
202007;352590;G;4781400;3;22;-19
202007;352590;G;4511104;3;1;2
202007;352590;G;4789099;3;1;2
202007;352590;G;4761003;1;0;1
202007;352590;G;4633801;0;1;-1
202007;352590;G;4744002;0;1;-1
202007;352590;G;4751201;1;0;1
202007;352590;G;4773300;1;0;1
202007;352590;G;4781400;0;1;-1
202007;352590;G;4731800;0;1;-1
202007;352590;G;4649499;0;1;-1
202007;352590;G;4772500;0;4;-4
202007;352590;G;4789002;0;1;-1
202007;352590;G;4744004;0;2;-2
202007;352590;G;4789002;0;1;-1
202007;352590;G;4789004;0;1;-1
202007;352590;G;4731800;1;1;0
202007;352590;G;4713002;0;1;-1
202007;352590;G;4761001;0;3;-3
202007;352590;G;4781400;0;1;-1
202007;352590;G;4712100;0;1;-1
202007;352590;G;4711302;0;1;-1
202007;352590;G;4712100;3;1;2
202007;352590;G;4520005;3;0;3
202007;352590;G;4744001;2;1;1
202007;352590;G;4520002;0;1;-1
202007;352590;G;4743100;2;1;1
202007;352590;G;4772500;2;0;2
202007;352590;G;4772500;0;1;-1
202007;352590;G;4691500;8;3;5
202007;352590;G;4637199;1;0;1
202007;352590;G;4639701;0;1;-1
202007;352590;G;4619200;1;0;1
202007;352590;G;4761003;1;0;1
202007;352590;G;4689399;0;1;-1
202007;352590;G;4772500;0;1;-1
202007;352590;G;4669999;1;4;-3
202007;352590;G;4763601;0;2;-2
202007;352590;G;4744005;0;1;-1
202007;352590;G;4722901;0;1;-1
202007;352590;G;4781400;1;0;1
202007;352590;G;4686902;3;1;2
202007;352590;G;4731800;1;1;0
202007;352590;G;4763603;0;1;-1
202007;352590;G;4789099;1;1;0
202007;352590;G;4530704;3;1;2
202007;352590;G;4754701;47;5;42
202007;352590;G;4744099;2;0;2
202007;352590;G;4771702;2;3;-1
202007;352590;G;4530703;4;0;4
202007;352590;G;4713002;0;1;-1
202007;352590;G;4763601;1;0;1
202007;352590;G;4741500;1;0;1
202007;352590;G;4772500;0;1;-1
202007;352590;G;4741500;2;0;2
202007;352590;G;4774100;0;4;-4
202007;352590;G;4721104;8;3;5
202007;352590;G;4637107;1;0;1
202007;352590;G;4754701;4;1;3
202007;352590;G;4744099;6;6;0
202007;352590;G;4721104;0;1;-1
202007;352590;G;4721104;0;2;-2
202007;352590;G;4663000;1;0;1
202007;352590;G;4782201;1;2;-1
202007;352590;G;4712100;0;1;-1
202007;352590;G;4712100;1;0;1
202007;352590;G;4772500;1;0;1
202007;352590;G;4755502;0;1;-1
202007;352590;G;4754701;0;1;-1
202007;352590;G;4712100;1;0;1
202007;352590;G;4721102;1;0;1
202007;352590;G;4754701;0;1;-1
202007;352590;G;4712100;1;3;-2
202007;352590;G;4751201;1;0;1
202007;352590;G;4729699;3;0;3
202007;352590;G;4520005;17;3;14
202007;352590;G;4721104;1;0;1
202007;352590;G;4759801;1;0;1
202007;352590;G;4541201;0;1;-1
202007;352590;G;4663000;1;0;1
202007;352590;G;4752100;1;0;1
202007;352590;G;4771702;5;3;2
202007;352590;G;4789099;1;0;1
202007;352590;G;4752100;5;0;5
202007;352590;G;4754701;1;1;0
202007;352590;G;4634601;1;0;1
202007;352590;G;4789004;2;0;2
202007;352590;G;4687702;0;1;-1
202007;352590;G;4520005;0;2;-2
202007;352590;G;4731800;1;0;1
202007;352590;G;4782201;0;1;-1
202007;352590;G;4722901;0;1;-1
202007;352590;G;4724500;2;0;2
202007;352590;G;4723700;1;0;1
202007;352590;G;4520005;1;0;1
202007;352590;G;4729699;0;1;-1
202007;352590;G;4789004;0;1;-1
202007;352590;G;4712100;0;1;-1
202007;352590;G;4771701;1;0;1
202007;352590;G;4520002;0;1;-1
202007;352590;G;4729699;0;1;-1
202007;352590;G;4761001;0;1;-1
202007;352590;G;4752100;0;1;-1
202007;352590;G;4530703;0;1;-1
202007;352590;G;4530705;1;1;0
202007;352590;G;4774100;1;0;1
202007;352590;G;4789002;0;1;-1
202007;352590;G;4712100;4;2;2
202007;352590;G;4731800;1;1;0
202007;352590;G;4669999;5;1;4
202007;352590;G;4712100;1;0;1
202007;352590;G;4712100;2;0;2
202007;352590;G;4754701;1;0;1
202007;352590;G;4789099;0;1;-1
202007;352590;G;4721102;1;1;0
202007;352590;G;4789001;0;1;-1
202007;352590;G;4712100;0;2;-2
202007;352590;G;4645101;2;20;-18
202007;352590;G;4721102;0;2;-2
202007;352590;G;4731800;3;2;1
202007;352590;G;4744003;1;0;1
202007;352590;G;4752100;0;1;-1
202007;352590;G;4511101;0;1;-1
202007;352590;G;4520001;0;1;-1
202007;352590;G;4754701;1;0;1
202007;352590;G;4649499;1;2;-1
202007;352590;G;4729699;77;4;73
202007;352590;G;4742300;2;3;-1
202007;352590;G;4729699;0;1;-1
202007;352590;G;4646001;0;3;-3
202007;352590;G;4520001;1;0;1
202007;352590;G;4772500;0;1;-1
202007;352590;G;4633801;1;0;1
202007;352590;G;4530703;0;1;-1
202007;352590;G;4711302;1;1;0
202007;352590;G;4639701;17;9;8
202007;352590;G;4753900;25;5;20
202007;352590;G;4759899;0;1;-1
202007;352590;G;4771701;1;0;1
202007;352590;G;4754701;0;1;-1
202007;352590;G;4781400;1;0;1
202007;352590;G;4744099;0;1;-1
202007;352590;G;4781400;0;1;-1
202007;352590;G;4761003;0;1;-1
202007;352590;G;4744099;1;0;1
202007;352590;G;4781400;0;1;-1
202007;352590;G;4789099;1;0;1
202007;352590;G;4721102;0;1;-1
202007;352590;G;4530703;0;1;-1
202007;352590;G;4744005;1;0;1
202007;352590;G;4520002;0;1;-1
202007;352590;G;4755502;1;0;1
202007;352590;G;4774100;0;1;-1
202007;352590;G;4761001;0;4;-4
202007;352590;G;4762800;0;1;-1
202007;352590;G;4724500;3;0;3
202007;352590;G;4713002;0;1;-1
202007;352590;G;4520006;2;1;1
202007;352590;G;4721102;2;1;1
202007;352590;G;4771701;1;0;1
202007;352590;G;4789004;2;0;2
202007;352590;G;4722901;0;1;-1
202007;352590;G;4663000;0;1;-1
202007;352590;G;4687702;1;0;1
202007;352590;G;4520003;2;0;2
202007;352590;G;4744005;1;0;1
202007;352590;G;4711302;2;0;2
202007;352590;G;4744005;0;2;-2
202007;352590;G;4771701;1;0;1
202007;352590;G;4639701;0;1;-1
202007;352590;G;4755503;0;1;-1
202007;352590;G;4520002;1;0;1
202007;352590;G;4789004;1;0;1
202007;352590;G;4729699;1;0;1
202007;352590;G;4729699;0;3;-3
202007;352590;G;4722901;1;1;0
202007;352590;G;4789099;1;0;1
202007;352590;G;4741500;0;1;-1
202007;352590;G;4541203;1;0;1
202007;352590;G;4729699;1;0;1
202007;352590;G;4772500;0;1;-1
202007;352590;G;4520002;0;1;-1
202007;352590;G;4721102;1;0;1
202007;352590;G;4753900;0;5;-5
202007;352590;G;4712100;1;0;1
202007;352590;G;4789099;1;2;-1
202007;352590;G;4782201;0;1;-1
202007;352590;G;4744005;2;0;2
202007;352590;G;4772500;3;0;3
202007;352590;G;4721102;1;0;1
202007;352590;G;4781400;0;1;-1
202007;352590;G;4744099;3;0;3
202007;352590;G;4723700;1;1;0
202007;352590;G;4530703;0;1;-1
202007;352590;G;4789001;0;1;-1
202007;352590;G;4774100;1;0;1
202007;352590;G;4784900;1;0;1
202007;352590;G;4781400;0;1;-1
202007;352590;G;4781400;1;1;0
202007;352590;G;4711301;11;8;3
202007;352590;G;4729602;1;0;1
202007;352590;G;4783101;0;1;-1
202007;352590;G;4711302;0;1;-1
202007;352590;G;4520005;2;0;2
202007;352590;G;4781400;0;1;-1
202007;352590;G;4530702;3;0;3
202007;352590;G;4774100;0;1;-1
202007;352590;G;4781400;0;1;-1
202007;352590;G;4713002;1;0;1
202007;352590;G;4784900;1;0;1
202007;352590;G;4789002;2;0;2
202007;352590;G;4530703;1;0;1
202007;352590;G;4712100;0;1;-1
202007;352590;G;4711302;0;3;-3
202007;352590;G;4757100;0;1;-1
202007;352590;G;4691500;1;0;1
202007;352590;G;4633801;0;1;-1
202007;352590;G;4711302;0;3;-3
202007;352590;G;4753900;0;1;-1
202007;352590;G;4753900;128;31;97
202007;352590;G;4753900;0;2;-2
202007;352590;G;4753900;0;3;-3
202007;352590;G;4712100;1;0;1
202007;352590;G;4744099;2;0;2
202007;352590;G;4781400;0;8;-8
202007;352590;G;4781400;2;4;-2
202007;352590;G;4752100;1;0;1
202007;352590;G;4530703;2;0;2
202007;352590;G;4684299;1;0;1
202007;352590;G;4520002;1;0;1
202007;352590;G;4744001;4;0;4
202007;352590;G;4785799;1;2;-1
202007;352590;G;4669999;5;3;2
202007;352590;G;4669999;1;1;0
202007;352590;G;4729602;2;0;2
202007;352590;G;4754702;3;0;3
202007;352590;G;4771701;1;0;1
202007;352590;G;4774100;1;0;1
202007;352590;G;4771701;1;0;1
202007;352590;G;4774100;0;1;-1
202007;352590;G;4721102;2;0;2
202007;352590;G;4744099;0;1;-1
202007;352590;G;4712100;1;0;1
202007;352590;G;4744001;0;2;-2
202007;352590;G;4712100;0;1;-1
202007;352590;G;4729699;2;0;2
202007;352590;G;4723700;2;0;2
202007;352590;G;4781400;1;1;0
202007;352590;G;4744001;2;0;2
202007;352590;G;4781400;0;1;-1
202007;352590;G;4721104;0;1;-1
202007;352590;G;4753900;0;1;-1
202007;352590;G;4789002;1;0;1
202007;352590;G;4772500;0;1;-1
202007;352590;G;4781400;1;0;1
202007;352590;G;4781400;0;3;-3
202007;352590;G;4781400;0;2;-2
202007;352590;G;4632001;1;0;1
202007;352590;G;4782201;0;8;-8
202007;352590;G;4782201;0;14;-14
202007;352590;G;4782201;0;1;-1
202007;352590;G;4782201;0;13;-13
202007;352590;G;4782201;0;7;-7
202007;352590;G;4782201;0;5;-5
202007;352590;G;4782201;0;16;-16
202007;352590;G;4782201;0;3;-3
202007;352590;G;4711301;23;4;19
202007;352590;G;4731800;3;0;3
202007;352590;G;4744005;1;0;1
202007;352590;G;4744002;1;1;0
202007;352590;G;4639701;1;1;0
202007;352590;G;4754701;0;1;-1
202007;352590;G;4711302;0;4;-4
202007;352590;G;4711301;1;0;1
202007;352590;G;4789007;1;0;1
202007;352590;G;4789002;1;0;1
202007;352590;G;4711302;1;1;0
202007;352590;G;4713001;0;1;-1
202007;352590;G;4731800;0;1;-1
202007;352590;G;4732600;1;0;1
202007;352590;G;4784900;3;2;1
202007;352590;G;4530703;2;0;2
202007;352590;G;4755503;1;0;1
202007;352590;G;4731800;0;1;-1
202007;352590;G;4744002;0;1;-1
202007;352590;G;4711302;1;0;1
202007;352590;G;4744099;1;0;1
202007;352590;G;4771701;0;1;-1
202007;352590;G;4511101;2;2;0
202007;352590;G;4721102;1;1;0
202007;352590;G;4783101;0;1;-1
202007;352590;G;4729699;0;1;-1
202007;352590;G;4530703;0;1;-1
202007;352590;G;4541203;0;1;-1
202007;352590;G;4721102;1;1;0
202007;352590;G;4731800;1;1;0
202007;352590;G;4711302;0;2;-2
202007;352590;G;4711302;3;2;1
202007;352590;G;4711302;0;4;-4
202007;352590;G;4711302;1;6;-5
202007;352590;G;4711302;15;12;3
202007;352590;G;4711302;2;1;1
202007;352590;G;4711302;2;12;-10
202007;352590;G;4639701;0;1;-1
202007;352590;G;4711302;6;4;2
202007;352590;G;4711302;0;1;-1
202007;352590;G;4711302;2;7;-5
202007;352590;G;4711302;3;9;-6
202007;352590;G;4711302;6;15;-9
202007;352590;G;4721102;0;1;-1
202007;352590;G;4511101;0;1;-1
202007;352590;G;4721102;0;1;-1
202007;352590;G;4744005;1;0;1
202007;352590;G;4530703;0;1;-1
202007;352590;G;4744099;1;0;1
202007;352590;G;4711302;4;4;0
202007;352590;G;4711302;6;6;0
202007;352590;G;4711302;3;1;2
202007;352590;G;4711302;2;1;1
202007;352590;G;4711302;3;4;-1
202007;352590;G;4633801;2;1;1
202007;352590;G;4729699;0;1;-1
202007;352590;G;4744099;1;0;1
202007;352590;G;4647801;0;1;-1
202007;352590;G;4661300;1;5;-4
202007;352590;G;4639701;3;4;-1
202007;352590;G;4789008;0;1;-1
202007;352590;G;4771702;5;4;1
202007;352590;G;4755502;1;0;1
202007;352590;G;4744001;0;1;-1
202007;352590;G;4530703;0;1;-1
202007;352590;G;4721102;0;1;-1
202007;352590;G;4771701;0;1;-1
202007;352590;G;4669999;1;0;1
202007;352590;G;4789004;0;1;-1
202007;352590;G;4712100;0;1;-1
202007;352590;G;4712100;0;1;-1
202007;352590;G;4712100;1;1;0
202007;352590;G;4511101;6;2;4
202007;352590;G;4731800;0;1;-1
202007;352590;G;4661300;2;0;2
202007;352590;G;4753900;1;0;1
202007;352590;G;4511102;0;1;-1
202007;352590;G;4511102;1;0;1
202007;352590;G;4744005;0;1;-1
202007;352590;G;4520001;0;1;-1
202007;352590;G;4541205;1;0;1
202007;352590;G;4712100;1;1;0
202007;352590;G;4646001;0;1;-1
202007;352590;G;4763601;0;1;-1
202007;352590;G;4635402;16;6;10
202007;352590;G;4731800;0;1;-1
202007;352590;G;4721102;1;2;-1
202007;352590;G;4789099;0;1;-1
202007;352590;G;4741500;0;1;-1
202007;352590;G;4789004;1;0;1
202007;352590;G;4633802;0;1;-1
202007;352590;G;4731800;0;1;-1
202007;352590;G;4672900;1;0;1
202007;352590;G;4729699;0;1;-1
202007;352590;G;4771701;0;2;-2
202007;352590;G;4744005;1;0;1
202007;352590;G;4511104;0;2;-2
202007;352590;G;4633802;1;0;1
202007;352590;G;4633802;0;1;-1
202007;352590;G;4713001;2;1;1
202007;352590;G;4713004;16;0;16
202007;352590;G;4530703;0;1;-1
202007;352590;G;4635402;1;5;-4
202007;352590;G;4711302;9;8;1
202007;352590;G;4771701;0;1;-1
202007;352590;G;4771701;3;1;2
202007;352590;G;4771701;1;1;0
202007;352590;G;4661300;0;1;-1
202007;352590;G;4771701;0;1;-1
202007;352590;G;4771701;0;1;-1
202007;352590;G;4771701;0;1;-1
202007;352590;G;4771701;0;1;-1
202007;352590;G;4771701;0;1;-1
202007;352590;G;4771701;1;1;0
202007;352590;G;4771701;0;3;-3
202007;352590;G;4771701;0;1;-1
202007;352590;G;4771701;1;0;1
202007;352590;G;4635402;3;0;3
202007;352590;G;4741500;1;0;1
202007;352590;G;4712100;0;1;-1
202007;352590;G;4789002;5;8;-3
202007;352590;G;4744099;0;1;-1
202007;352590;G;4530701;1;0;1
202007;352590;G;4771701;1;1;0
202007;352590;G;4731800;1;0;1
202007;352590;G;4711302;21;21;0
202007;352590;G;4789099;1;3;-2
202007;352590;G;4771701;0;3;-3
202007;352590;G;4744005;1;1;0
202007;352590;G;4711302;1;1;0
202007;352590;G;4684299;1;0;1
202007;352590;G;4729699;0;1;-1
202007;352590;G;4781400;0;1;-1
202007;352590;G;4744005;6;3;3
202007;352590;G;4744005;0;1;-1
202007;352590;G;4721102;0;1;-1
202007;352590;G;4771701;1;0;1
202007;352590;G;4712100;1;0;1
202007;352590;G;4721102;3;1;2
202007;352590;G;4771702;3;4;-1
202007;352590;G;4530703;0;1;-1
202007;352590;G;4511101;1;2;-1
202007;352590;G;4741500;0;1;-1
202007;352590;G;4741500;1;0;1
202007;352590;G;4741500;1;0;1
202007;352590;G;4741500;2;1;1
202007;352590;G;4789099;0;1;-1
202007;352590;G;4692300;1;1;0
202007;352590;G;4635402;1;6;-5
202007;352590;G;4744001;1;1;0
202007;352590;G;4711302;1;0;1
202007;352590;G;4771701;1;0;1
202007;352590;G;4711301;23;14;9
202007;352590;G;4530703;0;1;-1
202007;352590;G;4711301;0;1;-1
202007;352590;G;4679604;1;0;1
202007;352590;G;4541201;0;20;-20
202007;352590;G;4751201;1;1;0
202007;352590;G;4781400;0;1;-1
202104;352590;G;4784900;1;0;1
202104;352590;G;4751201;0;2;-2
202104;352590;G;4633801;1;0;1
202104;352590;G;4530703;1;0;1
202104;352590;G;4672900;0;1;-1
202104;352590;G;4744001;1;0;1
202104;352590;G;4753900;4;3;1
202104;352590;G;4712100;0;1;-1
202104;352590;G;4744002;1;0;1
202104;352590;G;4649406;0;1;-1
202104;352590;G;4672900;3;0;3
202104;352590;G;4789007;0;1;-1
202104;352590;G;4789099;0;1;-1
202104;352590;G;4530703;1;0;1
202104;352590;G;4511102;1;0;1
202104;352590;G;4520001;0;1;-1
202104;352590;G;4732600;0;1;-1
202104;352590;G;4711301;3;9;-6
202104;352590;G;4511101;1;2;-1
202104;352590;G;4742300;0;2;-2
202104;352590;G;4644301;49;43;6
202104;352590;G;4781400;0;1;-1
202104;352590;G;4771701;1;1;0
202104;352590;G;4511102;1;0;1
202104;352590;G;4724500;1;0;1
202104;352590;G;4721102;0;1;-1
202104;352590;G;4781400;0;1;-1
202104;352590;G;4689399;6;0;6
202104;352590;G;4645101;0;1;-1
202104;352590;G;4652400;4;0;4
202104;352590;G;4751201;3;0;3
202104;352590;G;4771701;0;1;-1
202104;352590;G;4649499;0;1;-1
202104;352590;G;4639701;1;1;0
202104;352590;G;4530703;2;0;2
202104;352590;G;4721104;0;1;-1
202104;352590;G;4634601;15;13;2
202104;352590;G;4712100;1;1;0
202104;352590;G;4530701;0;4;-4
202104;352590;G;4687701;1;2;-1
202104;352590;G;4759899;1;3;-2
202104;352590;G;4744005;0;1;-1
202104;352590;G;4781400;1;0;1
202104;352590;G;4751201;1;1;0
202104;352590;G;4731800;1;1;0
202104;352590;G;4754701;0;2;-2
202104;352590;G;4781400;0;1;-1
202104;352590;G;4781400;0;1;-1
202104;352590;G;4731800;1;1;0
202104;352590;G;4530703;0;1;-1
202104;352590;G;4731800;1;1;0
202104;352590;G;4774100;0;1;-1
202104;352590;G;4763601;0;1;-1
202104;352590;G;4721102;0;1;-1
202104;352590;G;4511102;0;1;-1
202104;352590;G;4722901;1;1;0
202104;352590;G;4789099;1;0;1
202104;352590;G;4530705;0;1;-1
202104;352590;G;4721102;1;1;0
202104;352590;G;4731800;2;0;2
202104;352590;G;4722901;1;0;1
202104;352590;G;4789099;2;0;2
202104;352590;G;4754702;0;1;-1
202104;352590;G;4755503;0;1;-1
202104;352590;G;4679601;3;2;1
202104;352590;G;4789001;0;1;-1
202104;352590;G;4789099;2;0;2
202104;352590;G;4771702;0;2;-2
202104;352590;G;4771701;0;1;-1
202104;352590;G;4752100;0;2;-2
202104;352590;G;4689399;0;1;-1
202104;352590;G;4639701;1;4;-3
202104;352590;G;4646001;5;9;-4
202104;352590;G;4744099;1;1;0
202104;352590;G;4771702;1;0;1
202104;352590;G;4781400;1;2;-1
202104;352590;G;4711302;3;0;3
202104;352590;G;4712100;1;0;1
202104;352590;G;4754701;0;2;-2
202104;352590;G;4520005;0;1;-1
202104;352590;G;4789099;0;2;-2
202104;352590;G;4759801;0;1;-1
202104;352590;G;4744005;0;4;-4
202104;352590;G;4789099;0;1;-1
202104;352590;G;4744005;3;0;3
202104;352590;G;4637106;3;2;1
202104;352590;G;4744001;1;0;1
202104;352590;G;4646001;3;0;3
202104;352590;G;4649499;0;2;-2
202104;352590;G;4672900;2;3;-1
202104;352590;G;4742300;0;1;-1
202104;352590;G;4530703;0;1;-1
202104;352590;G;4520001;0;1;-1
202104;352590;G;4771701;0;1;-1
202104;352590;G;4541202;0;1;-1
202104;352590;G;4511101;1;2;-1
202104;352590;G;4753900;1;0;1
202104;352590;G;4731800;3;2;1
202104;352590;G;4639701;9;7;2
202104;352590;G;4731800;1;1;0
202104;352590;G;4771701;0;1;-1
202104;352590;G;4712100;1;0;1
202104;352590;G;4789099;0;2;-2
202104;352590;G;4731800;0;1;-1
202104;352590;G;4520001;1;0;1
202104;352590;G;4789007;3;0;3
202104;352590;G;4753900;1;1;0
202104;352590;G;4744005;1;0;1
202104;352590;G;4724500;1;4;-3
202104;352590;G;4724500;0;2;-2
202104;352590;G;4712100;0;1;-1
202104;352590;G;4712100;1;0;1
202104;352590;G;4520002;2;1;1
202104;352590;G;4729699;1;2;-1
202104;352590;G;4520001;0;1;-1
202104;352590;G;4751201;0;1;-1
202104;352590;G;4530703;8;2;6
202104;352590;G;4731800;1;1;0
202104;352590;G;4782201;1;1;0
202104;352590;G;4789099;0;1;-1
202104;352590;G;4511101;4;5;-1
202104;352590;G;4789001;2;0;2
202104;352590;G;4687703;2;1;1
202104;352590;G;4729699;1;0;1
202104;352590;G;4755502;0;2;-2
202104;352590;G;4781400;1;0;1
202104;352590;G;4772500;0;1;-1
202104;352590;G;4530703;0;1;-1
202104;352590;G;4541203;1;1;0
202104;352590;G;4721102;1;1;0
202104;352590;G;4774100;0;1;-1
202104;352590;G;4721102;0;2;-2
202104;352590;G;4687702;0;1;-1
202104;352590;G;4711302;9;9;0
202104;352590;G;4774100;0;3;-3
202104;352590;G;4753900;0;1;-1
202104;352590;G;4649499;0;1;-1
202104;352590;G;4530703;0;1;-1
202104;352590;G;4759899;0;1;-1
202104;352590;G;4744099;0;1;-1
202104;352590;G;4772500;0;2;-2
202104;352590;G;4772500;0;1;-1
202104;352590;G;4639701;1;2;-1
202104;352590;G;4530703;1;0;1
202104;352590;G;4759899;0;3;-3
202104;352590;G;4759899;1;4;-3
202104;352590;G;4649499;3;7;-4
202104;352590;G;4744099;1;1;0
202104;352590;G;4520001;1;0;1
202104;352590;G;4753900;0;2;-2
202104;352590;G;4744002;0;1;-1
202104;352590;G;4645101;1;0;1
202104;352590;G;4711302;1;6;-5
202104;352590;G;4711301;10;8;2
202104;352590;G;4711302;2;0;2
202104;352590;G;4789099;0;1;-1
202104;352590;G;4789002;1;0;1
202104;352590;G;4761001;0;2;-2
202104;352590;G;4789001;0;2;-2
202104;352590;G;4530703;2;0;2
202104;352590;G;4759899;0;1;-1
202104;352590;G;4721102;0;1;-1
202104;352590;G;4753900;0;1;-1
202104;352590;G;4781400;0;1;-1
202104;352590;G;4744099;0;1;-1
202104;352590;G;4712100;2;3;-1
202104;352590;G;4530703;1;1;0
202104;352590;G;4789002;3;0;3
202104;352590;G;4789002;0;8;-8
202104;352590;G;4751201;1;2;-1
202104;352590;G;4763602;0;1;-1
202104;352590;G;4721102;0;1;-1
202104;352590;G;4759899;1;0;1
202104;352590;G;4763601;0;1;-1
202104;352590;G;4618499;1;0;1
202104;352590;G;4633801;0;1;-1
202104;352590;G;4711302;7;11;-4
202104;352590;G;4713002;0;2;-2
202104;352590;G;4763603;2;1;1
202104;352590;G;4771701;0;1;-1
202104;352590;G;4729699;0;3;-3
202104;352590;G;4530703;0;1;-1
202104;352590;G;4781400;0;3;-3
202104;352590;G;4530703;1;0;1
202104;352590;G;4722901;0;1;-1
202104;352590;G;4633801;4;2;2
202104;352590;G;4744099;1;2;-1
202104;352590;G;4751201;1;0;1
202104;352590;G;4685100;0;2;-2
202104;352590;G;4771701;0;1;-1
202104;352590;G;4771701;0;2;-2
202104;352590;G;4771701;0;1;-1
202104;352590;G;4652400;1;0;1
202104;352590;G;4752100;0;1;-1
202104;352590;G;4722901;1;1;0
202104;352590;G;4741500;0;1;-1
202104;352590;G;4731800;0;2;-2
202104;352590;G;4635402;4;2;2
202104;352590;G;4754703;1;1;0
202104;352590;G;4722901;1;0;1
202104;352590;G;4759899;1;0;1
202104;352590;G;4520001;1;0;1
202104;352590;G;4771702;1;1;0
202104;352590;G;4772500;0;1;-1
202104;352590;G;4754702;0;1;-1
202104;352590;G;4712100;1;0;1
202104;352590;G;4541203;0;1;-1
202104;352590;G;4789001;0;2;-2
202104;352590;G;4753900;0;5;-5
202104;352590;G;4753900;0;1;-1
202104;352590;G;4789099;0;1;-1
202104;352590;G;4789002;1;0;1
202104;352590;G;4639701;2;2;0
202104;352590;G;4781400;0;1;-1
202104;352590;G;4731800;0;1;-1
202104;352590;G;4759899;0;1;-1
202104;352590;G;4729699;1;0;1
202104;352590;G;4530703;0;2;-2
202104;352590;G;4731800;1;0;1
202104;352590;G;4687703;0;1;-1
202104;352590;G;4731800;0;2;-2
202104;352590;G;4686902;0;1;-1
202104;352590;G;4530704;0;1;-1
202104;352590;G;4729699;0;1;-1
202104;352590;G;4530703;8;1;7
202104;352590;G;4744001;0;2;-2
202104;352590;G;4744099;1;0;1
202104;352590;G;4781400;0;1;-1
202104;352590;G;4729699;1;1;0
202104;352590;G;4721104;1;2;-1
202104;352590;G;4672900;1;0;1
202104;352590;G;4789001;0;2;-2
202104;352590;G;4511101;1;0;1
202104;352590;G;4782201;1;0;1
202104;352590;G;4729699;1;5;-4
202104;352590;G;4744001;1;0;1
202104;352590;G;4789099;1;0;1
202104;352590;G;4686902;16;4;12
202104;352590;G;4511101;1;3;-2
202104;352590;G;4789099;0;1;-1
202104;352590;G;4774100;0;2;-2
202104;352590;G;4754701;2;0;2
202104;352590;G;4731800;0;1;-1
202104;352590;G;4731800;5;2;3
202104;352590;G;4789005;0;3;-3
202104;352590;G;4754701;2;1;1
202104;352590;G;4781400;1;0;1
202104;352590;G;4771701;1;0;1
202104;352590;G;4772500;1;0;1
202104;352590;G;4722901;2;2;0
202104;352590;G;4789099;1;0;1
202104;352590;G;4530703;0;1;-1
202104;352590;G;4686902;4;2;2
202104;352590;G;4724500;3;4;-1
202104;352590;G;4633801;0;1;-1
202104;352590;G;4724500;10;3;7
202104;352590;G;4663000;1;0;1
202104;352590;G;4789099;1;0;1
202104;352590;G;4721102;1;0;1
202104;352590;G;4744002;0;1;-1
202104;352590;G;4691500;6;9;-3
202104;352590;G;4520006;2;0;2
202104;352590;G;4731800;1;0;1
202104;352590;G;4511101;0;1;-1
202104;352590;G;4731800;1;1;0
202104;352590;G;4757100;0;1;-1
202104;352590;G;4771701;1;0;1
202104;352590;G;4712100;2;1;1
202104;352590;G;4633801;0;1;-1
202104;352590;G;4511101;0;1;-1
202104;352590;G;4729699;1;0;1
202104;352590;G;4781400;0;2;-2
202104;352590;G;4731800;0;1;-1
202104;352590;G;4782201;0;1;-1
202104;352590;G;4520004;2;0;2
202104;352590;G;4754701;14;5;9
202104;352590;G;4754701;0;1;-1
202104;352590;G;4530703;1;0;1
202104;352590;G;4744003;0;1;-1
202104;352590;G;4789099;1;1;0
202104;352590;G;4773300;1;0;1
202104;352590;G;4742300;0;1;-1
202104;352590;G;4789099;0;1;-1
202104;352590;G;4754701;0;1;-1
202104;352590;G;4731800;2;2;0
202104;352590;G;4712100;0;1;-1
202104;352590;G;4511101;1;2;-1
202104;352590;G;4789099;1;0;1
202104;352590;G;4772500;0;1;-1
202104;352590;G;4530703;1;0;1
202104;352590;G;4712100;1;1;0
202104;352590;G;4669999;1;0;1
202104;352590;G;4623109;9;0;9
202104;352590;G;4781400;5;10;-5
202104;352590;G;4511104;1;2;-1
202104;352590;G;4789099;2;6;-4
202104;352590;G;4761003;0;1;-1
202104;352590;G;4633801;0;1;-1
202104;352590;G;4721102;0;1;-1
202104;352590;G;4751201;0;2;-2
202104;352590;G;4771701;1;0;1
202104;352590;G;4789005;1;1;0
202104;352590;G;4773300;3;0;3
202104;352590;G;4754701;0;1;-1
202104;352590;G;4781400;0;1;-1
202104;352590;G;4633801;1;1;0
202104;352590;G;4731800;1;0;1
202104;352590;G;4649499;1;0;1
202104;352590;G;4782201;1;1;0
202104;352590;G;4782201;0;1;-1
202104;352590;G;4782201;6;0;6
202104;352590;G;4713002;1;1;0
202104;352590;G;4731800;0;1;-1
202104;352590;G;4789004;0;1;-1
202104;352590;G;4743100;0;2;-2
202104;352590;G;4729699;0;1;-1
202104;352590;G;4530703;1;0;1
202104;352590;G;4781400;0;1;-1
202104;352590;G;4782201;0;2;-2
202104;352590;G;4781400;0;3;-3
202104;352590;G;4781400;0;1;-1
202104;352590;G;4712100;1;0;1
202104;352590;G;4783101;0;1;-1
202104;352590;G;4711302;0;1;-1
202104;352590;G;4712100;1;1;0
202104;352590;G;4744099;2;1;1
202104;352590;G;4783101;1;0;1
202104;352590;G;4774100;0;1;-1
202104;352590;G;4759899;1;0;1
202104;352590;G;4743100;0;1;-1
202104;352590;G;4772500;1;0;1
202104;352590;G;4772500;0;1;-1
202104;352590;G;4772500;0;1;-1
202104;352590;G;4530701;0;1;-1
202104;352590;G;4530703;0;2;-2
202104;352590;G;4691500;7;2;5
202104;352590;G;4637199;0;3;-3
202104;352590;G;4687702;0;2;-2
202104;352590;G;4663000;2;0;2
202104;352590;G;4637199;0;1;-1
202104;352590;G;4761003;2;0;2
202104;352590;G;4689399;2;3;-1
202104;352590;G;4669999;6;4;2
202104;352590;G;4722901;0;1;-1
202104;352590;G;4543900;1;0;1
202104;352590;G;4781400;0;2;-2
202104;352590;G;4530703;1;0;1
202104;352590;G;4646001;0;1;-1
202104;352590;G;4789099;2;0;2
202104;352590;G;4530704;3;3;0
202104;352590;G;4753900;0;1;-1
202104;352590;G;4530705;0;1;-1
202104;352590;G;4771701;1;0;1
202104;352590;G;4744001;1;1;0
202104;352590;G;4754701;7;8;-1
202104;352590;G;4744099;4;0;4
202104;352590;G;4771702;3;0;3
202104;352590;G;4759899;0;1;-1
202104;352590;G;4781400;0;1;-1
202104;352590;G;4772500;0;2;-2
202104;352590;G;4530703;2;3;-1
202104;352590;G;4761001;0;1;-1
202104;352590;G;4623109;1;1;0
202104;352590;G;4741500;0;1;-1
202104;352590;G;4772500;0;1;-1
202104;352590;G;4741500;1;1;0
202104;352590;G;4721104;3;9;-6
202104;352590;G;4637107;1;2;-1
202104;352590;G;4754701;0;2;-2
202104;352590;G;4754701;1;2;-1
202104;352590;G;4772500;0;2;-2
202104;352590;G;4757100;2;0;2
202104;352590;G;4782201;0;1;-1
202104;352590;G;4781400;0;1;-1
202104;352590;G;4781400;0;1;-1
202104;352590;G;4712100;0;1;-1
202104;352590;G;4782201;0;2;-2
202104;352590;G;4782201;1;0;1
202104;352590;G;4759899;1;0;1
202104;352590;G;4754701;1;0;1
202104;352590;G;4744004;0;1;-1
202104;352590;G;4712100;1;0;1
202104;352590;G;4781400;0;1;-1
202104;352590;G;4774100;3;0;3
202104;352590;G;4742300;0;1;-1
202104;352590;G;4751201;1;0;1
202104;352590;G;4520005;14;19;-5
202104;352590;G;4721104;0;1;-1
202104;352590;G;4721104;0;3;-3
202104;352590;G;4663000;3;3;0
202104;352590;G;4511102;1;0;1
202104;352590;G;4663000;1;1;0
202104;352590;G;4711302;0;1;-1
202104;352590;G;4721104;0;2;-2
202104;352590;G;4614100;1;1;0
202104;352590;G;4771702;4;5;-1
202104;352590;G;4789099;0;1;-1
202104;352590;G;4754701;0;1;-1
202104;352590;G;4744002;0;1;-1
202104;352590;G;4752100;1;0;1
202104;352590;G;4789004;0;2;-2
202104;352590;G;4744005;1;0;1
202104;352590;G;4732600;0;1;-1
202104;352590;G;4782201;0;1;-1
202104;352590;G;4751201;2;2;0
202104;352590;G;4789004;0;1;-1
202104;352590;G;4774100;2;1;1
202104;352590;G;4663000;2;1;1
202104;352590;G;4724500;1;1;0
202104;352590;G;4782201;0;1;-1
202104;352590;G;4781400;0;1;-1
202104;352590;G;4783101;0;1;-1
202104;352590;G;4530704;1;0;1
202104;352590;G;4753900;0;3;-3
202104;352590;G;4520002;0;4;-4
202104;352590;G;4761001;0;2;-2
202104;352590;G;4520002;2;0;2
202104;352590;G;4652400;0;2;-2
202104;352590;G;4744002;2;2;0
202104;352590;G;4530703;1;0;1
202104;352590;G;4530703;1;2;-1
202104;352590;G;4530705;1;0;1
202104;352590;G;4721102;2;0;2
202104;352590;G;4721102;0;1;-1
202104;352590;G;4721102;1;0;1
202104;352590;G;4754701;4;0;4
202104;352590;G;4752100;0;1;-1
202104;352590;G;4781400;0;1;-1
202104;352590;G;4712100;1;1;0
202104;352590;G;4781400;1;1;0
202104;352590;G;4731800;1;2;-1
202104;352590;G;4723700;0;1;-1
202104;352590;G;4781400;0;1;-1
202104;352590;G;4713002;0;1;-1
202104;352590;G;4669999;5;2;3
202104;352590;G;4672900;0;1;-1
202104;352590;G;4754701;1;1;0
202104;352590;G;4754701;0;1;-1
202104;352590;G;4771701;0;1;-1
202104;352590;G;4781400;2;0;2
202104;352590;G;4672900;1;0;1
202104;352590;G;4723700;2;0;2
202104;352590;G;4789003;0;1;-1
202104;352590;G;4757100;0;1;-1
202104;352590;G;4530703;0;1;-1
202104;352590;G;4645101;35;1;34
202104;352590;G;4783101;0;1;-1
202104;352590;G;4741500;0;2;-2
202104;352590;G;4722901;0;2;-2
202104;352590;G;4731800;0;1;-1
202104;352590;G;4713004;0;1;-1
202104;352590;G;4520001;0;1;-1
202104;352590;G;4759899;1;1;0
202104;352590;G;4754701;1;1;0
202104;352590;G;4731800;1;1;0
202104;352590;G;4729699;1;33;-32
202104;352590;G;4753900;0;3;-3
202104;352590;G;4633801;1;0;1
202104;352590;G;4754701;1;0;1
202104;352590;G;4774100;0;1;-1
202104;352590;G;4772500;1;0;1
202104;352590;G;4729602;0;1;-1
202104;352590;G;4530703;1;0;1
202104;352590;G;4530703;0;1;-1
202104;352590;G;4711302;1;2;-1
202104;352590;G;4639701;3;8;-5
202104;352590;G;4520007;1;1;0
202104;352590;G;4520004;0;1;-1
202104;352590;G;4712100;0;1;-1
202104;352590;G;4753900;0;16;-16
202104;352590;G;4759899;0;1;-1
202104;352590;G;4759899;0;2;-2
202104;352590;G;4771701;1;0;1
202104;352590;G;4753900;0;1;-1
202104;352590;G;4731800;0;1;-1
202104;352590;G;4781400;2;1;1
202104;352590;G;4511102;1;0;1
202104;352590;G;4637199;4;1;3
202104;352590;G;4782201;0;1;-1
202104;352590;G;4789099;2;0;2
202104;352590;G;4722901;3;0;3
202104;352590;G;4722901;0;2;-2
202104;352590;G;4781400;0;1;-1
202104;352590;G;4729699;1;1;0
202104;352590;G;4520007;1;0;1
202104;352590;G;4789099;1;1;0
202104;352590;G;4755502;0;1;-1
202104;352590;G;4789099;0;1;-1
202104;352590;G;4729699;2;0;2
202104;352590;G;4774100;1;0;1
202104;352590;G;4530703;1;0;1
202104;352590;G;4774100;0;1;-1
202104;352590;G;4724500;1;0;1
202104;352590;G;4729602;1;0;1
202104;352590;G;4729602;1;0;1
202104;352590;G;4724500;0;1;-1
202104;352590;G;4520006;1;0;1
202104;352590;G;4773300;0;1;-1
202104;352590;G;4686902;2;2;0
202104;352590;G;4731800;1;0;1
202104;352590;G;4781400;0;1;-1
202104;352590;G;4711302;1;0;1
202104;352590;G;4755501;1;0;1
202104;352590;G;4530703;0;1;-1
202104;352590;G;4722901;1;0;1
202104;352590;G;4693100;0;1;-1
202104;352590;G;4520003;0;1;-1
202104;352590;G;4729602;1;0;1
202104;352590;G;4711302;2;3;-1
202104;352590;G;4721102;1;1;0
202104;352590;G;4729699;0;1;-1
202104;352590;G;4729699;0;1;-1
202104;352590;G;4781400;0;1;-1
202104;352590;G;4789099;1;0;1
202104;352590;G;4713002;2;0;2
202104;352590;G;4773300;0;1;-1
202104;352590;G;4520002;2;0;2
202104;352590;G;4729699;1;0;1
202104;352590;G;4772500;0;1;-1
202104;352590;G;4722901;3;1;2
202104;352590;G;4729699;1;0;1
202104;352590;G;4729602;1;0;1
202104;352590;G;4520002;0;1;-1
202104;352590;G;4751201;1;0;1
202104;352590;G;4721102;0;6;-6
202104;352590;G;4530705;0;1;-1
202104;352590;G;4712100;2;0;2
202104;352590;G;4789099;0;3;-3
202104;352590;G;4744005;0;1;-1
202104;352590;G;4772500;1;2;-1
202104;352590;G;4771701;0;1;-1
202104;352590;G;4781400;0;1;-1
202104;352590;G;4781400;1;0;1
202104;352590;G;4789004;1;1;0
202104;352590;G;4729699;2;0;2
202104;352590;G;4729699;0;4;-4
202104;352590;G;4511101;1;1;0
202104;352590;G;4530705;1;0;1
202104;352590;G;4721104;0;1;-1
202104;352590;G;4723700;0;2;-2
202104;352590;G;4784900;0;1;-1
202104;352590;G;4781400;1;0;1
202104;352590;G;4771701;1;0;1
202104;352590;G;4711301;5;8;-3
202104;352590;G;4783101;0;1;-1
202104;352590;G;4711302;3;0;3
202104;352590;G;4789099;2;0;2
202104;352590;G;4520005;1;1;0
202104;352590;G;4781400;0;1;-1
202104;352590;G;4781400;0;2;-2
202104;352590;G;4530703;0;1;-1
202104;352590;G;4729699;0;1;-1
202104;352590;G;4520002;0;1;-1
202104;352590;G;4782201;0;1;-1
202104;352590;G;4639701;6;8;-2
202104;352590;G;4752100;0;1;-1
202104;352590;G;4637199;9;1;8
202104;352590;G;4722902;0;1;-1
202104;352590;G;4789002;2;3;-1
202104;352590;G;4781400;0;1;-1
202104;352590;G;4721104;1;0;1
202104;352590;G;4781400;1;2;-1
202104;352590;G;4744005;1;0;1
202104;352590;G;4712100;2;0;2
202104;352590;G;4711302;3;2;1
202104;352590;G;4781400;1;0;1
202104;352590;G;4789001;1;1;0
202104;352590;G;4729699;0;1;-1
202104;352590;G;4520006;2;1;1
202104;352590;G;4789001;0;1;-1
202104;352590;G;4711302;0;2;-2
202104;352590;G;4753900;22;53;-31
202104;352590;G;4753900;0;1;-1
202104;352590;G;4753900;0;3;-3
202104;352590;G;4753900;0;3;-3
202104;352590;G;4753900;18;16;2
202104;352590;G;4752100;1;0;1
202104;352590;G;4712100;0;3;-3
202104;352590;G;4712100;0;1;-1
202104;352590;G;4781400;0;1;-1
202104;352590;G;4781400;2;1;1
202104;352590;G;4781400;0;2;-2
202104;352590;G;4781400;0;1;-1
202104;352590;G;4541204;0;1;-1
202104;352590;G;4774100;2;0;2
202104;352590;G;4724500;2;0;2
202104;352590;G;4763602;0;3;-3
202104;352590;G;4781400;0;1;-1
202104;352590;G;4771701;1;0;1
202104;352590;G;4669999;13;3;10
202104;352590;G;4669999;2;0;2
202104;352590;G;4729602;0;1;-1
202104;352590;G;4541203;0;1;-1
202104;352590;G;4771701;2;1;1
202104;352590;G;4520007;1;0;1
202104;352590;G;4781400;0;1;-1
202104;352590;G;4721102;0;1;-1
202104;352590;G;4731800;3;0;3
202104;352590;G;4754701;0;1;-1
202104;352590;G;4729699;1;0;1
202104;352590;G;4781400;0;1;-1
202104;352590;G;4633801;0;2;-2
202104;352590;G;4712100;0;1;-1
202104;352590;G;4729699;0;1;-1
202104;352590;G;4713002;0;1;-1
202104;352590;G;4774100;1;0;1
202104;352590;G;4729699;2;0;2
202104;352590;G;4723700;1;0;1
202104;352590;G;4781400;0;1;-1
202104;352590;G;4520001;0;1;-1
202104;352590;G;4761003;1;0;1
202104;352590;G;4784900;2;0;2
202104;352590;G;4754701;0;1;-1
202104;352590;G;4781400;0;1;-1
202104;352590;G;4744001;2;1;1
202104;352590;G;4781400;0;1;-1
202104;352590;G;4729699;1;0;1
202104;352590;G;4729602;1;0;1
202104;352590;G;4781400;0;1;-1
202104;352590;G;4759899;7;4;3
202104;352590;G;4744005;1;0;1
202104;352590;G;4781400;2;1;1
202104;352590;G;4686902;4;5;-1
202104;352590;G;4530703;2;0;2
202104;352590;G;4723700;1;1;0
202104;352590;G;4781400;0;1;-1
202104;352590;G;4774100;1;0;1
202104;352590;G;4759899;0;1;-1
202104;352590;G;4729699;1;0;1
202104;352590;G;4744001;1;0;1
202104;352590;G;4520005;2;0;2
202104;352590;G;4772500;0;2;-2
202104;352590;G;4635499;1;0;1
202104;352590;G;4729699;1;1;0
202104;352590;G;4633801;5;0;5
202104;352590;G;4669999;3;0;3
202104;352590;G;4774100;2;0;2
202104;352590;G;4774100;2;0;2
202104;352590;G;4771701;1;0;1
202104;352590;G;4721102;4;1;3
202104;352590;G;4772500;1;0;1
202104;352590;G;4771701;1;0;1
202104;352590;G;4789001;3;0;3
202104;352590;G;4711302;0;1;-1
202104;352590;G;4753900;2;2;0
202104;352590;G;4753900;1;1;0
202104;352590;G;4789099;0;1;-1
202104;352590;G;4744005;0;1;-1
202104;352590;G;4530703;1;0;1
202104;352590;G;4781400;0;1;-1
202104;352590;G;4781400;0;1;-1
202104;352590;G;4782201;0;1;-1
202104;352590;G;4782201;1;1;0
202104;352590;G;4782201;0;9;-9
202104;352590;G;4782201;0;1;-1
202104;352590;G;4782201;0;1;-1
202104;352590;G;4711301;11;15;-4
202104;352590;G;4731800;1;2;-1
202104;352590;G;4771701;2;0;2
202104;352590;G;4744005;1;0;1
202104;352590;G;4722901;0;1;-1
202104;352590;G;4530705;1;0;1
202104;352590;G;4744002;5;0;5
202104;352590;G;4639701;16;5;11
202104;352590;G;4731800;1;0;1
202104;352590;G;4781400;0;1;-1
202104;352590;G;4711302;4;2;2
202104;352590;G;4711302;3;3;0
202104;352590;G;4789002;0;1;-1
202104;352590;G;4637107;0;1;-1
202104;352590;G;4713004;1;1;0
202104;352590;G;4712100;1;0;1
202104;352590;G;4731800;0;1;-1
202104;352590;G;4731800;0;1;-1
202104;352590;G;4781400;0;1;-1
202104;352590;G;4781400;1;0;1
202104;352590;G;4772500;0;1;-1
202104;352590;G;4511102;0;1;-1
202104;352590;G;4530703;2;1;1
202104;352590;G;4616800;1;1;0
202104;352590;G;4731800;1;1;0
202104;352590;G;4744099;1;1;0
202104;352590;G;4530703;0;2;-2
202104;352590;G;4689399;1;0;1
202104;352590;G;4729699;0;3;-3
202104;352590;G;4511104;2;2;0
202104;352590;G;4530705;1;0;1
202104;352590;G;4530703;0;1;-1
202104;352590;G;4731800;1;0;1
202104;352590;G;4711302;0;2;-2
202104;352590;G;4711302;0;3;-3
202104;352590;G;4711302;0;1;-1
202104;352590;G;4711302;0;6;-6
202104;352590;G;4711302;5;5;0
202104;352590;G;4711302;1;0;1
202104;352590;G;4711302;7;12;-5
202104;352590;G;4711302;1;4;-3
202104;352590;G;4711302;7;7;0
202104;352590;G;4639701;7;7;0
202104;352590;G;4711302;1;2;-1
202104;352590;G;4711302;3;3;0
202104;352590;G;4711302;1;2;-1
202104;352590;G;4711302;1;1;0
202104;352590;G;4711302;10;11;-1
202104;352590;G;4721102;0;1;-1
202104;352590;G;4744005;1;1;0
202104;352590;G;4530703;0;1;-1
202104;352590;G;4744099;0;1;-1
202104;352590;G;4731800;1;0;1
202104;352590;G;4711302;4;7;-3
202104;352590;G;4711302;2;4;-2
202104;352590;G;4711302;7;2;5
202104;352590;G;4711302;3;1;2
202104;352590;G;4711302;4;4;0
202104;352590;G;4633801;3;2;1
202104;352590;G;4771701;0;1;-1
202104;352590;G;4744099;0;1;-1
202104;352590;G;4661300;8;7;1
202104;352590;G;4639701;0;1;-1
202104;352590;G;4744099;1;3;-2
202104;352590;G;4782201;0;1;-1
202104;352590;G;4782201;0;1;-1
202104;352590;G;4771702;6;4;2
202104;352590;G;4755502;2;0;2
202104;352590;G;4744001;1;0;1
202104;352590;G;4530703;0;1;-1
202104;352590;G;4530701;0;1;-1
202104;352590;G;4721102;1;5;-4
202104;352590;G;4789004;1;3;-2
202104;352590;G;4669999;4;1;3
202104;352590;G;4530704;1;0;1
202104;352590;G;4771701;1;0;1
202104;352590;G;4541203;0;1;-1
202104;352590;G;4520006;0;1;-1
202104;352590;G;4781400;0;1;-1
202104;352590;G;4712100;1;1;0
202104;352590;G;4712100;0;2;-2
202104;352590;G;4712100;0;3;-3
202104;352590;G;4649499;0;1;-1
202104;352590;G;4511101;2;3;-1
202104;352590;G;4789007;0;1;-1
202104;352590;G;4721102;2;0;2
202104;352590;G;4649499;0;1;-1
202104;352590;G;4661300;4;0;4
202104;352590;G;4744005;1;0;1
202104;352590;G;4753900;0;1;-1
202104;352590;G;4761003;1;2;-1
202104;352590;G;4783101;0;1;-1
202104;352590;G;4530703;1;0;1
202104;352590;G;4641901;0;1;-1
202104;352590;G;4781400;0;1;-1
202104;352590;G;4781400;1;0;1
202104;352590;G;4763601;0;1;-1
202104;352590;G;4635402;8;14;-6
202104;352590;G;4520001;0;1;-1
202104;352590;G;4520001;1;2;-1
202104;352590;G;4721102;0;3;-3
202104;352590;G;4755502;0;1;-1
202104;352590;G;4741500;1;0;1
202104;352590;G;4633802;0;1;-1
202104;352590;G;4530703;0;1;-1
202104;352590;G;4729699;0;1;-1
202104;352590;G;4530701;3;1;2
202104;352590;G;4530703;3;0;3
202104;352590;G;4511104;2;0;2
202104;352590;G;4530703;1;0;1
202104;352590;G;4646001;0;1;-1
202104;352590;G;4635402;3;4;-1
202104;352590;G;4781400;1;0;1
202104;352590;G;4647801;5;2;3
202104;352590;G;4711302;4;5;-1
202104;352590;G;4761001;0;4;-4
202104;352590;G;4771701;1;1;0
202104;352590;G;4771701;0;1;-1
202104;352590;G;4771701;1;0;1
202104;352590;G;4731800;0;1;-1
202104;352590;G;4771701;2;2;0
202104;352590;G;4771701;1;1;0
202104;352590;G;4771701;0;1;-1
202104;352590;G;4771701;1;0;1
202104;352590;G;4771701;1;1;0
202104;352590;G;4771701;0;1;-1
202104;352590;G;4771701;0;1;-1
202104;352590;G;4771701;1;0;1
202104;352590;G;4771701;1;2;-1
202104;352590;G;4771701;1;1;0
202104;352590;G;4771701;2;1;1
202104;352590;G;4771701;1;0;1
202104;352590;G;4771701;0;2;-2
202104;352590;G;4771701;1;0;1
202104;352590;G;4743100;1;0;1
202104;352590;G;4782202;0;1;-1
202104;352590;G;4781400;0;1;-1
202104;352590;G;4637107;0;1;-1
202104;352590;G;4759899;1;0;1
202104;352590;G;4789002;3;3;0
202104;352590;G;4744099;0;2;-2
202104;352590;G;4731800;1;1;0
202104;352590;G;4731800;2;0;2
202104;352590;G;4731800;1;1;0
202104;352590;G;4711302;35;25;10
202104;352590;G;4783101;0;1;-1
202104;352590;G;4789099;1;0;1
202104;352590;G;4789099;1;1;0
202104;352590;G;4731800;0;1;-1
202104;352590;G;4771701;2;1;1
202104;352590;G;4771701;1;0;1
202104;352590;G;4771701;1;0;1
202104;352590;G;4744005;2;0;2
202104;352590;G;4711302;1;0;1
202104;352590;G;4722901;0;1;-1
202104;352590;G;4729699;1;0;1
202104;352590;G;4520001;0;1;-1
202104;352590;G;4741500;1;1;0
202104;352590;G;4744005;6;1;5
202104;352590;G;4781400;0;1;-1
202104;352590;G;4623199;4;0;4
202104;352590;G;4729699;0;2;-2
202104;352590;G;4530703;1;0;1
202104;352590;G;4763601;0;1;-1
202104;352590;G;4530703;0;1;-1
202104;352590;G;4712100;3;0;3
202104;352590;G;4712100;1;0;1
202104;352590;G;4721102;0;1;-1
202104;352590;G;4753900;0;1;-1
202104;352590;G;4771702;0;2;-2
202104;352590;G;4782202;0;1;-1
202104;352590;G;4754702;0;1;-1
202104;352590;G;4741500;1;1;0
202104;352590;G;4741500;0;1;-1
202104;352590;G;4741500;0;2;-2
202104;352590;G;4741500;1;1;0
202104;352590;G;4741500;1;0;1
202104;352590;G;4741500;1;0;1
202104;352590;G;4744005;0;1;-1
202104;352590;G;4781400;2;1;1
202104;352590;G;4744002;0;1;-1
202104;352590;G;4530703;0;1;-1
202104;352590;G;4789099;0;1;-1
202104;352590;G;4731800;0;1;-1
202104;352590;G;4731800;0;1;-1
202104;352590;G;4692300;12;6;6
202104;352590;G;4520005;0;1;-1
202104;352590;G;4743100;1;0;1
202104;352590;G;4635402;0;1;-1
202104;352590;G;4744099;2;0;2
202104;352590;G;4711302;1;1;0
202104;352590;G;4711301;5;10;-5
202104;352590;G;4672900;4;4;0
202104;352590;G;4757100;0;1;-1
202104;352590;G;4530703;0;1;-1
202104;352590;G;4711301;3;0;3
202104;352590;G;4639701;3;0;3
202104;352590;G;4679604;10;1;9
202104;352590;G;4541201;0;1;-1
202104;352590;G;4661300;0;2;-2
202104;352590;G;4781400;2;1;1
202104;352590;G;4781400;1;1;0
202104;352590;G;4771702;1;0;1
202104;352590;G;4781400;0;1;-1
202104;352590;G;4642702;0;1;-1
202009;352590;G;4789099;0;1;-1
202009;352590;G;4751201;1;1;0
202009;352590;G;4752100;1;1;0
202009;352590;G;4712100;0;1;-1
202009;352590;G;4789099;2;1;1
202009;352590;G;4781400;0;1;-1
202009;352590;G;4789099;1;1;0
202009;352590;G;4732600;0;1;-1
202009;352590;G;4753900;5;7;-2
202009;352590;G;4753900;1;0;1
202009;352590;G;4753900;1;1;0
202009;352590;G;4672900;1;0;1
202009;352590;G;4789007;0;1;-1
202009;352590;G;4789099;1;0;1
202009;352590;G;4754701;1;1;0
202009;352590;G;4772500;0;1;-1
202009;352590;G;4633801;1;1;0
202009;352590;G;4511102;2;1;1
202009;352590;G;4789099;1;0;1
202009;352590;G;4693100;14;15;-1
202009;352590;G;4511101;6;2;4
202009;352590;G;4644301;27;19;8
202009;352590;G;4752100;1;0;1
202009;352590;G;4789099;1;0;1
202009;352590;G;4721102;2;0;2
202009;352590;G;4781400;0;1;-1
202009;352590;G;4689399;1;0;1
202009;352590;G;4645101;1;0;1
202009;352590;G;4652400;0;1;-1
202009;352590;G;4751201;0;1;-1
202009;352590;G;4744001;0;1;-1
202009;352590;G;4530703;1;0;1
202009;352590;G;4639701;0;1;-1
202009;352590;G;4781400;1;0;1
202009;352590;G;4721104;1;0;1
202009;352590;G;4634601;10;8;2
202009;352590;G;4752100;1;1;0
202009;352590;G;4530703;1;0;1
202009;352590;G;4712100;1;1;0
202009;352590;G;4530701;3;0;3
202009;352590;G;4530702;5;2;3
202009;352590;G;4687703;0;2;-2
202009;352590;G;4759899;2;2;0
202009;352590;G;4731800;0;1;-1
202009;352590;G;4731800;1;0;1
202009;352590;G;4781400;0;1;-1
202009;352590;G;4639701;7;1;6
202009;352590;G;4751201;1;1;0
202009;352590;G;4511101;2;5;-3
202009;352590;G;4731800;1;2;-1
202009;352590;G;4511102;0;1;-1
202009;352590;G;4511101;0;1;-1
202009;352590;G;4511101;0;1;-1
202009;352590;G;4634601;0;1;-1
202009;352590;G;4721104;0;1;-1
202009;352590;G;4781400;1;0;1
202009;352590;G;4754701;2;0;2
202009;352590;G;4789099;0;1;-1
202009;352590;G;4713001;0;1;-1
202009;352590;G;4771702;1;0;1
202009;352590;G;4731800;0;1;-1
202009;352590;G;4752100;0;1;-1
202009;352590;G;4752100;1;1;0
202009;352590;G;4752100;2;0;2
202009;352590;G;4724500;0;1;-1
202009;352590;G;4724500;1;2;-1
202009;352590;G;4771701;0;1;-1
202009;352590;G;4639701;3;2;1
202009;352590;G;4646001;12;1;11
202009;352590;G;4781400;1;0;1
202009;352590;G;4759899;0;1;-1
202009;352590;G;4754701;1;0;1
202009;352590;G;4665600;1;0;1
202009;352590;G;4744099;0;1;-1
202009;352590;G;4711302;1;1;0
202009;352590;G;4711302;0;1;-1
202009;352590;G;4724500;0;1;-1
202009;352590;G;4744005;0;1;-1
202009;352590;G;4754701;1;0;1
202009;352590;G;4633801;0;7;-7
202009;352590;G;4774100;1;0;1
202009;352590;G;4744005;0;2;-2
202009;352590;G;4783101;0;1;-1
202009;352590;G;4789005;0;1;-1
202009;352590;G;4637106;9;6;3
202009;352590;G;4744001;1;0;1
202009;352590;G;4771701;2;0;2
202009;352590;G;4781400;1;0;1
202009;352590;G;4781400;1;0;1
202009;352590;G;4530703;6;5;1
202009;352590;G;4672900;2;0;2
202009;352590;G;4639701;0;1;-1
202009;352590;G;4789099;1;0;1
202009;352590;G;4672900;0;1;-1
202009;352590;G;4520001;0;1;-1
202009;352590;G;4541202;0;1;-1
202009;352590;G;4511101;4;1;3
202009;352590;G;4743100;1;0;1
202009;352590;G;4731800;0;1;-1
202009;352590;G;4639701;10;11;-1
202009;352590;G;4731800;1;0;1
202009;352590;G;4789007;1;0;1
202009;352590;G;4771702;1;1;0
202009;352590;G;4789099;0;1;-1
202009;352590;G;4761003;1;0;1
202009;352590;G;4731800;1;1;0
202009;352590;G;4789001;1;0;1
202009;352590;G;4520001;0;1;-1
202009;352590;G;4789007;2;2;0
202009;352590;G;4781400;0;1;-1
202009;352590;G;4753900;3;1;2
202009;352590;G;4771701;1;0;1
202009;352590;G;4724500;69;0;69
202009;352590;G;4743100;0;1;-1
202009;352590;G;4712100;0;1;-1
202009;352590;G;4520002;2;0;2
202009;352590;G;4744001;1;1;0
202009;352590;G;4729699;2;0;2
202009;352590;G;4729699;0;1;-1
202009;352590;G;4781400;0;1;-1
202009;352590;G;4530703;6;4;2
202009;352590;G;4687701;0;2;-2
202009;352590;G;4731800;1;0;1
202009;352590;G;4782201;0;2;-2
202009;352590;G;4511101;14;8;6
202009;352590;G;4744099;1;0;1
202009;352590;G;4751201;0;1;-1
202009;352590;G;4781400;0;3;-3
202009;352590;G;4781400;0;2;-2
202009;352590;G;4781400;0;1;-1
202009;352590;G;4731800;0;1;-1
202009;352590;G;4781400;1;0;1
202009;352590;G;4772500;1;0;1
202009;352590;G;4752100;0;1;-1
202009;352590;G;4772500;0;1;-1
202009;352590;G;4541203;0;1;-1
202009;352590;G;4687702;1;0;1
202009;352590;G;4693100;1;0;1
202009;352590;G;4711302;5;3;2
202009;352590;G;4753900;1;0;1
202009;352590;G;4649499;1;0;1
202009;352590;G;4771701;0;1;-1
202009;352590;G;4751201;0;1;-1
202009;352590;G;4744099;1;1;0
202009;352590;G;4772500;1;1;0
202009;352590;G;4772500;1;3;-2
202009;352590;G;4781400;1;0;1
202009;352590;G;4741500;0;1;-1
202009;352590;G;4530703;0;1;-1
202009;352590;G;4759899;5;3;2
202009;352590;G;4759899;2;0;2
202009;352590;G;4649499;7;4;3
202009;352590;G;4761001;0;1;-1
202009;352590;G;4520001;1;1;0
202009;352590;G;4744002;2;0;2
202009;352590;G;4712100;0;1;-1
202009;352590;G;4645101;1;0;1
202009;352590;G;4711302;13;13;0
202009;352590;G;4711301;7;23;-16
202009;352590;G;4711302;1;1;0
202009;352590;G;4751200;0;1;-1
202009;352590;G;4744001;0;1;-1
202009;352590;G;4753900;1;0;1
202009;352590;G;4789002;3;1;2
202009;352590;G;4761001;1;1;0
202009;352590;G;4530703;0;3;-3
202009;352590;G;4530703;1;0;1
202009;352590;G;4712100;1;4;-3
202009;352590;G;4789002;2;1;1
202009;352590;G;4763602;1;2;-1
202009;352590;G;4731800;0;3;-3
202009;352590;G;4652400;0;19;-19
202009;352590;G;4687702;0;1;-1
202009;352590;G;4520001;1;1;0
202009;352590;G;4711302;17;8;9
202009;352590;G;4781400;0;1;-1
202009;352590;G;4731800;2;0;2
202009;352590;G;4781400;0;1;-1
202009;352590;G;4754702;0;1;-1
202009;352590;G;4729699;0;1;-1
202009;352590;G;4530703;2;0;2
202009;352590;G;4781400;7;6;1
202009;352590;G;4744099;3;0;3
202009;352590;G;4530703;1;1;0
202009;352590;G;4633801;10;5;5
202009;352590;G;4744099;0;2;-2
202009;352590;G;4685100;0;1;-1
202009;352590;G;4713002;2;0;2
202009;352590;G;4713002;0;3;-3
202009;352590;G;4530703;1;0;1
202009;352590;G;4771701;0;1;-1
202009;352590;G;4652400;1;2;-1
202009;352590;G;4731800;0;1;-1
202009;352590;G;4635402;1;1;0
202009;352590;G;4744002;1;0;1
202009;352590;G;4789005;1;0;1
202009;352590;G;4772500;0;1;-1
202009;352590;G;4754703;1;2;-1
202009;352590;G;4520005;1;0;1
202009;352590;G;4617600;1;1;0
202009;352590;G;4722901;0;1;-1
202009;352590;G;4781400;0;1;-1
202009;352590;G;4771702;0;1;-1
202009;352590;G;4772500;0;1;-1
202009;352590;G;4712100;3;2;1
202009;352590;G;4520001;1;0;1
202009;352590;G;4771702;1;0;1
202009;352590;G;4781400;0;1;-1
202009;352590;G;4511101;1;0;1
202009;352590;G;4530703;1;0;1
202009;352590;G;4753900;1;2;-1
202009;352590;G;4753900;3;2;1
202009;352590;G;4789099;1;1;0
202009;352590;G;4639701;1;1;0
202009;352590;G;4721104;0;1;-1
202009;352590;G;4751201;0;1;-1
202009;352590;G;4729699;1;1;0
202009;352590;G;4731800;2;1;1
202009;352590;G;4744099;1;0;1
202009;352590;G;4759899;0;1;-1
202009;352590;G;4731800;2;0;2
202009;352590;G;4635499;0;5;-5
202009;352590;G;4744001;3;0;3
202009;352590;G;4729699;2;1;1
202009;352590;G;4763601;0;2;-2
202009;352590;G;4744001;1;0;1
202009;352590;G;4729699;3;10;-7
202009;352590;G;4744003;1;0;1
202009;352590;G;4774100;0;1;-1
202009;352590;G;4789099;2;2;0
202009;352590;G;4686902;4;2;2
202009;352590;G;4759899;3;1;2
202009;352590;G;4511101;4;2;2
202009;352590;G;4774100;1;0;1
202009;352590;G;4754701;14;2;12
202009;352590;G;4754701;2;1;1
202009;352590;G;4731800;1;0;1
202009;352590;G;4759899;0;1;-1
202009;352590;G;4731800;1;1;0
202009;352590;G;4789005;1;0;1
202009;352590;G;4520001;0;1;-1
202009;352590;G;4754701;3;1;2
202009;352590;G;4782201;1;0;1
202009;352590;G;4781400;1;0;1
202009;352590;G;4530703;0;1;-1
202009;352590;G;4722901;1;0;1
202009;352590;G;4541203;1;0;1
202009;352590;G;4663000;1;0;1
202009;352590;G;4713002;4;0;4
202009;352590;G;4711302;1;0;1
202009;352590;G;4520002;0;1;-1
202009;352590;G;4724500;12;9;3
202009;352590;G;4724500;14;13;1
202009;352590;G;4781400;2;0;2
202009;352590;G;4721102;1;0;1
202009;352590;G;4691500;7;4;3
202009;352590;G;4721103;2;1;1
202009;352590;G;4731800;1;0;1
202009;352590;G;4520005;0;1;-1
202009;352590;G;4618402;0;1;-1
202009;352590;G;4774100;0;1;-1
202009;352590;G;4771701;1;0;1
202009;352590;G;4712100;1;0;1
202009;352590;G;4633801;0;1;-1
202009;352590;G;4511101;0;1;-1
202009;352590;G;4782201;1;4;-3
202009;352590;G;4520004;0;1;-1
202009;352590;G;4744002;1;0;1
202009;352590;G;4789004;1;0;1
202009;352590;G;4742300;0;1;-1
202009;352590;G;4744099;1;0;1
202009;352590;G;4761003;1;0;1
202009;352590;G;4742300;0;1;-1
202009;352590;G;4732600;1;0;1
202009;352590;G;4635499;1;0;1
202009;352590;G;4712100;4;0;4
202009;352590;G;4771701;0;1;-1
202009;352590;G;4511101;0;2;-2
202009;352590;G;4530703;2;0;2
202009;352590;G;4651601;0;1;-1
202009;352590;G;4646001;0;1;-1
202009;352590;G;4712100;1;0;1
202009;352590;G;4623109;3;2;1
202009;352590;G;4623109;0;1;-1
202009;352590;G;4781400;5;85;-80
202009;352590;G;4511104;1;3;-2
202009;352590;G;4789099;0;3;-3
202009;352590;G;4761003;1;0;1
202009;352590;G;4782201;0;1;-1
202009;352590;G;4781400;1;1;0
202009;352590;G;4781400;1;0;1
202009;352590;G;4633801;1;1;0
202009;352590;G;4751201;1;0;1
202009;352590;G;4520005;1;0;1
202009;352590;G;4773300;1;0;1
202009;352590;G;4649499;5;2;3
202009;352590;G;4789002;0;1;-1
202009;352590;G;4744004;0;1;-1
202009;352590;G;4782201;1;0;1
202009;352590;G;4789004;0;1;-1
202009;352590;G;4789001;0;1;-1
202009;352590;G;4721102;1;1;0
202009;352590;G;4520001;1;1;0
202009;352590;G;4789002;2;0;2
202009;352590;G;4751201;1;0;1
202009;352590;G;4781400;0;1;-1
202009;352590;G;4511102;1;0;1
202009;352590;G;4781400;0;5;-5
202009;352590;G;4689301;1;0;1
202009;352590;G;4731800;1;0;1
202009;352590;G;4781400;1;1;0
202009;352590;G;4634601;0;1;-1
202009;352590;G;4781400;0;1;-1
202009;352590;G;4781400;0;1;-1
202009;352590;G;4712100;2;0;2
202009;352590;G;4757100;1;1;0
202009;352590;G;4744005;1;0;1
202009;352590;G;4783101;3;0;3
202009;352590;G;4755503;0;1;-1
202009;352590;G;4783101;1;0;1
202009;352590;G;4520005;0;1;-1
202009;352590;G;4744001;1;1;0
202009;352590;G;4782201;0;1;-1
202009;352590;G;4754701;1;0;1
202009;352590;G;4781400;1;0;1
202009;352590;G;4772500;1;2;-1
202009;352590;G;4541204;0;1;-1
202009;352590;G;4530701;1;0;1
202009;352590;G;4530703;1;1;0
202009;352590;G;4691500;4;7;-3
202009;352590;G;4743100;1;0;1
202009;352590;G;4637199;0;2;-2
202009;352590;G;4637199;1;0;1
202009;352590;G;4744099;0;1;-1
202009;352590;G;4669999;5;4;1
202009;352590;G;4763601;2;1;1
202009;352590;G;4632003;2;0;2
202009;352590;G;4722901;2;0;2
202009;352590;G;4781400;2;0;2
202009;352590;G;4686902;3;1;2
202009;352590;G;4772500;0;1;-1
202009;352590;G;4763603;1;0;1
202009;352590;G;4646001;0;3;-3
202009;352590;G;4614100;1;0;1
202009;352590;G;4789099;1;1;0
202009;352590;G;4530704;8;1;7
202009;352590;G;4753900;2;0;2
202009;352590;G;4789099;1;0;1
202009;352590;G;4744001;2;0;2
202009;352590;G;4754701;22;31;-9
202009;352590;G;4633801;0;1;-1
202009;352590;G;4744099;4;0;4
202009;352590;G;4771702;1;0;1
202009;352590;G;4759899;5;0;5
202009;352590;G;4772500;0;1;-1
202009;352590;G;4511102;1;0;1
202009;352590;G;4530703;3;0;3
202009;352590;G;4761001;5;4;1
202009;352590;G;4724500;1;0;1
202009;352590;G;4741500;3;0;3
202009;352590;G;4772500;2;1;1
202009;352590;G;4774100;1;0;1
202009;352590;G;4520001;0;1;-1
202009;352590;G;4721104;5;3;2
202009;352590;G;4637107;3;0;3
202009;352590;G;4754701;5;1;4
202009;352590;G;4744099;1;5;-4
202009;352590;G;4744005;0;1;-1
202009;352590;G;4781400;0;1;-1
202009;352590;G;4663000;0;1;-1
202009;352590;G;4781400;0;1;-1
202009;352590;G;4782201;0;1;-1
202009;352590;G;4712100;1;0;1
202009;352590;G;4782201;0;5;-5
202009;352590;G;4782201;1;1;0
202009;352590;G;4759899;0;1;-1
202009;352590;G;4623109;0;1;-1
202009;352590;G;4754701;2;0;2
202009;352590;G;4781400;5;0;5
202009;352590;G;4774100;1;1;0
202009;352590;G;4751201;1;2;-1
202009;352590;G;4781400;0;1;-1
202009;352590;G;4520005;12;6;6
202009;352590;G;4789004;0;1;-1
202009;352590;G;4530703;0;1;-1
202009;352590;G;4541201;0;2;-2
202009;352590;G;4663000;1;0;1
202009;352590;G;4752100;2;1;1
202009;352590;G;4711302;1;0;1
202009;352590;G;4771702;3;2;1
202009;352590;G;4789099;3;0;3
202009;352590;G;4754701;4;0;4
202009;352590;G;4752100;3;1;2
202009;352590;G;4530703;0;1;-1
202009;352590;G;4789004;1;2;-1
202009;352590;G;4530703;1;1;0
202009;352590;G;4782201;0;1;-1
202009;352590;G;4789004;0;1;-1
202009;352590;G;4781400;1;0;1
202009;352590;G;4774100;0;1;-1
202009;352590;G;4781400;1;1;0
202009;352590;G;4663000;0;1;-1
202009;352590;G;4722901;2;0;2
202009;352590;G;4781400;0;1;-1
202009;352590;G;4724500;2;0;2
202009;352590;G;4771701;1;2;-1
202009;352590;G;4781400;1;0;1
202009;352590;G;4754701;2;0;2
202009;352590;G;4712100;0;10;-10
202009;352590;G;4520002;0;1;-1
202009;352590;G;4782202;0;1;-1
202009;352590;G;4753900;3;1;2
202009;352590;G;4722901;1;1;0
202009;352590;G;4774100;0;1;-1
202009;352590;G;4652400;2;1;1
202009;352590;G;4752100;0;1;-1
202009;352590;G;4530703;1;0;1
202009;352590;G;4713002;1;1;0
202009;352590;G;4530705;2;3;-1
202009;352590;G;4520001;0;1;-1
202009;352590;G;4721102;1;2;-1
202009;352590;G;4781400;1;0;1
202009;352590;G;4789002;2;0;2
202009;352590;G;4754701;0;2;-2
202009;352590;G;4781400;0;1;-1
202009;352590;G;4721102;0;1;-1
202009;352590;G;4520001;1;1;0
202009;352590;G;4663000;0;1;-1
202009;352590;G;4781400;0;1;-1
202009;352590;G;4712100;0;1;-1
202009;352590;G;4731800;3;1;2
202009;352590;G;4772500;1;1;0
202009;352590;G;4669999;10;5;5
202009;352590;G;4672900;0;2;-2
202009;352590;G;4754701;0;1;-1
202009;352590;G;4744005;1;0;1
202009;352590;G;4530703;2;0;2
202009;352590;G;4789002;3;0;3
202009;352590;G;4754701;0;1;-1
202009;352590;G;4645101;5;2;3
202009;352590;G;4789004;0;1;-1
202009;352590;G;4789099;1;0;1
202009;352590;G;4729699;1;1;0
202009;352590;G;4731800;1;3;-2
202009;352590;G;4713001;1;5;-4
202009;352590;G;4511101;1;1;0
202009;352590;G;4744001;2;0;2
202009;352590;G;4520001;1;0;1
202009;352590;G;4754701;1;0;1
202009;352590;G;4649499;0;1;-1
202009;352590;G;4754701;1;0;1
202009;352590;G;4729699;13;1;12
202009;352590;G;4789099;1;0;1
202009;352590;G;4789007;0;1;-1
202009;352590;G;4649402;1;0;1
202009;352590;G;4789099;0;1;-1
202009;352590;G;4744003;0;1;-1
202009;352590;G;4742300;0;1;-1
202009;352590;G;4646001;1;0;1
202009;352590;G;4754701;1;0;1
202009;352590;G;4781400;0;1;-1
202009;352590;G;4723700;1;0;1
202009;352590;G;4783101;2;1;1
202009;352590;G;4774100;1;0;1
202009;352590;G;4772500;3;1;2
202009;352590;G;4751201;1;0;1
202009;352590;G;4633801;1;3;-2
202009;352590;G;4771701;1;0;1
202009;352590;G;4530703;1;1;0
202009;352590;G;4633801;0;10;-10
202009;352590;G;4530703;2;3;-1
202009;352590;G;4774100;1;0;1
202009;352590;G;4711302;2;2;0
202009;352590;G;4639701;4;3;1
202009;352590;G;4753900;1;6;-5
202009;352590;G;4530703;0;1;-1
202009;352590;G;4771701;1;0;1
202009;352590;G;4754701;3;0;3
202009;352590;G;4781400;2;0;2
202009;352590;G;4789002;1;1;0
202009;352590;G;4530703;1;0;1
202009;352590;G;4781400;0;1;-1
202009;352590;G;4530705;1;0;1
202009;352590;G;4724500;0;1;-1
202009;352590;G;4633801;0;1;-1
202009;352590;G;4772500;0;1;-1
202009;352590;G;4781400;1;0;1
202009;352590;G;4646001;1;1;0
202009;352590;G;4773300;1;0;1
202009;352590;G;4724500;0;1;-1
202009;352590;G;4541205;0;1;-1
202009;352590;G;4530703;1;0;1
202009;352590;G;4744005;0;1;-1
202009;352590;G;4789099;1;0;1
202009;352590;G;4789099;1;0;1
202009;352590;G;4774100;1;0;1
202009;352590;G;4774100;1;0;1
202009;352590;G;4724500;0;1;-1
202009;352590;G;4713002;1;1;0
202009;352590;G;4721103;0;1;-1
202009;352590;G;4781400;0;1;-1
202009;352590;G;4520006;1;1;0
202009;352590;G;4721102;1;1;0
202009;352590;G;4722901;4;0;4
202009;352590;G;4686902;1;0;1
202009;352590;G;4712100;0;1;-1
202009;352590;G;4729699;0;1;-1
202009;352590;G;4781400;1;0;1
202009;352590;G;4789004;0;1;-1
202009;352590;G;4722901;1;0;1
202009;352590;G;4687702;2;5;-3
202009;352590;G;4772500;1;0;1
202009;352590;G;4713001;0;1;-1
202009;352590;G;4520003;2;0;2
202009;352590;G;4729602;1;0;1
202009;352590;G;4711302;3;2;1
202009;352590;G;4721102;0;1;-1
202009;352590;G;4781400;2;0;2
202009;352590;G;4729699;0;1;-1
202009;352590;G;4713002;1;0;1
202009;352590;G;4633801;0;1;-1
202009;352590;G;4754701;1;0;1
202009;352590;G;4722901;0;1;-1
202009;352590;G;4789099;4;1;3
202009;352590;G;4541203;1;0;1
202009;352590;G;4789099;1;0;1
202009;352590;G;4729699;1;0;1
202009;352590;G;4752100;0;1;-1
202009;352590;G;4712100;1;0;1
202009;352590;G;4789099;2;0;2
202009;352590;G;4772500;1;1;0
202009;352590;G;4781400;2;1;1
202009;352590;G;4781400;1;0;1
202009;352590;G;4781400;1;0;1
202009;352590;G;4781400;0;1;-1
202009;352590;G;4781400;0;1;-1
202009;352590;G;4781400;0;4;-4
202009;352590;G;4789099;1;0;1
202009;352590;G;4744099;1;1;0
202009;352590;G;4511101;3;1;2
202009;352590;G;4520003;1;0;1
202009;352590;G;4723700;0;1;-1
202009;352590;G;4530703;0;1;-1
202009;352590;G;4722902;2;1;1
202009;352590;G;4637104;1;0;1
202009;352590;G;4781400;1;0;1
202009;352590;G;4729699;0;1;-1
202009;352590;G;4789002;0;1;-1
202009;352590;G;4711301;10;7;3
202009;352590;G;4789004;0;1;-1
202009;352590;G;4711302;0;2;-2
202009;352590;G;4789099;0;1;-1
202009;352590;G;4520005;1;0;1
202009;352590;G;4781400;6;0;6
202009;352590;G;4781400;3;0;3
202009;352590;G;4530702;2;0;2
202009;352590;G;4713002;0;1;-1
202009;352590;G;4772500;0;3;-3
202009;352590;G;4752100;1;1;0
202009;352590;G;4637199;4;1;3
202009;352590;G;4729699;1;0;1
202009;352590;G;4721104;0;1;-1
202009;352590;G;4774100;0;1;-1
202009;352590;G;4642701;1;1;0
202009;352590;G;4722902;1;0;1
202009;352590;G;4781400;0;1;-1
202009;352590;G;4789002;0;1;-1
202009;352590;G;4721104;1;1;0
202009;352590;G;4741500;1;0;1
202009;352590;G;4742300;2;1;1
202009;352590;G;4763602;2;1;1
202009;352590;G;4712100;0;1;-1
202009;352590;G;4781400;1;0;1
202009;352590;G;4711302;1;0;1
202009;352590;G;4530703;2;0;2
202009;352590;G;4752100;2;0;2
202009;352590;G;4774100;2;0;2
202009;352590;G;4789001;0;1;-1
202009;352590;G;4520006;2;1;1
202009;352590;G;4711302;0;2;-2
202009;352590;G;4753900;7;1;6
202009;352590;G;4753900;50;40;10
202009;352590;G;4753900;7;2;5
202009;352590;G;4753900;7;4;3
202009;352590;G;4753900;2;1;1
202009;352590;G;4712100;4;1;3
202009;352590;G;4712100;5;1;4
202009;352590;G;4781400;2;2;0
202009;352590;G;4781400;2;1;1
202009;352590;G;4744001;0;1;-1
202009;352590;G;4744005;1;1;0
202009;352590;G;4752100;2;1;1
202009;352590;G;4511102;0;1;-1
202009;352590;G;4530703;0;1;-1
202009;352590;G;4723700;1;0;1
202009;352590;G;4741500;1;0;1
202009;352590;G;4721104;1;0;1
202009;352590;G;4752100;0;1;-1
202009;352590;G;4729699;1;0;1
202009;352590;G;4763602;1;1;0
202009;352590;G;4669999;6;6;0
202009;352590;G;4669999;1;5;-4
202009;352590;G;4729602;1;0;1
202009;352590;G;4772500;2;1;1
202009;352590;G;4772500;3;0;3
202009;352590;G;4782201;1;0;1
202009;352590;G;4771701;0;2;-2
202009;352590;G;4520007;1;0;1
202009;352590;G;4782201;2;1;1
202009;352590;G;4713002;2;0;2
202009;352590;G;4781400;1;0;1
202009;352590;G;4744099;1;0;1
202009;352590;G;4781400;0;1;-1
202009;352590;G;4633801;2;0;2
202009;352590;G;4712100;3;0;3
202009;352590;G;4781400;1;0;1
202009;352590;G;4729699;0;1;-1
202009;352590;G;4723700;1;2;-1
202009;352590;G;4759899;5;0;5
202009;352590;G;4761003;2;0;2
202009;352590;G;4754701;0;1;-1
202009;352590;G;4771701;2;0;2
202009;352590;G;4744001;2;1;1
202009;352590;G;4789099;3;0;3
202009;352590;G;4789001;4;1;3
202009;352590;G;4729699;1;0;1
202009;352590;G;4520002;2;0;2
202009;352590;G;4711302;1;0;1
202009;352590;G;4647801;1;2;-1
202009;352590;G;4753900;0;2;-2
202009;352590;G;4753900;0;1;-1
202009;352590;G;4789099;0;2;-2
202009;352590;G;4744005;0;1;-1
202009;352590;G;4530703;1;0;1
202009;352590;G;4781400;0;3;-3
202009;352590;G;4782201;0;2;-2
202009;352590;G;4711301;9;20;-11
202009;352590;G;4731800;1;1;0
202009;352590;G;4771701;1;0;1
202009;352590;G;4744005;0;1;-1
202009;352590;G;4781400;1;3;-2
202009;352590;G;4744002;0;2;-2
202009;352590;G;4639701;8;2;6
202009;352590;G;4754701;0;1;-1
202009;352590;G;4731800;1;1;0
202009;352590;G;4711302;0;6;-6
202009;352590;G;4771701;0;1;-1
202009;352590;G;4711302;0;4;-4
202009;352590;G;4713001;0;1;-1
202009;352590;G;4713001;1;0;1
202009;352590;G;4774100;1;0;1
202009;352590;G;4712100;1;1;0
202009;352590;G;4731800;1;1;0
202009;352590;G;4744099;2;1;1
202009;352590;G;4731800;0;1;-1
202009;352590;G;4711302;1;2;-1
202009;352590;G;4784900;1;0;1
202009;352590;G;4781400;0;1;-1
202009;352590;G;4741500;0;1;-1
202009;352590;G;4772500;0;2;-2
202009;352590;G;4772500;2;1;1
202009;352590;G;4763604;1;0;1
202009;352590;G;4755503;1;0;1
202009;352590;G;4711302;0;3;-3
202009;352590;G;4712100;1;0;1
202009;352590;G;4744099;1;1;0
202009;352590;G;4530703;0;1;-1
202009;352590;G;4721102;0;1;-1
202009;352590;G;4689399;1;1;0
202009;352590;G;4729699;2;0;2
202009;352590;G;4511104;2;2;0
202009;352590;G;4672900;0;2;-2
202009;352590;G;4712100;0;1;-1
202009;352590;G;4753900;0;1;-1
202009;352590;G;4721102;0;1;-1
202009;352590;G;4763603;0;1;-1
202009;352590;G;4731800;2;0;2
202009;352590;G;4711302;0;1;-1
202009;352590;G;4711302;0;3;-3
202009;352590;G;4711302;0;2;-2
202009;352590;G;4711302;2;3;-1
202009;352590;G;4711302;8;4;4
202009;352590;G;4731800;1;0;1
202009;352590;G;4711302;11;3;8
202009;352590;G;4711302;1;1;0
202009;352590;G;4711302;14;13;1
202009;352590;G;4711302;4;1;3
202009;352590;G;4711302;5;4;1
202009;352590;G;4711302;5;5;0
202009;352590;G;4711302;1;6;-5
202009;352590;G;4711302;7;5;2
202009;352590;G;4711302;13;18;-5
202009;352590;G;4511101;2;3;-1
202009;352590;G;4721102;0;1;-1
202009;352590;G;4744005;1;0;1
202009;352590;G;4744099;0;1;-1
202009;352590;G;4711302;3;6;-3
202009;352590;G;4711302;1;5;-4
202009;352590;G;4711302;0;4;-4
202009;352590;G;4711302;1;2;-1
202009;352590;G;4711302;2;4;-2
202009;352590;G;4633801;8;1;7
202009;352590;G;4771701;0;1;-1
202009;352590;G;4789099;2;0;2
202009;352590;G;4744099;1;0;1
202009;352590;G;4647801;0;2;-2
202009;352590;G;4661300;9;5;4
202009;352590;G;4744001;1;0;1
202009;352590;G;4639701;0;1;-1
202009;352590;G;4782201;2;1;1
202009;352590;G;4782201;3;0;3
202009;352590;G;4771702;10;5;5
202009;352590;G;4755502;0;1;-1
202009;352590;G;4530703;0;3;-3
202009;352590;G;4721102;1;0;1
202009;352590;G;4771701;1;0;1
202009;352590;G;4771701;0;1;-1
202009;352590;G;4789004;3;1;2
202009;352590;G;4669999;2;1;1
202009;352590;G;4771703;0;1;-1
202009;352590;G;4541203;0;1;-1
202009;352590;G;4520001;1;1;0
202009;352590;G;4712100;1;0;1
202009;352590;G;4633801;0;2;-2
202009;352590;G;4712100;3;1;2
202009;352590;G;4511101;4;3;1
202009;352590;G;4520001;1;0;1
202009;352590;G;4789007;1;0;1
202009;352590;G;4712100;1;0;1
202009;352590;G;4712100;0;1;-1
202009;352590;G;4781400;1;0;1
202009;352590;G;4661300;6;3;3
202009;352590;G;4789099;0;1;-1
202009;352590;G;4789005;0;1;-1
202009;352590;G;4649403;0;1;-1
202009;352590;G;4761003;0;1;-1
202009;352590;G;4753900;6;2;4
202009;352590;G;4753900;1;2;-1
202009;352590;G;4673700;0;1;-1
202009;352590;G;4744005;0;3;-3
202009;352590;G;4761003;1;1;0
202009;352590;G;4530703;0;1;-1
202009;352590;G;4774100;1;1;0
202009;352590;G;4721103;1;0;1
202009;352590;G;4712100;0;2;-2
202009;352590;G;4763601;0;1;-1
202009;352590;G;4721102;0;1;-1
202009;352590;G;4763601;1;2;-1
202009;352590;G;4635402;7;4;3
202009;352590;G;4772500;0;1;-1
202009;352590;G;4789099;1;0;1
202009;352590;G;4731800;1;0;1
202009;352590;G;4741500;0;1;-1
202009;352590;G;4789004;0;1;-1
202009;352590;G;4731800;0;2;-2
202009;352590;G;4743100;1;1;0
202009;352590;G;4744002;1;0;1
202009;352590;G;4530701;1;1;0
202009;352590;G;4771701;1;1;0
202009;352590;G;4744005;1;1;0
202009;352590;G;4633802;1;0;1
202009;352590;G;4633802;0;2;-2
202009;352590;G;4713004;2;5;-3
202009;352590;G;4646001;0;1;-1
202009;352590;G;4755502;0;1;-1
202009;352590;G;4635402;5;4;1
202009;352590;G;4711302;3;5;-2
202009;352590;G;4771701;0;1;-1
202009;352590;G;4771701;1;0;1
202009;352590;G;4771701;1;1;0
202009;352590;G;4771701;0;1;-1
202009;352590;G;4645101;1;1;0
202009;352590;G;4731800;0;1;-1
202009;352590;G;4771701;1;0;1
202009;352590;G;4771701;1;1;0
202009;352590;G;4771701;1;0;1
202009;352590;G;4771701;1;0;1
202009;352590;G;4771701;1;0;1
202009;352590;G;4771701;0;1;-1
202009;352590;G;4771701;1;0;1
202009;352590;G;4771701;1;0;1
202009;352590;G;4771701;1;0;1
202009;352590;G;4771701;1;0;1
202009;352590;G;4771701;1;0;1
202009;352590;G;4771701;1;1;0
202009;352590;G;4771701;0;1;-1
202009;352590;G;4635402;6;2;4
202009;352590;G;4743100;0;1;-1
202009;352590;G;4741500;0;1;-1
202009;352590;G;4679603;1;0;1
202009;352590;G;4789002;3;0;3
202009;352590;G;4744099;4;2;2
202009;352590;G;4530701;1;1;0
202009;352590;G;4755503;0;1;-1
202009;352590;G;4649408;0;1;-1
202009;352590;G;4789099;0;1;-1
202009;352590;G;4711302;20;26;-6
202009;352590;G;4783101;2;0;2
202009;352590;G;4771702;0;1;-1
202009;352590;G;4773300;1;0;1
202009;352590;G;4771701;1;1;0
202009;352590;G;4754701;0;1;-1
202009;352590;G;4744005;1;0;1
202009;352590;G;4711302;0;1;-1
202009;352590;G;4729699;0;1;-1
202009;352590;G;4789099;1;0;1
202009;352590;G;4744005;3;3;0
202009;352590;G;4623199;14;0;14
202009;352590;G;4721102;0;1;-1
202009;352590;G;4789004;1;0;1
202009;352590;G;4771702;3;3;0
202009;352590;G;4511101;1;2;-1
202009;352590;G;4741500;1;1;0
202009;352590;G;4741500;1;0;1
202009;352590;G;4741500;2;0;2
202009;352590;G;4744005;1;0;1
202009;352590;G;4744001;0;1;-1
202009;352590;G;4530703;1;0;1
202009;352590;G;4789099;0;1;-1
202009;352590;G;4692300;5;3;2
202009;352590;G;4520005;1;1;0
202009;352590;G;4635402;0;6;-6
202009;352590;G;4789099;1;0;1
202009;352590;G;4744001;1;0;1
202009;352590;G;4711302;0;1;-1
202009;352590;G;4771701;1;0;1
202009;352590;G;4711301;24;14;10
202009;352590;G;4672900;6;2;4
202009;352590;G;4781400;1;1;0
202009;352590;G;4530703;2;1;1
202009;352590;G;4711301;1;8;-7
202009;352590;G;4679604;1;2;-1
202009;352590;G;4783101;2;1;1
202009;352590;G;4783101;1;0;1
202009;352590;G;4661300;3;0;3
202009;352590;G;4751201;1;0;1
202009;352590;G;4744001;6;1;5
202009;352590;G;4781400;0;2;-2
202009;352590;G;4781400;2;0;2
202009;352590;G;4642702;1;1;0
202009;352590;G;4752100;1;0;1
202102;352590;G;4751201;1;1;0
202102;352590;G;4633801;1;0;1
202102;352590;G;4744005;0;1;-1
202102;352590;G;4744005;1;0;1
202102;352590;G;4672900;1;0;1
202102;352590;G;4789099;0;1;-1
202102;352590;G;4732600;1;0;1
202102;352590;G;4757100;0;1;-1
202102;352590;G;4753900;4;6;-2
202102;352590;G;4753900;1;0;1
202102;352590;G;4789099;0;1;-1
202102;352590;G;4744002;0;1;-1
202102;352590;G;4672900;0;1;-1
202102;352590;G;4789099;0;1;-1
202102;352590;G;4721102;0;1;-1
202102;352590;G;4772500;0;1;-1
202102;352590;G;4633801;1;1;0
202102;352590;G;4763604;1;0;1
202102;352590;G;4771702;0;1;-1
202102;352590;G;4530705;2;0;2
202102;352590;G;4789099;1;0;1
202102;352590;G;4789099;0;3;-3
202102;352590;G;4711301;11;9;2
202102;352590;G;4511101;5;8;-3
202102;352590;G;4742300;2;1;1
202102;352590;G;4644301;35;34;1
202102;352590;G;4771701;1;0;1
202102;352590;G;4763602;0;1;-1
202102;352590;G;4721102;3;1;2
202102;352590;G;4781400;0;1;-1
202102;352590;G;4689399;2;2;0
202102;352590;G;4652400;7;3;4
202102;352590;G;4772500;1;1;0
202102;352590;G;4689301;2;0;2
202102;352590;G;4751201;2;0;2
202102;352590;G;4530703;1;1;0
202102;352590;G;4744001;0;1;-1
202102;352590;G;4639701;3;2;1
202102;352590;G;4781400;0;1;-1
202102;352590;G;4789099;0;1;-1
202102;352590;G;4712100;0;1;-1
202102;352590;G;4789099;4;0;4
202102;352590;G;4530703;0;1;-1
202102;352590;G;4687703;3;0;3
202102;352590;G;4634601;1;5;-4
202102;352590;G;4752100;1;1;0
202102;352590;G;4712100;1;1;0
202102;352590;G;4751201;0;1;-1
202102;352590;G;4763603;1;0;1
202102;352590;G;4530701;2;2;0
202102;352590;G;4712100;1;1;0
202102;352590;G;4530702;0;3;-3
202102;352590;G;4772500;0;1;-1
202102;352590;G;4759899;1;0;1
202102;352590;G;4763601;0;1;-1
202102;352590;G;4763602;1;3;-2
202102;352590;G;4731800;1;1;0
202102;352590;G;4754701;1;1;0
202102;352590;G;4781400;0;1;-1
202102;352590;G;4781400;0;1;-1
202102;352590;G;4541204;2;0;2
202102;352590;G;4511101;1;4;-3
202102;352590;G;4614100;0;1;-1
202102;352590;G;4731800;1;2;-1
202102;352590;G;4754701;1;0;1
202102;352590;G;4754701;0;3;-3
202102;352590;G;4619200;0;1;-1
202102;352590;G;4731800;1;0;1
202102;352590;G;4541205;1;1;0
202102;352590;G;4712100;1;0;1
202102;352590;G;4511101;1;0;1
202102;352590;G;4684299;1;0;1
202102;352590;G;4520001;0;1;-1
202102;352590;G;4530705;0;1;-1
202102;352590;G;4781400;0;2;-2
202102;352590;G;4731800;0;1;-1
202102;352590;G;4722901;3;0;3
202102;352590;G;4784900;1;0;1
202102;352590;G;4754701;0;1;-1
202102;352590;G;4781400;0;1;-1
202102;352590;G;4754702;0;1;-1
202102;352590;G;4754702;0;1;-1
202102;352590;G;4755503;0;2;-2
202102;352590;G;4679601;0;2;-2
202102;352590;G;4789001;1;0;1
202102;352590;G;4789001;1;0;1
202102;352590;G;4789099;1;0;1
202102;352590;G;4771702;0;2;-2
202102;352590;G;4731800;0;2;-2
202102;352590;G;4752100;1;0;1
202102;352590;G;4752100;0;2;-2
202102;352590;G;4752100;0;2;-2
202102;352590;G;4639701;1;0;1
202102;352590;G;4789099;1;0;1
202102;352590;G;4646001;1;3;-2
202102;352590;G;4789004;0;1;-1
202102;352590;G;4789004;1;0;1
202102;352590;G;4772500;0;2;-2
202102;352590;G;4759899;1;1;0
202102;352590;G;4744099;3;1;2
202102;352590;G;4771702;1;0;1
202102;352590;G;4781400;1;3;-2
202102;352590;G;4723700;0;1;-1
202102;352590;G;4711302;1;0;1
202102;352590;G;4711302;0;1;-1
202102;352590;G;4520005;3;1;2
202102;352590;G;4754701;0;2;-2
202102;352590;G;4613300;1;0;1
202102;352590;G;4744005;1;3;-2
202102;352590;G;4721104;0;1;-1
202102;352590;G;4789099;1;0;1
202102;352590;G;4731800;2;0;2
202102;352590;G;4744005;1;1;0
202102;352590;G;4637106;8;5;3
202102;352590;G;4649499;0;5;-5
202102;352590;G;4751200;0;3;-3
202102;352590;G;4774100;0;1;-1
202102;352590;G;4672900;0;5;-5
202102;352590;G;4742300;1;1;0
202102;352590;G;4520001;1;1;0
202102;352590;G;4781400;0;1;-1
202102;352590;G;4789002;1;0;1
202102;352590;G;4541202;1;0;1
202102;352590;G;4712100;0;1;-1
202102;352590;G;4782202;1;0;1
202102;352590;G;4511101;4;2;2
202102;352590;G;4743100;1;1;0
202102;352590;G;4753900;1;1;0
202102;352590;G;4731800;2;3;-1
202102;352590;G;4639701;7;12;-5
202102;352590;G;4729699;0;1;-1
202102;352590;G;4731800;1;1;0
202102;352590;G;4782201;1;3;-2
202102;352590;G;4789007;0;1;-1
202102;352590;G;4511102;1;0;1
202102;352590;G;4744005;1;0;1
202102;352590;G;4731800;1;0;1
202102;352590;G;4781400;1;0;1
202102;352590;G;4789002;0;1;-1
202102;352590;G;4731800;2;0;2
202102;352590;G;4759899;1;0;1
202102;352590;G;4520001;0;1;-1
202102;352590;G;4789007;6;2;4
202102;352590;G;4753900;1;1;0
202102;352590;G;4744005;2;0;2
202102;352590;G;4724500;10;16;-6
202102;352590;G;4724500;4;2;2
202102;352590;G;4511101;0;1;-1
202102;352590;G;4672900;0;1;-1
202102;352590;G;4712100;2;1;1
202102;352590;G;4731800;1;0;1
202102;352590;G;4744001;1;0;1
202102;352590;G;4729699;3;1;2
202102;352590;G;4781400;1;0;1
202102;352590;G;4751201;2;0;2
202102;352590;G;4530703;7;2;5
202102;352590;G;4731800;2;0;2
202102;352590;G;4782201;0;1;-1
202102;352590;G;4724500;0;1;-1
202102;352590;G;4511101;7;5;2
202102;352590;G;4781400;1;1;0
202102;352590;G;4687703;1;0;1
202102;352590;G;4729699;1;1;0
202102;352590;G;4789099;1;0;1
202102;352590;G;4722901;1;0;1
202102;352590;G;4781400;0;1;-1
202102;352590;G;4520001;0;1;-1
202102;352590;G;4755502;0;2;-2
202102;352590;G;4781400;1;0;1
202102;352590;G;4744002;1;0;1
202102;352590;G;4772500;0;1;-1
202102;352590;G;4541203;1;2;-1
202102;352590;G;4761001;1;0;1
202102;352590;G;4774100;1;0;1
202102;352590;G;4721102;0;1;-1
202102;352590;G;4687702;1;0;1
202102;352590;G;4711302;7;16;-9
202102;352590;G;4774100;0;1;-1
202102;352590;G;4753900;2;1;1
202102;352590;G;4649499;2;1;1
202102;352590;G;4771701;1;0;1
202102;352590;G;4751201;0;1;-1
202102;352590;G;4759899;1;0;1
202102;352590;G;4754701;1;0;1
202102;352590;G;4744099;1;0;1
202102;352590;G;4741500;1;1;0
202102;352590;G;4639701;0;1;-1
202102;352590;G;4741500;2;0;2
202102;352590;G;4759899;2;2;0
202102;352590;G;4759899;0;3;-3
202102;352590;G;4759899;0;3;-3
202102;352590;G;4759899;8;5;3
202102;352590;G;4649499;2;9;-7
202102;352590;G;4761001;2;2;0
202102;352590;G;4520001;2;1;1
202102;352590;G;4744002;1;0;1
202102;352590;G;4712100;10;3;7
202102;352590;G;4711302;0;3;-3
202102;352590;G;4711301;13;7;6
202102;352590;G;4511102;1;0;1
202102;352590;G;4751201;1;1;0
202102;352590;G;4753900;0;1;-1
202102;352590;G;4789002;0;1;-1
202102;352590;G;4781400;1;0;1
202102;352590;G;4759899;4;1;3
202102;352590;G;4530703;1;1;0
202102;352590;G;4789001;0;1;-1
202102;352590;G;4721102;0;1;-1
202102;352590;G;4744099;0;1;-1
202102;352590;G;4722901;0;1;-1
202102;352590;G;4712100;3;4;-1
202102;352590;G;4789002;4;1;3
202102;352590;G;4687701;1;0;1
202102;352590;G;4763602;1;3;-2
202102;352590;G;4763601;0;1;-1
202102;352590;G;4633801;2;0;2
202102;352590;G;4711302;24;14;10
202102;352590;G;4763603;2;0;2
202102;352590;G;4731800;1;2;-1
202102;352590;G;4781400;0;1;-1
202102;352590;G;4754701;2;0;2
202102;352590;G;4781400;1;0;1
202102;352590;G;4530703;1;0;1
202102;352590;G;4781400;0;6;-6
202102;352590;G;4781400;0;1;-1
202102;352590;G;4774100;0;1;-1
202102;352590;G;4633801;3;9;-6
202102;352590;G;4744099;1;1;0
202102;352590;G;4751201;1;0;1
202102;352590;G;4520005;1;1;0
202102;352590;G;4731800;0;1;-1
202102;352590;G;4771701;0;1;-1
202102;352590;G;4771701;0;1;-1
202102;352590;G;4752100;0;2;-2
202102;352590;G;4722901;0;1;-1
202102;352590;G;4781400;0;1;-1
202102;352590;G;4741500;1;0;1
202102;352590;G;4635402;1;2;-1
202102;352590;G;4789005;0;1;-1
202102;352590;G;4724500;1;0;1
202102;352590;G;4754703;1;2;-1
202102;352590;G;4617600;2;0;2
202102;352590;G;4721102;2;2;0
202102;352590;G;4772500;1;1;0
202102;352590;G;4520001;1;0;1
202102;352590;G;4754702;0;1;-1
202102;352590;G;4712100;1;2;-1
202102;352590;G;4541203;1;0;1
202102;352590;G;4789099;0;2;-2
202102;352590;G;4781400;0;2;-2
202102;352590;G;4742300;0;1;-1
202102;352590;G;4781400;0;1;-1
202102;352590;G;4511101;1;1;0
202102;352590;G;4530703;1;0;1
202102;352590;G;4782201;1;1;0
202102;352590;G;4530703;1;0;1
202102;352590;G;4753900;2;3;-1
202102;352590;G;4789099;1;2;-1
202102;352590;G;4639701;4;1;3
202102;352590;G;4744001;1;0;1
202102;352590;G;4721104;1;0;1
202102;352590;G;4530703;2;0;2
202102;352590;G;4731800;1;0;1
202102;352590;G;4744001;0;2;-2
202102;352590;G;4686902;1;0;1
202102;352590;G;4759899;1;0;1
202102;352590;G;4742300;1;0;1
202102;352590;G;4761001;1;0;1
202102;352590;G;4752100;1;0;1
202102;352590;G;4752100;0;1;-1
202102;352590;G;4744099;1;0;1
202102;352590;G;4687703;1;0;1
202102;352590;G;4731800;1;1;0
202102;352590;G;4530703;3;2;1
202102;352590;G;4744001;1;2;-1
202102;352590;G;4789004;3;0;3
202102;352590;G;4530703;0;1;-1
202102;352590;G;4729699;3;1;2
202102;352590;G;4663000;1;0;1
202102;352590;G;4729699;1;0;1
202102;352590;G;4789001;0;1;-1
202102;352590;G;4511101;0;4;-4
202102;352590;G;4729699;5;6;-1
202102;352590;G;4774100;2;0;2
202102;352590;G;4789099;1;0;1
202102;352590;G;4686902;17;1;16
202102;352590;G;4759899;0;1;-1
202102;352590;G;4781400;1;0;1
202102;352590;G;4511101;5;3;2
202102;352590;G;4781400;1;0;1
202102;352590;G;4789099;3;0;3
202102;352590;G;4774100;1;0;1
202102;352590;G;4754701;4;4;0
202102;352590;G;4729699;1;0;1
202102;352590;G;4541205;0;1;-1
202102;352590;G;4731800;0;1;-1
202102;352590;G;4759899;0;1;-1
202102;352590;G;4729699;0;1;-1
202102;352590;G;4789005;0;1;-1
202102;352590;G;4782201;1;0;1
202102;352590;G;4530703;0;1;-1
202102;352590;G;4772500;3;4;-1
202102;352590;G;4541203;1;0;1
202102;352590;G;4789099;1;1;0
202102;352590;G;4713002;0;2;-2
202102;352590;G;4686902;5;1;4
202102;352590;G;4724500;11;9;2
202102;352590;G;4633801;2;1;1
202102;352590;G;4724500;4;13;-9
202102;352590;G;4781400;1;0;1
202102;352590;G;4781400;0;1;-1
202102;352590;G;4663000;1;0;1
202102;352590;G;4751201;1;0;1
202102;352590;G;4789004;1;0;1
202102;352590;G;4691500;7;6;1
202102;352590;G;4781400;1;0;1
202102;352590;G;4520006;1;0;1
202102;352590;G;4731800;1;0;1
202102;352590;G;4731800;0;2;-2
202102;352590;G;4781400;0;1;-1
202102;352590;G;4771701;1;0;1
202102;352590;G;4712100;1;0;1
202102;352590;G;4633801;0;1;-1
202102;352590;G;4511101;5;0;5
202102;352590;G;4731800;2;1;1
202102;352590;G;4782201;1;1;0
202102;352590;G;4520004;0;1;-1
202102;352590;G;4754701;22;2;20
202102;352590;G;4754701;4;0;4
202102;352590;G;4713002;1;0;1
202102;352590;G;4530703;1;4;-3
202102;352590;G;4744099;1;0;1
202102;352590;G;4744003;1;0;1
202102;352590;G;4732600;0;1;-1
202102;352590;G;4754701;1;0;1
202102;352590;G;4771701;1;0;1
202102;352590;G;4751201;0;1;-1
202102;352590;G;4731800;2;2;0
202102;352590;G;4712100;2;1;1
202102;352590;G;4511101;1;1;0
202102;352590;G;4530703;0;1;-1
202102;352590;G;4686902;1;0;1
202102;352590;G;4651601;0;1;-1
202102;352590;G;4530703;0;1;-1
202102;352590;G;4712100;2;1;1
202102;352590;G;4669999;1;0;1
202102;352590;G;4623109;0;2;-2
202102;352590;G;4781400;8;25;-17
202102;352590;G;4511104;3;0;3
202102;352590;G;4789099;1;2;-1
202102;352590;G;4761003;1;1;0
202102;352590;G;4789099;0;1;-1
202102;352590;G;4781400;0;1;-1
202102;352590;G;4721102;0;1;-1
202102;352590;G;4744002;1;1;0
202102;352590;G;4789099;1;0;1
202102;352590;G;4754701;0;1;-1
202102;352590;G;4530703;1;0;1
202102;352590;G;4781400;1;0;1
202102;352590;G;4771701;1;0;1
202102;352590;G;4649499;6;1;5
202102;352590;G;4520007;3;3;0
202102;352590;G;4782201;1;0;1
202102;352590;G;4744099;2;2;0
202102;352590;G;4721102;0;1;-1
202102;352590;G;4781400;4;8;-4
202102;352590;G;4520001;0;1;-1
202102;352590;G;4751201;1;0;1
202102;352590;G;4520002;2;0;2
202102;352590;G;4530703;0;1;-1
202102;352590;G;4722901;1;0;1
202102;352590;G;4781400;0;1;-1
202102;352590;G;4789004;0;1;-1
202102;352590;G;4713002;0;1;-1
202102;352590;G;4530703;0;1;-1
202102;352590;G;4781400;1;0;1
202102;352590;G;4689301;1;1;0
202102;352590;G;4731800;1;1;0
202102;352590;G;4761001;1;2;-1
202102;352590;G;4782201;2;1;1
202102;352590;G;4781400;9;1;8
202102;352590;G;4772500;0;2;-2
202102;352590;G;4541204;1;0;1
202102;352590;G;4789001;0;2;-2
202102;352590;G;4783101;0;1;-1
202102;352590;G;4755503;1;1;0
202102;352590;G;4520007;0;1;-1
202102;352590;G;4744099;0;2;-2
202102;352590;G;4783101;1;0;1
202102;352590;G;4520005;0;1;-1
202102;352590;G;4744001;1;0;1
202102;352590;G;4782201;0;3;-3
202102;352590;G;4771701;0;1;-1
202102;352590;G;4619200;1;0;1
202102;352590;G;4530703;1;0;1
202102;352590;G;4743100;1;1;0
202102;352590;G;4772500;1;1;0
202102;352590;G;4772500;2;2;0
202102;352590;G;4530701;1;3;-2
202102;352590;G;4757100;2;0;2
202102;352590;G;4691500;4;10;-6
202102;352590;G;4743100;1;0;1
202102;352590;G;4637199;0;2;-2
202102;352590;G;4687702;1;0;1
202102;352590;G;4781400;1;0;1
202102;352590;G;4520004;1;0;1
202102;352590;G;4761003;2;0;2
202102;352590;G;4689399;1;0;1
202102;352590;G;4772500;0;1;-1
202102;352590;G;4669999;5;3;2
202102;352590;G;4724500;0;1;-1
202102;352590;G;4632003;0;1;-1
202102;352590;G;4649402;0;1;-1
202102;352590;G;4781400;2;1;1
202102;352590;G;4781400;1;1;0
202102;352590;G;4686902;1;0;1
202102;352590;G;4772500;0;2;-2
202102;352590;G;4530703;1;0;1
202102;352590;G;4731800;0;1;-1
202102;352590;G;4763603;1;0;1
202102;352590;G;4646001;0;1;-1
202102;352590;G;4789099;3;1;2
202102;352590;G;4530704;6;1;5
202102;352590;G;4753900;0;2;-2
202102;352590;G;4530705;0;2;-2
202102;352590;G;4771701;1;0;1
202102;352590;G;4744001;2;0;2
202102;352590;G;4754701;2;6;-4
202102;352590;G;4781400;19;0;19
202102;352590;G;4771702;2;0;2
202102;352590;G;4763603;1;0;1
202102;352590;G;4721102;2;0;2
202102;352590;G;4771701;2;1;1
202102;352590;G;4530703;1;3;-2
202102;352590;G;4761001;2;2;0
202102;352590;G;4763601;0;4;-4
202102;352590;G;4713002;3;0;3
202102;352590;G;4741500;1;0;1
202102;352590;G;4741500;1;0;1
202102;352590;G;4781400;1;1;0
202102;352590;G;4772500;1;1;0
202102;352590;G;4741500;0;1;-1
202102;352590;G;4721104;12;5;7
202102;352590;G;4637107;4;0;4
202102;352590;G;4754701;1;3;-2
202102;352590;G;4754701;0;1;-1
202102;352590;G;4752100;0;6;-6
202102;352590;G;4744002;1;0;1
202102;352590;G;4744099;1;0;1
202102;352590;G;4781400;0;1;-1
202102;352590;G;4721104;1;0;1
202102;352590;G;4781400;1;0;1
202102;352590;G;4772500;0;1;-1
202102;352590;G;4781400;0;2;-2
202102;352590;G;4520002;2;1;1
202102;352590;G;4712100;1;1;0
202102;352590;G;4712100;1;0;1
202102;352590;G;4782201;0;2;-2
202102;352590;G;4781400;0;2;-2
202102;352590;G;4782201;0;1;-1
202102;352590;G;4755502;3;4;-1
202102;352590;G;4712100;1;0;1
202102;352590;G;4774100;0;1;-1
202102;352590;G;4781400;1;1;0
202102;352590;G;4774100;0;1;-1
202102;352590;G;4729699;1;0;1
202102;352590;G;4763601;1;0;1
202102;352590;G;4520005;7;11;-4
202102;352590;G;4721104;1;2;-1
202102;352590;G;4721104;1;2;-1
202102;352590;G;4772500;0;1;-1
202102;352590;G;4663000;6;4;2
202102;352590;G;4511102;0;1;-1
202102;352590;G;4541201;1;0;1
202102;352590;G;4752100;0;2;-2
202102;352590;G;4741500;1;1;0
202102;352590;G;4614100;0;1;-1
202102;352590;G;4771702;2;0;2
202102;352590;G;4789099;2;1;1
202102;352590;G;4754701;2;0;2
202102;352590;G;4744002;0;1;-1
202102;352590;G;4618499;1;0;1
202102;352590;G;4752100;2;1;1
202102;352590;G;4789002;0;1;-1
202102;352590;G;4634601;4;1;3
202102;352590;G;4783102;0;1;-1
202102;352590;G;4789004;3;4;-1
202102;352590;G;4530703;0;1;-1
202102;352590;G;4687702;0;1;-1
202102;352590;G;4530704;0;1;-1
202102;352590;G;4713002;1;2;-1
202102;352590;G;4712100;1;0;1
202102;352590;G;4732600;0;2;-2
202102;352590;G;4782201;1;1;0
202102;352590;G;4782201;1;0;1
202102;352590;G;4642701;0;1;-1
202102;352590;G;4789004;1;1;0
202102;352590;G;4774100;2;0;2
202102;352590;G;4757100;0;1;-1
202102;352590;G;4781400;1;0;1
202102;352590;G;4724500;1;0;1
202102;352590;G;4772500;0;2;-2
202102;352590;G;4782201;0;1;-1
202102;352590;G;4782201;0;1;-1
202102;352590;G;4781400;0;1;-1
202102;352590;G;4751200;1;0;1
202102;352590;G;4789004;1;0;1
202102;352590;G;4520002;0;1;-1
202102;352590;G;4520001;0;1;-1
202102;352590;G;4753900;1;1;0
202102;352590;G;4520002;0;2;-2
202102;352590;G;4789001;0;1;-1
202102;352590;G;4744099;1;0;1
202102;352590;G;4761001;0;1;-1
202102;352590;G;4722901;0;1;-1
202102;352590;G;4520002;0;1;-1
202102;352590;G;4652400;0;1;-1
202102;352590;G;4752100;1;2;-1
202102;352590;G;4744002;0;1;-1
202102;352590;G;4751201;2;0;2
202102;352590;G;4530703;2;0;2
202102;352590;G;4530703;1;1;0
202102;352590;G;4713002;2;0;2
202102;352590;G;4729699;1;0;1
202102;352590;G;4530705;0;1;-1
202102;352590;G;4520001;1;0;1
202102;352590;G;4721102;3;1;2
202102;352590;G;4721102;1;1;0
202102;352590;G;4721102;1;1;0
202102;352590;G;4781400;1;1;0
202102;352590;G;4781400;1;0;1
202102;352590;G;4763602;0;1;-1
202102;352590;G;4789002;2;0;2
202102;352590;G;4781400;1;0;1
202102;352590;G;4520001;0;1;-1
202102;352590;G;4721102;1;1;0
202102;352590;G;4752100;1;0;1
202102;352590;G;4530703;0;1;-1
202102;352590;G;4781400;0;1;-1
202102;352590;G;4721102;0;1;-1
202102;352590;G;4781400;2;0;2
202102;352590;G;4712100;1;1;0
202102;352590;G;4781400;1;0;1
202102;352590;G;4782202;1;1;0
202102;352590;G;4731800;0;2;-2
202102;352590;G;4669999;0;4;-4
202102;352590;G;4754701;0;1;-1
202102;352590;G;4642702;1;0;1
202102;352590;G;4771701;1;1;0
202102;352590;G;4789099;0;3;-3
202102;352590;G;4721102;0;1;-1
202102;352590;G;4672900;1;0;1
202102;352590;G;4789001;0;1;-1
202102;352590;G;4781400;1;0;1
202102;352590;G;4530703;1;1;0
202102;352590;G;4752100;1;0;1
202102;352590;G;4789002;0;1;-1
202102;352590;G;4645101;8;4;4
202102;352590;G;4789001;0;1;-1
202102;352590;G;4721102;4;0;4
202102;352590;G;4721102;0;1;-1
202102;352590;G;4781400;0;1;-1
202102;352590;G;4789099;0;1;-1
202102;352590;G;4631100;1;1;0
202102;352590;G;4731800;2;1;1
202102;352590;G;4713004;0;2;-2
202102;352590;G;4774100;1;0;1
202102;352590;G;4520001;2;2;0
202102;352590;G;4744001;3;0;3
202102;352590;G;4752100;1;0;1
202102;352590;G;4754701;1;0;1
202102;352590;G;4731800;1;0;1
202102;352590;G;4649499;0;1;-1
202102;352590;G;4729699;2;36;-34
202102;352590;G;4520001;2;0;2
202102;352590;G;4781400;1;1;0
202102;352590;G;4679699;0;1;-1
202102;352590;G;4789099;1;0;1
202102;352590;G;4753900;0;1;-1
202102;352590;G;4633801;2;0;2
202102;352590;G;4646001;1;1;0
202102;352590;G;4712100;1;0;1
202102;352590;G;4754701;0;3;-3
202102;352590;G;4781400;1;0;1
202102;352590;G;4783101;0;2;-2
202102;352590;G;4772500;0;2;-2
202102;352590;G;4679603;1;1;0
202102;352590;G;4721102;0;1;-1
202102;352590;G;4633801;4;0;4
202102;352590;G;4530703;0;1;-1
202102;352590;G;4520003;1;0;1
202102;352590;G;4711302;1;2;-1
202102;352590;G;4751201;0;1;-1
202102;352590;G;4639701;6;15;-9
202102;352590;G;4520007;3;0;3
202102;352590;G;4520004;1;0;1
202102;352590;G;4753900;8;7;1
202102;352590;G;4530704;2;2;0
202102;352590;G;4530703;1;0;1
202102;352590;G;4781400;1;0;1
202102;352590;G;4781400;0;1;-1
202102;352590;G;4759899;1;2;-1
202102;352590;G;4781400;1;0;1
202102;352590;G;4781400;0;1;-1
202102;352590;G;4789099;1;0;1
202102;352590;G;4723700;1;0;1
202102;352590;G;4646001;4;0;4
202102;352590;G;4781400;1;0;1
202102;352590;G;4782201;0;1;-1
202102;352590;G;4530703;0;1;-1
202102;352590;G;4530705;2;1;1
202102;352590;G;4722901;0;1;-1
202102;352590;G;4759899;1;0;1
202102;352590;G;4781400;0;2;-2
202102;352590;G;4781400;0;1;-1
202102;352590;G;4759899;2;0;2
202102;352590;G;4772500;1;1;0
202102;352590;G;4789099;1;0;1
202102;352590;G;4646001;1;0;1
202102;352590;G;4724500;1;0;1
202102;352590;G;4541205;0;1;-1
202102;352590;G;4789099;1;0;1
202102;352590;G;4761001;1;0;1
202102;352590;G;4729699;0;1;-1
202102;352590;G;4729699;1;0;1
202102;352590;G;4721102;0;1;-1
202102;352590;G;4724500;0;1;-1
202102;352590;G;4729602;0;1;-1
202102;352590;G;4729602;6;0;6
202102;352590;G;4712100;5;0;5
202102;352590;G;4520003;1;0;1
202102;352590;G;4721103;1;1;0
202102;352590;G;4781400;1;1;0
202102;352590;G;4782201;0;1;-1
202102;352590;G;4520006;4;1;3
202102;352590;G;4721102;1;0;1
202102;352590;G;4789001;1;0;1
202102;352590;G;4686902;1;0;1
202102;352590;G;4771701;2;2;0
202102;352590;G;4771701;1;1;0
202102;352590;G;4754703;1;0;1
202102;352590;G;4712100;1;0;1
202102;352590;G;4789004;1;1;0
202102;352590;G;4789004;3;2;1
202102;352590;G;4755501;1;0;1
202102;352590;G;4722901;1;1;0
202102;352590;G;4687702;2;1;1
202102;352590;G;4693100;0;3;-3
202102;352590;G;4744005;0;1;-1
202102;352590;G;4711302;2;1;1
202102;352590;G;4664800;0;1;-1
202102;352590;G;4721102;0;1;-1
202102;352590;G;4789004;1;0;1
202102;352590;G;4771701;1;0;1
202102;352590;G;4729602;1;0;1
202102;352590;G;4520002;0;1;-1
202102;352590;G;4757100;0;1;-1
202102;352590;G;4729699;1;1;0
202102;352590;G;4772500;1;0;1
202102;352590;G;4789099;1;1;0
202102;352590;G;4729602;1;1;0
202102;352590;G;4789099;1;0;1
202102;352590;G;4752100;0;1;-1
202102;352590;G;4752100;0;2;-2
202102;352590;G;4721102;0;1;-1
202102;352590;G;4781400;0;1;-1
202102;352590;G;4723700;0;1;-1
202102;352590;G;4712100;2;2;0
202102;352590;G;4772500;5;1;4
202102;352590;G;4781400;1;0;1
202102;352590;G;4721102;2;1;1
202102;352590;G;4744001;0;1;-1
202102;352590;G;4729699;1;1;0
202102;352590;G;4744099;0;1;-1
202102;352590;G;4511101;1;1;0
202102;352590;G;4772500;1;1;0
202102;352590;G;4723700;1;1;0
202102;352590;G;4781400;0;1;-1
202102;352590;G;4781400;2;1;1
202102;352590;G;4781400;0;1;-1
202102;352590;G;4729699;1;0;1
202102;352590;G;4712100;1;0;1
202102;352590;G;4771701;1;0;1
202102;352590;G;4782201;1;0;1
202102;352590;G;4781400;2;0;2
202102;352590;G;4711301;5;8;-3
202102;352590;G;4781400;0;1;-1
202102;352590;G;4511102;0;1;-1
202102;352590;G;4744099;1;0;1
202102;352590;G;4783101;0;2;-2
202102;352590;G;4711302;4;1;3
202102;352590;G;4731800;0;1;-1
202102;352590;G;4520005;0;2;-2
202102;352590;G;4781400;5;1;4
202102;352590;G;4781400;0;2;-2
202102;352590;G;4782202;1;0;1
202102;352590;G;4530703;0;1;-1
202102;352590;G;4530702;1;0;1
202102;352590;G;4782201;3;3;0
202102;352590;G;4789001;0;1;-1
202102;352590;G;4639701;22;7;15
202102;352590;G;4713002;1;0;1
202102;352590;G;4637199;10;3;7
202102;352590;G;4723700;1;0;1
202102;352590;G;4723700;1;0;1
202102;352590;G;4744005;1;0;1
202102;352590;G;4729699;1;0;1
202102;352590;G;4642701;0;1;-1
202102;352590;G;4789002;9;3;6
202102;352590;G;4771701;1;0;1
202102;352590;G;4781400;3;2;1
202102;352590;G;4741500;1;0;1
202102;352590;G;4781400;6;1;5
202102;352590;G;4744005;0;1;-1
202102;352590;G;4712100;1;0;1
202102;352590;G;4771701;1;0;1
202102;352590;G;4782201;1;0;1
202102;352590;G;4711302;1;1;0
202102;352590;G;4773300;1;0;1
202102;352590;G;4752100;0;1;-1
202102;352590;G;4789001;0;1;-1
202102;352590;G;4752100;1;0;1
202102;352590;G;4520006;3;0;3
202102;352590;G;4711302;0;2;-2
202102;352590;G;4753900;1;0;1
202102;352590;G;4753900;26;52;-26
202102;352590;G;4753900;3;4;-1
202102;352590;G;4753900;3;3;0
202102;352590;G;4753900;2;1;1
202102;352590;G;4753900;40;21;19
202102;352590;G;4753900;3;1;2
202102;352590;G;4753900;0;4;-4
202102;352590;G;4712100;1;4;-3
202102;352590;G;4712100;0;5;-5
202102;352590;G;4744099;1;0;1
202102;352590;G;4744001;2;0;2
202102;352590;G;4781400;1;0;1
202102;352590;G;4781400;2;2;0
202102;352590;G;4744001;1;0;1
202102;352590;G;4781400;0;1;-1
202102;352590;G;4744005;1;1;0
202102;352590;G;4752100;2;1;1
202102;352590;G;4781400;0;1;-1
202102;352590;G;4684299;0;2;-2
202102;352590;G;4712100;1;0;1
202102;352590;G;4774100;0;1;-1
202102;352590;G;4724500;1;0;1
202102;352590;G;4752100;1;0;1
202102;352590;G;4782201;2;0;2
202102;352590;G;4712100;1;1;0
202102;352590;G;4731800;3;0;3
202102;352590;G;4520002;2;0;2
202102;352590;G;4763602;0;5;-5
202102;352590;G;4785799;2;2;0
202102;352590;G;4753900;1;0;1
202102;352590;G;4712100;1;0;1
202102;352590;G;4789004;1;0;1
202102;352590;G;4721102;4;0;4
202102;352590;G;4669999;6;3;3
202102;352590;G;4669999;1;0;1
202102;352590;G;4729602;0;1;-1
202102;352590;G;4782201;0;1;-1
202102;352590;G;4763602;0;1;-1
202102;352590;G;4771701;0;1;-1
202102;352590;G;4774100;0;1;-1
202102;352590;G;4713002;0;1;-1
202102;352590;G;4774100;0;1;-1
202102;352590;G;4774100;1;1;0
202102;352590;G;4721102;2;0;2
202102;352590;G;4511101;1;0;1
202102;352590;G;4781400;0;1;-1
202102;352590;G;4731800;2;0;2
202102;352590;G;4781400;2;2;0
202102;352590;G;4781400;1;0;1
202102;352590;G;4781400;1;2;-1
202102;352590;G;4744099;1;0;1
202102;352590;G;4520005;1;0;1
202102;352590;G;4712100;0;2;-2
202102;352590;G;4744005;1;0;1
202102;352590;G;4723700;0;1;-1
202102;352590;G;4759899;0;2;-2
202102;352590;G;4744003;1;0;1
202102;352590;G;4520001;0;1;-1
202102;352590;G;4721104;0;1;-1
202102;352590;G;4754701;1;1;0
202102;352590;G;4530703;1;0;1
202102;352590;G;4530703;1;0;1
202102;352590;G;4723700;0;1;-1
202102;352590;G;4744001;2;0;2
202102;352590;G;4789001;1;0;1
202102;352590;G;4721104;1;0;1
202102;352590;G;4721104;0;1;-1
202102;352590;G;4789099;0;1;-1
202102;352590;G;4729699;1;1;0
202102;352590;G;4781400;1;0;1
202102;352590;G;4729602;1;1;0
202102;352590;G;4744005;3;1;2
202102;352590;G;4781400;1;1;0
202102;352590;G;4729699;2;0;2
202102;352590;G;4686902;5;2;3
202102;352590;G;4712100;0;2;-2
202102;352590;G;4789001;1;0;1
202102;352590;G;4723700;1;0;1
202102;352590;G;4520001;2;0;2
202102;352590;G;4761001;1;2;-1
202102;352590;G;4789004;1;0;1
202102;352590;G;4713001;2;2;0
202102;352590;G;4761001;2;1;1
202102;352590;G;4729699;0;1;-1
202102;352590;G;4744005;1;0;1
202102;352590;G;4781400;1;0;1
202102;352590;G;4772500;0;1;-1
202102;352590;G;4772500;2;0;2
202102;352590;G;4635499;6;2;4
202102;352590;G;4633801;1;2;-1
202102;352590;G;4637107;2;0;2
202102;352590;G;4729699;1;0;1
202102;352590;G;4669999;8;1;7
202102;352590;G;4729699;3;1;2
202102;352590;G;4647801;0;1;-1
202102;352590;G;4774100;0;1;-1
202102;352590;G;4721104;0;1;-1
202102;352590;G;4753900;2;1;1
202102;352590;G;4753900;0;1;-1
202102;352590;G;4772500;0;1;-1
202102;352590;G;4789099;0;1;-1
202102;352590;G;4744005;1;0;1
202102;352590;G;4721102;1;0;1
202102;352590;G;4731800;1;1;0
202102;352590;G;4530703;1;2;-1
202102;352590;G;4755502;0;1;-1
202102;352590;G;4781400;4;7;-3
202102;352590;G;4781400;3;6;-3
202102;352590;G;4782201;1;0;1
202102;352590;G;4782201;0;2;-2
202102;352590;G;4782201;0;12;-12
202102;352590;G;4782201;0;2;-2
202102;352590;G;4711301;4;7;-3
202102;352590;G;4731800;1;2;-1
202102;352590;G;4771701;1;2;-1
202102;352590;G;4744005;0;1;-1
202102;352590;G;4672900;0;1;-1
202102;352590;G;4781400;0;29;-29
202102;352590;G;4646001;0;1;-1
202102;352590;G;4761003;0;1;-1
202102;352590;G;4744002;1;3;-2
202102;352590;G;4639701;5;3;2
202102;352590;G;4729601;1;0;1
202102;352590;G;4781400;0;1;-1
202102;352590;G;4781400;1;0;1
202102;352590;G;4781400;0;1;-1
202102;352590;G;4711302;1;5;-4
202102;352590;G;4771701;0;1;-1
202102;352590;G;4711302;0;1;-1
202102;352590;G;4789007;1;0;1
202102;352590;G;4789002;3;0;3
202102;352590;G;4637107;2;0;2
202102;352590;G;4713004;1;3;-2
202102;352590;G;4713004;1;2;-1
202102;352590;G;4789099;0;1;-1
202102;352590;G;4731800;0;1;-1
202102;352590;G;4732600;0;1;-1
202102;352590;G;4711302;1;0;1
202102;352590;G;4712100;1;0;1
202102;352590;G;4784900;0;1;-1
202102;352590;G;4731800;1;1;0
202102;352590;G;4781400;1;0;1
202102;352590;G;4781400;2;2;0
202102;352590;G;4741500;0;3;-3
202102;352590;G;4744005;1;0;1
202102;352590;G;4530703;2;0;2
202102;352590;G;4731800;0;2;-2
202102;352590;G;4711302;1;1;0
202102;352590;G;4712100;0;1;-1
202102;352590;G;4744099;0;1;-1
202102;352590;G;4530703;1;0;1
202102;352590;G;4731800;1;1;0
202102;352590;G;4511101;5;3;2
202102;352590;G;4721102;1;3;-2
202102;352590;G;4689399;1;0;1
202102;352590;G;4530703;0;1;-1
202102;352590;G;4530705;0;1;-1
202102;352590;G;4530703;0;1;-1
202102;352590;G;4712100;0;1;-1
202102;352590;G;4731800;2;1;1
202102;352590;G;4711302;0;2;-2
202102;352590;G;4711302;1;2;-1
202102;352590;G;4711302;9;6;3
202102;352590;G;4711302;4;4;0
202102;352590;G;4711302;6;3;3
202102;352590;G;4711302;3;9;-6
202102;352590;G;4711302;0;3;-3
202102;352590;G;4711302;13;11;2
202102;352590;G;4711302;4;3;1
202102;352590;G;4711302;7;9;-2
202102;352590;G;4639701;1;0;1
202102;352590;G;4711302;1;3;-2
202102;352590;G;4711302;1;1;0
202102;352590;G;4711302;4;3;1
202102;352590;G;4711302;4;2;2
202102;352590;G;4711302;5;7;-2
202102;352590;G;4721102;1;0;1
202102;352590;G;4511101;3;4;-1
202102;352590;G;4721102;0;1;-1
202102;352590;G;4530703;1;0;1
202102;352590;G;4744099;1;0;1
202102;352590;G;4731800;0;1;-1
202102;352590;G;4711302;6;7;-1
202102;352590;G;4711302;2;6;-4
202102;352590;G;4711302;3;5;-2
202102;352590;G;4711302;1;3;-2
202102;352590;G;4711302;4;1;3
202102;352590;G;4633801;4;3;1
202102;352590;G;4789099;1;1;0
202102;352590;G;4541203;1;0;1
202102;352590;G;4744099;3;1;2
202102;352590;G;4647801;2;1;1
202102;352590;G;4661300;7;6;1
202102;352590;G;4639701;4;0;4
202102;352590;G;4744099;1;0;1
202102;352590;G;4782201;0;1;-1
202102;352590;G;4782201;1;5;-4
202102;352590;G;4789099;2;0;2
202102;352590;G;4771702;7;4;3
202102;352590;G;4755502;1;0;1
202102;352590;G;4744001;0;1;-1
202102;352590;G;4530703;1;2;-1
202102;352590;G;4530701;0;1;-1
202102;352590;G;4721102;4;3;1
202102;352590;G;4789004;4;2;2
202102;352590;G;4669999;4;2;2
202102;352590;G;4530704;0;1;-1
202102;352590;G;4520006;0;2;-2
202102;352590;G;4781400;1;0;1
202102;352590;G;4732600;0;1;-1
202102;352590;G;4520001;0;1;-1
202102;352590;G;4712100;0;1;-1
202102;352590;G;4744002;2;0;2
202102;352590;G;4712100;2;1;1
202102;352590;G;4712100;1;1;0
202102;352590;G;4744005;1;0;1
202102;352590;G;4530703;0;1;-1
202102;352590;G;4511101;4;5;-1
202102;352590;G;4789007;0;1;-1
202102;352590;G;4721102;1;0;1
202102;352590;G;4712100;0;1;-1
202102;352590;G;4649499;0;2;-2
202102;352590;G;4661300;3;0;3
202102;352590;G;4530703;0;1;-1
202102;352590;G;4721102;0;2;-2
202102;352590;G;4649403;1;1;0
202102;352590;G;4761003;1;0;1
202102;352590;G;4753900;0;1;-1
202102;352590;G;4511102;0;1;-1
202102;352590;G;4541205;1;0;1
202102;352590;G;4763602;1;1;0
202102;352590;G;4781400;2;0;2
202102;352590;G;4781400;0;1;-1
202102;352590;G;4761003;2;1;1
202102;352590;G;4789099;0;1;-1
202102;352590;G;4635402;7;9;-2
202102;352590;G;4744099;1;0;1
202102;352590;G;4520001;0;1;-1
202102;352590;G;4520001;0;1;-1
202102;352590;G;4721102;2;1;1
202102;352590;G;4751201;1;0;1
202102;352590;G;4755502;1;0;1
202102;352590;G;4789004;0;1;-1
202102;352590;G;4672900;0;1;-1
202102;352590;G;4744002;0;1;-1
202102;352590;G;4530701;1;1;0
202102;352590;G;4789099;1;0;1
202102;352590;G;4530703;1;3;-2
202102;352590;G;4744005;1;0;1
202102;352590;G;4744005;1;0;1
202102;352590;G;4511104;2;0;2
202102;352590;G;4713004;2;1;1
202102;352590;G;4646001;1;1;0
202102;352590;G;4635402;2;9;-7
202102;352590;G;4781400;0;1;-1
202102;352590;G;4781400;0;1;-1
202102;352590;G;4647801;4;2;2
202102;352590;G;4711302;6;11;-5
202102;352590;G;4771701;1;1;0
202102;352590;G;4771701;0;2;-2
202102;352590;G;4771701;1;0;1
202102;352590;G;4771701;3;1;2
202102;352590;G;4771701;0;2;-2
202102;352590;G;4771701;1;0;1
202102;352590;G;4771701;1;1;0
202102;352590;G;4771701;1;0;1
202102;352590;G;4771701;0;2;-2
202102;352590;G;4771701;0;1;-1
202102;352590;G;4771701;2;0;2
202102;352590;G;4771701;0;2;-2
202102;352590;G;4771701;1;0;1
202102;352590;G;4771701;1;0;1
202102;352590;G;4771701;0;2;-2
202102;352590;G;4771701;2;0;2
202102;352590;G;4743100;2;0;2
202102;352590;G;4782202;2;1;1
202102;352590;G;4637107;3;0;3
202102;352590;G;4759899;1;0;1
202102;352590;G;4789002;5;11;-6
202102;352590;G;4530701;0;1;-1
202102;352590;G;4755503;1;1;0
202102;352590;G;4649408;0;1;-1
202102;352590;G;4731800;1;1;0
202102;352590;G;4789099;2;0;2
202102;352590;G;4782201;0;2;-2
202102;352590;G;4530703;0;1;-1
202102;352590;G;4530703;1;0;1
202102;352590;G;4711302;27;42;-15
202102;352590;G;4771702;2;1;1
202102;352590;G;4684201;3;1;2
202102;352590;G;4789099;2;0;2
202102;352590;G;4731800;0;1;-1
202102;352590;G;4771701;0;2;-2
202102;352590;G;4771701;1;1;0
202102;352590;G;4771701;1;1;0
202102;352590;G;4744005;1;0;1
202102;352590;G;4530703;1;0;1
202102;352590;G;4711302;2;2;0
202102;352590;G;4729699;1;1;0
202102;352590;G;4520001;0;1;-1
202102;352590;G;4637199;0;1;-1
202102;352590;G;4741500;1;0;1
202102;352590;G;4744005;1;0;1
202102;352590;G;4744005;2;0;2
202102;352590;G;4623199;2;0;2
202102;352590;G;4763601;0;2;-2
202102;352590;G;4785701;0;1;-1
202102;352590;G;4530703;2;0;2
202102;352590;G;4771701;0;1;-1
202102;352590;G;4781400;1;0;1
202102;352590;G;4789004;0;1;-1
202102;352590;G;4712100;1;0;1
202102;352590;G;4722901;1;0;1
202102;352590;G;4721102;1;1;0
202102;352590;G;4771702;9;3;6
202102;352590;G;4530703;0;1;-1
202102;352590;G;4771701;1;1;0
202102;352590;G;4744005;2;0;2
202102;352590;G;4744005;0;1;-1
202102;352590;G;4741500;3;1;2
202102;352590;G;4741500;1;0;1
202102;352590;G;4741500;1;1;0
202102;352590;G;4741500;2;0;2
202102;352590;G;4744001;1;1;0
202102;352590;G;4744005;1;1;0
202102;352590;G;4781400;1;0;1
202102;352590;G;4789099;1;0;1
202102;352590;G;4761001;0;1;-1
202102;352590;G;4789099;0;1;-1
202102;352590;G;4520005;0;7;-7
202102;352590;G;4744001;0;1;-1
202102;352590;G;4743100;3;0;3
202102;352590;G;4635402;4;0;4
202102;352590;G;4789002;1;1;0
202102;352590;G;4744001;0;1;-1
202102;352590;G;4744099;0;1;-1
202102;352590;G;4711302;1;3;-2
202102;352590;G;4729699;1;0;1
202102;352590;G;4771701;0;1;-1
202102;352590;G;4711301;2;8;-6
202102;352590;G;4672900;11;3;8
202102;352590;G;4711301;3;4;-1
202102;352590;G;4679604;3;4;-1
202102;352590;G;4541201;0;1;-1
202102;352590;G;4661300;1;0;1
202102;352590;G;4781400;2;5;-3
202102;352590;G;4781400;0;2;-2
202102;352590;G;4771702;0;1;-1
202102;352590;G;4722901;1;0;1
202102;352590;G;4642702;0;1;-1
202102;352590;G;4752100;0;2;-2
202010;352590;G;4789099;1;0;1
202010;352590;G;4751201;1;0;1
202010;352590;G;4744005;1;1;0
202010;352590;G;4789099;2;1;1
202010;352590;G;4789099;1;0;1
202010;352590;G;4789099;0;3;-3
202010;352590;G;4753900;5;10;-5
202010;352590;G;4753900;0;1;-1
202010;352590;G;4721102;0;1;-1
202010;352590;G;4672900;2;0;2
202010;352590;G;4789007;0;1;-1
202010;352590;G;4530703;1;0;1
202010;352590;G;4712100;1;0;1
202010;352590;G;4530703;0;4;-4
202010;352590;G;4633801;1;0;1
202010;352590;G;4511102;2;0;2
202010;352590;G;4771702;1;0;1
202010;352590;G;4781400;0;1;-1
202010;352590;G;4530705;2;1;1
202010;352590;G;4616800;2;0;2
202010;352590;G;4753900;1;0;1
202010;352590;G;4689399;0;1;-1
202010;352590;G;4721102;0;1;-1
202010;352590;G;4693100;9;11;-2
202010;352590;G;4511101;5;3;2
202010;352590;G;4742300;0;1;-1
202010;352590;G;4644301;19;22;-3
202010;352590;G;4771701;1;0;1
202010;352590;G;4752100;1;0;1
202010;352590;G;4721102;1;2;-1
202010;352590;G;4689399;3;1;2
202010;352590;G;4652400;3;1;2
202010;352590;G;4772500;0;1;-1
202010;352590;G;4689301;1;1;0
202010;352590;G;4639701;0;2;-2
202010;352590;G;4781400;0;1;-1
202010;352590;G;4789099;0;1;-1
202010;352590;G;4634601;21;8;13
202010;352590;G;4712100;3;2;1
202010;352590;G;4763603;1;0;1
202010;352590;G;4530701;0;2;-2
202010;352590;G;4530701;1;1;0
202010;352590;G;4530702;3;4;-1
202010;352590;G;4687703;2;1;1
202010;352590;G;4759899;1;1;0
202010;352590;G;4731800;0;1;-1
202010;352590;G;4731800;1;1;0
202010;352590;G;4639701;8;6;2
202010;352590;G;4771701;2;0;2
202010;352590;G;4789002;1;0;1
202010;352590;G;4511101;1;1;0
202010;352590;G;4784900;0;1;-1
202010;352590;G;4774100;1;0;1
202010;352590;G;4511101;1;0;1
202010;352590;G;4511101;0;1;-1
202010;352590;G;4511102;1;0;1
202010;352590;G;4520001;1;0;1
202010;352590;G;4772500;0;1;-1
202010;352590;G;4781400;1;2;-1
202010;352590;G;4721102;0;1;-1
202010;352590;G;4686902;0;1;-1
202010;352590;G;4722901;1;0;1
202010;352590;G;4754701;1;0;1
202010;352590;G;4781400;0;1;-1
202010;352590;G;4789099;1;1;0
202010;352590;G;4754702;0;1;-1
202010;352590;G;4713001;0;1;-1
202010;352590;G;4789001;1;1;0
202010;352590;G;4789001;2;0;2
202010;352590;G;4789099;1;0;1
202010;352590;G;4771702;2;2;0
202010;352590;G;4731800;0;4;-4
202010;352590;G;4771701;0;1;-1
202010;352590;G;4752100;1;0;1
202010;352590;G;4752100;2;3;-1
202010;352590;G;4752100;1;3;-2
202010;352590;G;4771701;1;0;1
202010;352590;G;4689399;1;1;0
202010;352590;G;4639701;3;0;3
202010;352590;G;4744002;1;0;1
202010;352590;G;4646001;1;2;-1
202010;352590;G;4781400;1;0;1
202010;352590;G;4789099;1;0;1
202010;352590;G;4759899;1;1;0
202010;352590;G;4754701;1;1;0
202010;352590;G;4744099;1;1;0
202010;352590;G;4711302;1;0;1
202010;352590;G;4711302;1;2;-1
202010;352590;G;4754701;1;0;1
202010;352590;G;4724500;1;0;1
202010;352590;G;4633801;0;6;-6
202010;352590;G;4744005;5;1;4
202010;352590;G;4789099;2;0;2
202010;352590;G;4744005;3;1;2
202010;352590;G;4637106;10;3;7
202010;352590;G;4774100;1;1;0
202010;352590;G;4744005;1;0;1
202010;352590;G;4649499;2;2;0
202010;352590;G;4781400;0;1;-1
202010;352590;G;4530703;1;2;-1
202010;352590;G;4672900;1;1;0
202010;352590;G;4742300;0;2;-2
202010;352590;G;4639701;0;1;-1
202010;352590;G;4520001;1;1;0
202010;352590;G;4541202;1;1;0
202010;352590;G;4782202;1;1;0
202010;352590;G;4753900;2;1;1
202010;352590;G;4731800;2;1;1
202010;352590;G;4639701;14;12;2
202010;352590;G;4751201;0;1;-1
202010;352590;G;4712100;0;1;-1
202010;352590;G;4789007;0;1;-1
202010;352590;G;4781400;0;1;-1
202010;352590;G;4520001;2;0;2
202010;352590;G;4789007;1;2;-1
202010;352590;G;4753900;0;1;-1
202010;352590;G;4744005;0;1;-1
202010;352590;G;4781400;0;1;-1
202010;352590;G;4724500;26;11;15
202010;352590;G;4743100;1;0;1
202010;352590;G;4712100;1;0;1
202010;352590;G;4511101;2;0;2
202010;352590;G;4672900;1;1;0
202010;352590;G;4784900;0;1;-1
202010;352590;G;4520002;0;1;-1
202010;352590;G;4781400;1;0;1
202010;352590;G;4744002;1;0;1
202010;352590;G;4751201;1;0;1
202010;352590;G;4530703;5;2;3
202010;352590;G;4731800;2;1;1
202010;352590;G;4782201;4;4;0
202010;352590;G;4723700;2;0;2
202010;352590;G;4511101;3;2;1
202010;352590;G;4687703;1;0;1
202010;352590;G;4712100;1;0;1
202010;352590;G;4729699;0;1;-1
202010;352590;G;4722901;1;0;1
202010;352590;G;4744002;0;1;-1
202010;352590;G;4774100;1;1;0
202010;352590;G;4541203;1;0;1
202010;352590;G;4712100;0;1;-1
202010;352590;G;4774100;0;1;-1
202010;352590;G;4721102;0;1;-1
202010;352590;G;4744003;1;0;1
202010;352590;G;4693100;0;2;-2
202010;352590;G;4711302;9;10;-1
202010;352590;G;4774100;0;1;-1
202010;352590;G;4753900;1;0;1
202010;352590;G;4771701;1;1;0
202010;352590;G;4751201;2;0;2
202010;352590;G;4772500;1;3;-2
202010;352590;G;4772500;3;4;-1
202010;352590;G;4759899;4;3;1
202010;352590;G;4759899;2;0;2
202010;352590;G;4759899;0;2;-2
202010;352590;G;4649499;0;5;-5
202010;352590;G;4761001;1;1;0
202010;352590;G;4753900;3;0;3
202010;352590;G;4744002;0;1;-1
202010;352590;G;4711302;8;5;3
202010;352590;G;4711301;21;26;-5
202010;352590;G;4711302;0;1;-1
202010;352590;G;4689399;0;1;-1
202010;352590;G;4789002;0;1;-1
202010;352590;G;4761001;3;2;1
202010;352590;G;4511102;0;1;-1
202010;352590;G;4530703;0;1;-1
202010;352590;G;4744099;1;0;1
202010;352590;G;4669999;0;1;-1
202010;352590;G;4712100;1;6;-5
202010;352590;G;4789002;3;2;1
202010;352590;G;4763602;4;2;2
202010;352590;G;4731800;0;10;-10
202010;352590;G;4781400;1;1;0
202010;352590;G;4687702;0;1;-1
202010;352590;G;4520001;0;1;-1
202010;352590;G;4711302;4;15;-11
202010;352590;G;4763603;0;1;-1
202010;352590;G;4731800;1;0;1
202010;352590;G;4754701;0;1;-1
202010;352590;G;4729699;0;1;-1
202010;352590;G;4530703;3;1;2
202010;352590;G;4781400;10;5;5
202010;352590;G;4530703;2;2;0
202010;352590;G;4754702;1;0;1
202010;352590;G;4530703;0;1;-1
202010;352590;G;4774100;0;1;-1
202010;352590;G;4633801;25;24;1
202010;352590;G;4744099;1;0;1
202010;352590;G;4685100;0;2;-2
202010;352590;G;4713002;1;0;1
202010;352590;G;4713002;0;1;-1
202010;352590;G;4530703;0;1;-1
202010;352590;G;4761001;2;0;2
202010;352590;G;4741500;2;0;2
202010;352590;G;4771701;0;1;-1
202010;352590;G;4771701;0;2;-2
202010;352590;G;4771701;0;1;-1
202010;352590;G;4744003;1;0;1
202010;352590;G;4741500;0;1;-1
202010;352590;G;4741500;0;1;-1
202010;352590;G;4741500;1;0;1
202010;352590;G;4731800;1;0;1
202010;352590;G;4635402;0;4;-4
202010;352590;G;4520004;0;1;-1
202010;352590;G;4754703;2;4;-2
202010;352590;G;4721102;0;1;-1
202010;352590;G;4731800;1;0;1
202010;352590;G;4772500;1;0;1
202010;352590;G;4771702;1;0;1
202010;352590;G;4781400;1;0;1
202010;352590;G;4772500;2;0;2
202010;352590;G;4754702;3;0;3
202010;352590;G;4530703;0;1;-1
202010;352590;G;4712100;1;0;1
202010;352590;G;4721102;0;1;-1
202010;352590;G;4782201;1;0;1
202010;352590;G;4729699;1;1;0
202010;352590;G;4753900;7;2;5
202010;352590;G;4753900;4;3;1
202010;352590;G;4781400;1;0;1
202010;352590;G;4639701;0;1;-1
202010;352590;G;4530703;2;3;-1
202010;352590;G;4781400;3;1;2
202010;352590;G;4744001;0;1;-1
202010;352590;G;4755502;1;0;1
202010;352590;G;4742300;1;0;1
202010;352590;G;4729699;3;0;3
202010;352590;G;4724500;0;1;-1
202010;352590;G;4761001;1;1;0
202010;352590;G;4731800;1;2;-1
202010;352590;G;4744099;0;1;-1
202010;352590;G;4530703;0;1;-1
202010;352590;G;4731800;0;2;-2
202010;352590;G;4712100;0;2;-2
202010;352590;G;4530703;1;1;0
202010;352590;G;4744001;0;1;-1
202010;352590;G;4789004;1;1;0
202010;352590;G;4663000;2;0;2
202010;352590;G;4729699;1;0;1
202010;352590;G;4721104;1;0;1
202010;352590;G;4672900;1;0;1
202010;352590;G;4511101;1;2;-1
202010;352590;G;4729699;2;5;-3
202010;352590;G;4789099;2;1;1
202010;352590;G;4686902;3;8;-5
202010;352590;G;4530703;1;0;1
202010;352590;G;4784900;0;1;-1
202010;352590;G;4759899;1;0;1
202010;352590;G;4511101;5;1;4
202010;352590;G;4729699;0;1;-1
202010;352590;G;4789099;2;0;2
202010;352590;G;4774100;1;0;1
202010;352590;G;4754701;4;7;-3
202010;352590;G;4754701;0;1;-1
202010;352590;G;4754701;0;2;-2
202010;352590;G;4724500;2;0;2
202010;352590;G;4731800;0;1;-1
202010;352590;G;4789005;3;1;2
202010;352590;G;4754701;1;2;-1
202010;352590;G;4771701;0;1;-1
202010;352590;G;4713002;2;4;-2
202010;352590;G;4711302;1;1;0
202010;352590;G;4511101;1;1;0
202010;352590;G;4686902;1;0;1
202010;352590;G;4724500;13;3;10
202010;352590;G;4633801;2;1;1
202010;352590;G;4724500;15;13;2
202010;352590;G;4781400;1;0;1
202010;352590;G;4789004;1;0;1
202010;352590;G;4784900;1;0;1
202010;352590;G;4721102;2;0;2
202010;352590;G;4772500;0;1;-1
202010;352590;G;4691500;4;11;-7
202010;352590;G;4751201;1;0;1
202010;352590;G;4520006;0;1;-1
202010;352590;G;4731800;0;1;-1
202010;352590;G;4618402;4;1;3
202010;352590;G;4757100;2;0;2
202010;352590;G;4771701;0;1;-1
202010;352590;G;4712100;0;1;-1
202010;352590;G;4647801;1;1;0
202010;352590;G;4511101;0;4;-4
202010;352590;G;4731800;0;1;-1
202010;352590;G;4782201;3;1;2
202010;352590;G;4520004;2;0;2
202010;352590;G;4754701;58;1;57
202010;352590;G;4530703;0;1;-1
202010;352590;G;4744099;1;0;1
202010;352590;G;4761003;0;1;-1
202010;352590;G;4742300;1;0;1
202010;352590;G;4759899;0;1;-1
202010;352590;G;4771701;1;0;1
202010;352590;G;4789004;1;0;1
202010;352590;G;4731800;2;0;2
202010;352590;G;4511101;1;0;1
202010;352590;G;4729699;1;1;0
202010;352590;G;4651601;1;0;1
202010;352590;G;4646001;1;0;1
202010;352590;G;4530703;0;1;-1
202010;352590;G;4712100;1;0;1
202010;352590;G;4669999;0;2;-2
202010;352590;G;4520001;1;0;1
202010;352590;G;4623109;1;4;-3
202010;352590;G;4623109;1;0;1
202010;352590;G;4781400;19;46;-27
202010;352590;G;4511104;0;2;-2
202010;352590;G;4789099;9;3;6
202010;352590;G;4782201;2;2;0
202010;352590;G;4781400;2;0;2
202010;352590;G;4781400;1;0;1
202010;352590;G;4633801;1;1;0
202010;352590;G;4744002;0;1;-1
202010;352590;G;4751201;1;1;0
202010;352590;G;4773300;0;1;-1
202010;352590;G;4633801;1;1;0
202010;352590;G;4649499;4;3;1
202010;352590;G;4782201;1;0;1
202010;352590;G;4782201;0;1;-1
202010;352590;G;4721102;1;1;0
202010;352590;G;4520001;0;1;-1
202010;352590;G;4511102;2;0;2
202010;352590;G;4530703;0;1;-1
202010;352590;G;4689301;1;0;1
202010;352590;G;4789005;0;1;-1
202010;352590;G;4713002;0;1;-1
202010;352590;G;4761001;0;1;-1
202010;352590;G;4781400;0;2;-2
202010;352590;G;4781400;4;4;0
202010;352590;G;4781400;0;5;-5
202010;352590;G;4772500;2;2;0
202010;352590;G;4757100;1;0;1
202010;352590;G;4744001;2;0;2
202010;352590;G;4783101;0;1;-1
202010;352590;G;4771704;1;0;1
202010;352590;G;4755503;0;1;-1
202010;352590;G;4712100;1;2;-1
202010;352590;G;4744099;2;0;2
202010;352590;G;4759899;0;1;-1
202010;352590;G;4755503;1;0;1
202010;352590;G;4520005;3;3;0
202010;352590;G;4744001;2;2;0
202010;352590;G;4782201;1;0;1
202010;352590;G;4771701;0;1;-1
202010;352590;G;4754701;1;0;1
202010;352590;G;4772500;2;0;2
202010;352590;G;4772500;0;1;-1
202010;352590;G;4772500;0;1;-1
202010;352590;G;4530701;0;1;-1
202010;352590;G;4691500;2;21;-19
202010;352590;G;4637199;1;1;0
202010;352590;G;4687702;1;0;1
202010;352590;G;4520007;1;0;1
202010;352590;G;4781400;1;0;1
202010;352590;G;4637199;0;4;-4
202010;352590;G;4619200;0;1;-1
202010;352590;G;4712100;1;0;1
202010;352590;G;4689399;1;1;0
202010;352590;G;4520002;0;2;-2
202010;352590;G;4669999;5;1;4
202010;352590;G;4763601;1;2;-1
202010;352590;G;4781400;1;0;1
202010;352590;G;4752100;1;0;1
202010;352590;G;4756300;1;0;1
202010;352590;G;4781400;0;1;-1
202010;352590;G;4781400;1;1;0
202010;352590;G;4772500;0;1;-1
202010;352590;G;4744005;0;1;-1
202010;352590;G;4731800;1;0;1
202010;352590;G;4763603;0;1;-1
202010;352590;G;4646001;0;1;-1
202010;352590;G;4789099;1;0;1
202010;352590;G;4744001;0;1;-1
202010;352590;G;4530704;5;2;3
202010;352590;G;4530705;2;0;2
202010;352590;G;4754701;2;22;-20
202010;352590;G;4744099;2;2;0
202010;352590;G;4771702;3;1;2
202010;352590;G;4759899;0;1;-1
202010;352590;G;4759899;0;4;-4
202010;352590;G;4772500;2;0;2
202010;352590;G;4721102;0;1;-1
202010;352590;G;4530703;0;1;-1
202010;352590;G;4761001;2;1;1
202010;352590;G;4751200;1;0;1
202010;352590;G;4623109;1;1;0
202010;352590;G;4763601;0;1;-1
202010;352590;G;4713002;1;0;1
202010;352590;G;4741500;1;0;1
202010;352590;G;4772500;1;1;0
202010;352590;G;4741500;0;1;-1
202010;352590;G;4721104;12;5;7
202010;352590;G;4637107;3;0;3
202010;352590;G;4754701;3;1;2
202010;352590;G;4752100;2;2;0
202010;352590;G;4744099;2;7;-5
202010;352590;G;4772500;1;0;1
202010;352590;G;4781400;1;0;1
202010;352590;G;4783101;2;2;0
202010;352590;G;4781400;1;0;1
202010;352590;G;4789001;1;1;0
202010;352590;G;4782201;1;0;1
202010;352590;G;4781400;2;0;2
202010;352590;G;4712100;0;1;-1
202010;352590;G;4782201;2;0;2
202010;352590;G;4782201;1;0;1
202010;352590;G;4755502;0;1;-1
202010;352590;G;4712100;0;1;-1
202010;352590;G;4721104;2;0;2
202010;352590;G;4754701;2;3;-1
202010;352590;G;4742300;0;1;-1
202010;352590;G;4774100;1;1;0
202010;352590;G;4751201;2;1;1
202010;352590;G;4763601;0;1;-1
202010;352590;G;4520005;29;6;23
202010;352590;G;4721104;0;2;-2
202010;352590;G;4772500;0;1;-1
202010;352590;G;4511102;1;0;1
202010;352590;G;4789004;1;0;1
202010;352590;G;4541201;3;0;3
202010;352590;G;4752100;5;1;4
202010;352590;G;4771702;3;3;0
202010;352590;G;4754701;1;0;1
202010;352590;G;4634601;1;1;0
202010;352590;G;4783102;0;1;-1
202010;352590;G;4789004;2;0;2
202010;352590;G;4687702;1;3;-2
202010;352590;G;4713002;1;0;1
202010;352590;G;4520005;0;1;-1
202010;352590;G;4744001;0;1;-1
202010;352590;G;4732600;5;0;5
202010;352590;G;4782201;0;1;-1
202010;352590;G;4642701;0;1;-1
202010;352590;G;4789004;1;0;1
202010;352590;G;4774100;1;0;1
202010;352590;G;4783101;1;0;1
202010;352590;G;4781400;1;1;0
202010;352590;G;4724500;1;3;-2
202010;352590;G;4771701;1;0;1
202010;352590;G;4781400;1;0;1
202010;352590;G;4754701;1;0;1
202010;352590;G;4530703;1;0;1
202010;352590;G;4530703;1;0;1
202010;352590;G;4530704;0;1;-1
202010;352590;G;4520001;5;0;5
202010;352590;G;4789005;1;0;1
202010;352590;G;4712100;0;1;-1
202010;352590;G;4753900;1;0;1
202010;352590;G;4774100;1;1;0
202010;352590;G;4637199;1;0;1
202010;352590;G;4722901;1;2;-1
202010;352590;G;4520002;0;1;-1
202010;352590;G;4652400;0;4;-4
202010;352590;G;4744002;1;1;0
202010;352590;G;4530703;0;1;-1
202010;352590;G;4729699;1;1;0
202010;352590;G;4530705;2;0;2
202010;352590;G;4721102;2;1;1
202010;352590;G;4721102;2;0;2
202010;352590;G;4774100;0;1;-1
202010;352590;G;4781400;0;1;-1
202010;352590;G;4752100;0;1;-1
202010;352590;G;4781400;1;0;1
202010;352590;G;4712100;1;1;0
202010;352590;G;4781400;1;0;1
202010;352590;G;4731800;2;5;-3
202010;352590;G;4723700;2;0;2
202010;352590;G;4669999;13;3;10
202010;352590;G;4754701;2;0;2
202010;352590;G;4754701;2;1;1
202010;352590;G;4712100;0;1;-1
202010;352590;G;4789099;0;1;-1
202010;352590;G;4721102;1;0;1
202010;352590;G;4672900;1;0;1
202010;352590;G;4712100;1;0;1
202010;352590;G;4781400;0;1;-1
202010;352590;G;4530703;1;0;1
202010;352590;G;4789002;1;1;0
202010;352590;G;4645101;6;0;6
202010;352590;G;4789004;1;0;1
202010;352590;G;4511101;1;1;0
202010;352590;G;4729699;1;0;1
202010;352590;G;4744001;0;1;-1
202010;352590;G;4731800;5;3;2
202010;352590;G;4713001;3;3;0
202010;352590;G;4781400;1;0;1
202010;352590;G;4774100;2;0;2
202010;352590;G;4759899;2;0;2
202010;352590;G;4754701;0;1;-1
202010;352590;G;4731800;5;0;5
202010;352590;G;4649499;0;2;-2
202010;352590;G;4729699;52;17;35
202010;352590;G;4646001;4;2;2
202010;352590;G;4712100;1;0;1
202010;352590;G;4771701;1;1;0
202010;352590;G;4781400;2;0;2
202010;352590;G;4781400;3;1;2
202010;352590;G;4783101;2;1;1
202010;352590;G;4772500;0;1;-1
202010;352590;G;4751201;1;1;0
202010;352590;G;4633801;0;1;-1
202010;352590;G;4511102;1;0;1
202010;352590;G;4679603;1;0;1
202010;352590;G;4633801;1;0;1
202010;352590;G;4530703;1;1;0
202010;352590;G;4781400;1;0;1
202010;352590;G;4520007;0;1;-1
202010;352590;G;4774100;0;1;-1
202010;352590;G;4639701;7;13;-6
202010;352590;G;4520007;1;0;1
202010;352590;G;4520004;1;0;1
202010;352590;G;4543900;1;0;1
202010;352590;G;4753900;1;10;-9
202010;352590;G;4781400;1;0;1
202010;352590;G;4759899;0;1;-1
202010;352590;G;4757100;1;0;1
202010;352590;G;4721103;2;0;2
202010;352590;G;4789099;0;1;-1
202010;352590;G;4782201;1;0;1
202010;352590;G;4530703;1;1;0
202010;352590;G;4789099;1;0;1
202010;352590;G;4729699;1;0;1
202010;352590;G;4744099;1;0;1
202010;352590;G;4781400;0;1;-1
202010;352590;G;4781400;0;1;-1
202010;352590;G;4633801;1;0;1
202010;352590;G;4781400;1;0;1
202010;352590;G;4759899;1;2;-1
202010;352590;G;4789099;2;0;2
202010;352590;G;4722901;0;1;-1
202010;352590;G;4511102;0;1;-1
202010;352590;G;4646001;2;1;1
202010;352590;G;4530703;0;1;-1
202010;352590;G;4530703;2;0;2
202010;352590;G;4755502;1;0;1
202010;352590;G;4774100;1;0;1
202010;352590;G;4729699;0;1;-1
202010;352590;G;4729699;1;0;1
202010;352590;G;4774100;0;2;-2
202010;352590;G;4759899;1;0;1
202010;352590;G;4729699;1;0;1
202010;352590;G;4713002;1;1;0
202010;352590;G;4781400;1;2;-1
202010;352590;G;4520006;1;0;1
202010;352590;G;4721102;3;0;3
202010;352590;G;4752100;0;1;-1
202010;352590;G;4773300;0;1;-1
202010;352590;G;4722901;0;1;-1
202010;352590;G;4686902;0;1;-1
202010;352590;G;4771701;0;1;-1
202010;352590;G;4731800;1;0;1
202010;352590;G;4781400;2;0;2
202010;352590;G;4781400;2;0;2
202010;352590;G;4789004;1;3;-2
202010;352590;G;4789004;2;1;1
202010;352590;G;4789099;0;1;-1
202010;352590;G;4687702;2;2;0
202010;352590;G;4713001;2;0;2
202010;352590;G;4783101;2;2;0
202010;352590;G;4763602;2;0;2
202010;352590;G;4729602;1;1;0
202010;352590;G;4721102;1;0;1
202010;352590;G;4789004;2;2;0
202010;352590;G;4783101;1;0;1
202010;352590;G;4729699;1;0;1
202010;352590;G;4722901;1;0;1
202010;352590;G;4789099;0;1;-1
202010;352590;G;4729699;1;0;1
202010;352590;G;4729602;1;0;1
202010;352590;G;4752100;0;2;-2
202010;352590;G;4729699;1;0;1
202010;352590;G;4712100;1;1;0
202010;352590;G;4712100;0;1;-1
202010;352590;G;4789099;3;2;1
202010;352590;G;4782201;1;0;1
202010;352590;G;4772500;2;3;-1
202010;352590;G;4781400;2;0;2
202010;352590;G;4712100;1;0;1
202010;352590;G;4781400;1;0;1
202010;352590;G;4781400;0;1;-1
202010;352590;G;4781400;0;2;-2
202010;352590;G;4789004;1;0;1
202010;352590;G;4721102;1;1;0
202010;352590;G;4763601;2;1;1
202010;352590;G;4744099;3;0;3
202010;352590;G;4511101;0;1;-1
202010;352590;G;4633801;1;0;1
202010;352590;G;4789004;1;0;1
202010;352590;G;4530705;1;1;0
202010;352590;G;4723700;2;1;1
202010;352590;G;4520001;1;0;1
202010;352590;G;4511101;1;0;1
202010;352590;G;4784900;0;1;-1
202010;352590;G;4712100;2;0;2
202010;352590;G;4771701;1;0;1
202010;352590;G;4520001;0;1;-1
202010;352590;G;4711301;6;10;-4
202010;352590;G;4511102;0;1;-1
202010;352590;G;4744099;1;0;1
202010;352590;G;4783101;1;0;1
202010;352590;G;4711302;1;1;0
202010;352590;G;4729699;0;1;-1
202010;352590;G;4731800;1;0;1
202010;352590;G;4722901;0;1;-1
202010;352590;G;4520005;5;2;3
202010;352590;G;4781400;1;1;0
202010;352590;G;4781400;1;1;0
202010;352590;G;4782201;1;0;1
202010;352590;G;4530703;1;0;1
202010;352590;G;4774100;0;1;-1
202010;352590;G;4713002;2;0;2
202010;352590;G;4637199;5;3;2
202010;352590;G;4754701;1;0;1
202010;352590;G;4744005;2;2;0
202010;352590;G;4729699;2;0;2
202010;352590;G;4781400;1;0;1
202010;352590;G;4774100;1;0;1
202010;352590;G;4642701;1;1;0
202010;352590;G;4722902;0;1;-1
202010;352590;G;4781400;1;0;1
202010;352590;G;4713002;1;2;-1
202010;352590;G;4784900;1;0;1
202010;352590;G;4789002;2;1;1
202010;352590;G;4742300;1;1;0
202010;352590;G;4763602;1;0;1
202010;352590;G;4781400;0;2;-2
202010;352590;G;4744005;2;0;2
202010;352590;G;4712100;1;0;1
202010;352590;G;4771701;0;2;-2
202010;352590;G;4742300;1;0;1
202010;352590;G;4711302;0;3;-3
202010;352590;G;4757100;1;0;1
202010;352590;G;4789099;1;0;1
202010;352590;G;4772500;0;1;-1
202010;352590;G;4729699;0;1;-1
202010;352590;G;4520006;2;0;2
202010;352590;G;4711302;3;2;1
202010;352590;G;4711302;1;0;1
202010;352590;G;4752100;1;0;1
202010;352590;G;4752100;0;1;-1
202010;352590;G;4753900;4;0;4
202010;352590;G;4753900;20;32;-12
202010;352590;G;4753900;13;4;9
202010;352590;G;4753900;8;5;3
202010;352590;G;4753900;11;1;10
202010;352590;G;4753900;3;9;-6
202010;352590;G;4753900;2;0;2
202010;352590;G;4753900;6;2;4
202010;352590;G;4752100;1;0;1
202010;352590;G;4712100;3;3;0
202010;352590;G;4712100;1;6;-5
202010;352590;G;4789099;0;1;-1
202010;352590;G;4781400;2;0;2
202010;352590;G;4781400;3;3;0
202010;352590;G;4781400;2;1;1
202010;352590;G;4752100;1;2;-1
202010;352590;G;4541204;0;1;-1
202010;352590;G;4721104;0;1;-1
202010;352590;G;4774100;0;1;-1
202010;352590;G;4744001;5;0;5
202010;352590;G;4520001;0;1;-1
202010;352590;G;4712100;1;0;1
202010;352590;G;4763602;1;0;1
202010;352590;G;4785799;1;3;-2
202010;352590;G;4789004;1;0;1
202010;352590;G;4669999;8;5;3
202010;352590;G;4669999;4;0;4
202010;352590;G;4729602;2;1;1
202010;352590;G;4754702;0;1;-1
202010;352590;G;4782201;1;1;0
202010;352590;G;4771701;3;3;0
202010;352590;G;4763602;1;1;0
202010;352590;G;4771701;0;2;-2
202010;352590;G;4530703;1;0;1
202010;352590;G;4713002;1;0;1
202010;352590;G;4774100;2;0;2
202010;352590;G;4774100;2;0;2
202010;352590;G;4781400;1;3;-2
202010;352590;G;4721102;0;1;-1
202010;352590;G;4731800;5;0;5
202010;352590;G;4781400;1;0;1
202010;352590;G;4744001;0;1;-1
202010;352590;G;4712100;0;1;-1
202010;352590;G;4781400;0;1;-1
202010;352590;G;4713002;3;2;1
202010;352590;G;4520007;2;0;2
202010;352590;G;4723700;2;2;0
202010;352590;G;4759899;2;0;2
202010;352590;G;4744003;1;0;1
202010;352590;G;4781400;4;2;2
202010;352590;G;4520001;2;0;2
202010;352590;G;4771701;1;0;1
202010;352590;G;4721104;2;1;1
202010;352590;G;4781400;2;0;2
202010;352590;G;4723700;3;0;3
202010;352590;G;4744001;0;1;-1
202010;352590;G;4781400;1;0;1
202010;352590;G;4789099;3;0;3
202010;352590;G;4789001;2;0;2
202010;352590;G;4729699;1;0;1
202010;352590;G;4763601;1;0;1
202010;352590;G;4729602;0;1;-1
202010;352590;G;4781400;8;1;7
202010;352590;G;4774100;1;0;1
202010;352590;G;4729699;1;0;1
202010;352590;G;4686902;2;0;2
202010;352590;G;4789001;1;0;1
202010;352590;G;4530703;3;0;3
202010;352590;G;4530703;1;0;1
202010;352590;G;4713001;1;1;0
202010;352590;G;4729699;1;0;1
202010;352590;G;4647801;0;1;-1
202010;352590;G;4721104;0;1;-1
202010;352590;G;4753900;2;2;0
202010;352590;G;4753900;2;1;1
202010;352590;G;4789099;1;1;0
202010;352590;G;4744005;0;2;-2
202010;352590;G;4721102;1;0;1
202010;352590;G;4781400;1;1;0
202010;352590;G;4781400;2;6;-4
202010;352590;G;4781400;2;1;1
202010;352590;G;4773300;1;1;0
202010;352590;G;4782201;1;0;1
202010;352590;G;4782201;2;4;-2
202010;352590;G;4782201;1;0;1
202010;352590;G;4761003;1;0;1
202010;352590;G;4711301;23;8;15
202010;352590;G;4731800;0;3;-3
202010;352590;G;4744005;1;1;0
202010;352590;G;4781400;1;0;1
202010;352590;G;4744002;1;1;0
202010;352590;G;4639701;4;7;-3
202010;352590;G;4754701;1;0;1
202010;352590;G;4781400;3;3;0
202010;352590;G;4711302;0;7;-7
202010;352590;G;4771701;1;0;1
202010;352590;G;4711302;0;7;-7
202010;352590;G;4789007;0;1;-1
202010;352590;G;4789002;1;0;1
202010;352590;G;4711302;1;0;1
202010;352590;G;4713001;1;1;0
202010;352590;G;4774100;0;1;-1
202010;352590;G;4731800;1;1;0
202010;352590;G;4781400;1;1;0
202010;352590;G;4781400;1;0;1
202010;352590;G;4772500;1;2;-1
202010;352590;G;4772500;0;4;-4
202010;352590;G;4530703;1;2;-1
202010;352590;G;4722901;1;0;1
202010;352590;G;4755503;0;1;-1
202010;352590;G;4711302;1;1;0
202010;352590;G;4712100;1;0;1
202010;352590;G;4731800;2;2;0
202010;352590;G;4744099;1;0;1
202010;352590;G;4530703;1;1;0
202010;352590;G;4511101;0;2;-2
202010;352590;G;4689399;2;2;0
202010;352590;G;4511104;5;0;5
202010;352590;G;4672900;0;2;-2
202010;352590;G;4712100;1;0;1
202010;352590;G;4753900;1;0;1
202010;352590;G;4771701;0;1;-1
202010;352590;G;4731800;1;3;-2
202010;352590;G;4711302;1;1;0
202010;352590;G;4711302;1;6;-5
202010;352590;G;4711302;1;5;-4
202010;352590;G;4711302;1;1;0
202010;352590;G;4711302;5;5;0
202010;352590;G;4711302;3;2;1
202010;352590;G;4711302;2;0;2
202010;352590;G;4711302;12;11;1
202010;352590;G;4711302;4;2;2
202010;352590;G;4711302;8;7;1
202010;352590;G;4639701;0;1;-1
202010;352590;G;4711302;5;5;0
202010;352590;G;4711302;1;1;0
202010;352590;G;4711302;4;2;2
202010;352590;G;4711302;4;2;2
202010;352590;G;4711302;14;5;9
202010;352590;G;4511101;0;1;-1
202010;352590;G;4635499;0;1;-1
202010;352590;G;4731800;1;0;1
202010;352590;G;4711302;4;3;1
202010;352590;G;4711302;2;3;-1
202010;352590;G;4711302;2;5;-3
202010;352590;G;4711302;0;5;-5
202010;352590;G;4711302;3;7;-4
202010;352590;G;4633801;7;3;4
202010;352590;G;4761003;1;0;1
202010;352590;G;4744099;1;1;0
202010;352590;G;4647801;3;3;0
202010;352590;G;4771701;0;1;-1
202010;352590;G;4661300;6;5;1
202010;352590;G;4639701;3;4;-1
202010;352590;G;4744099;2;2;0
202010;352590;G;4789008;0;1;-1
202010;352590;G;4782201;1;1;0
202010;352590;G;4782201;5;4;1
202010;352590;G;4771702;7;7;0
202010;352590;G;4530703;2;0;2
202010;352590;G;4530701;1;0;1
202010;352590;G;4721102;2;1;1
202010;352590;G;4771701;1;0;1
202010;352590;G;4789004;3;3;0
202010;352590;G;4669999;4;4;0
202010;352590;G;4789004;1;0;1
202010;352590;G;4771701;2;0;2
202010;352590;G;4712100;1;0;1
202010;352590;G;4520001;1;1;0
202010;352590;G;4712100;3;1;2
202010;352590;G;4744005;0;1;-1
202010;352590;G;4520001;0;1;-1
202010;352590;G;4712100;0;3;-3
202010;352590;G;4712100;0;1;-1
202010;352590;G;4744005;1;1;0
202010;352590;G;4530703;1;0;1
202010;352590;G;4511101;3;3;0
202010;352590;G;4687702;1;0;1
202010;352590;G;4661300;3;1;2
202010;352590;G;4721102;0;1;-1
202010;352590;G;4789005;1;0;1
202010;352590;G;4649403;0;1;-1
202010;352590;G;4753900;1;1;0
202010;352590;G;4511102;0;1;-1
202010;352590;G;4761003;0;2;-2
202010;352590;G;4731800;1;0;1
202010;352590;G;4541205;1;0;1
202010;352590;G;4774100;0;2;-2
202010;352590;G;4721103;1;0;1
202010;352590;G;4721103;0;1;-1
202010;352590;G;4530703;1;0;1
202010;352590;G;4712100;1;0;1
202010;352590;G;4763601;0;1;-1
202010;352590;G;4771702;1;0;1
202010;352590;G;4763601;11;11;0
202010;352590;G;4635402;6;7;-1
202010;352590;G;4731800;0;1;-1
202010;352590;G;4721102;2;2;0
202010;352590;G;4751201;1;0;1
202010;352590;G;4755502;1;1;0
202010;352590;G;4774100;1;0;1
202010;352590;G;4744001;1;0;1
202010;352590;G;4741500;0;1;-1
202010;352590;G;4731800;1;0;1
202010;352590;G;4731800;1;1;0
202010;352590;G;4633801;0;1;-1
202010;352590;G;4530703;1;0;1
202010;352590;G;4631100;0;1;-1
202010;352590;G;4744005;2;0;2
202010;352590;G;4744005;2;1;1
202010;352590;G;4511104;2;1;1
202010;352590;G;4781400;0;1;-1
202010;352590;G;4633802;2;0;2
202010;352590;G;4633802;0;2;-2
202010;352590;G;4713001;2;0;2
202010;352590;G;4713004;3;7;-4
202010;352590;G;4646001;2;1;1
202010;352590;G;4635402;6;3;3
202010;352590;G;4781400;0;1;-1
202010;352590;G;4711302;4;9;-5
202010;352590;G;4771701;3;1;2
202010;352590;G;4771701;1;0;1
202010;352590;G;4645101;1;0;1
202010;352590;G;4771701;1;0;1
202010;352590;G;4771701;2;1;1
202010;352590;G;4771701;0;1;-1
202010;352590;G;4771701;1;1;0
202010;352590;G;4771701;1;0;1
202010;352590;G;4771701;1;0;1
202010;352590;G;4771701;1;0;1
202010;352590;G;4635402;1;0;1
202010;352590;G;4782202;1;1;0
202010;352590;G;4782202;0;1;-1
202010;352590;G;4759899;1;1;0
202010;352590;G;4637107;6;1;5
202010;352590;G;4633801;1;0;1
202010;352590;G;4789002;2;7;-5
202010;352590;G;4744099;2;3;-1
202010;352590;G;4530701;1;0;1
202010;352590;G;4752100;1;0;1
202010;352590;G;4530703;1;2;-1
202010;352590;G;4530705;0;1;-1
202010;352590;G;4789099;2;1;1
202010;352590;G;4711302;28;48;-20
202010;352590;G;4783101;2;1;1
202010;352590;G;4789099;1;1;0
202010;352590;G;4530701;0;1;-1
202010;352590;G;4771701;0;2;-2
202010;352590;G;4771701;1;0;1
202010;352590;G;4771701;0;1;-1
202010;352590;G;4754701;0;1;-1
202010;352590;G;4744005;1;1;0
202010;352590;G;4722901;2;0;2
202010;352590;G;4729699;2;1;1
202010;352590;G;4713002;0;1;-1
202010;352590;G;4789099;1;1;0
202010;352590;G;4781400;0;1;-1
202010;352590;G;4744005;2;4;-2
202010;352590;G;4781400;1;0;1
202010;352590;G;4744005;1;0;1
202010;352590;G;4623199;4;1;3
202010;352590;G;4783101;1;0;1
202010;352590;G;4712100;1;0;1
202010;352590;G;4712100;1;0;1
202010;352590;G;4712100;0;1;-1
202010;352590;G;4721102;0;2;-2
202010;352590;G;4771702;1;1;0
202010;352590;G;4511101;2;1;1
202010;352590;G;4712100;0;1;-1
202010;352590;G;4771701;1;1;0
202010;352590;G;4744005;1;1;0
202010;352590;G;4741500;1;1;0
202010;352590;G;4741500;1;1;0
202010;352590;G;4741500;0;3;-3
202010;352590;G;4744005;0;1;-1
202010;352590;G;4781400;0;1;-1
202010;352590;G;4663000;1;0;1
202010;352590;G;4774100;0;1;-1
202010;352590;G;4789099;0;1;-1
202010;352590;G;4731800;2;1;1
202010;352590;G;4731800;1;0;1
202010;352590;G;4692300;0;1;-1
202010;352590;G;4520005;3;1;2
202010;352590;G;4761002;0;1;-1
202010;352590;G;4743100;0;1;-1
202010;352590;G;4635402;10;1;9
202010;352590;G;4711302;1;1;0
202010;352590;G;4729699;0;2;-2
202010;352590;G;4711301;14;9;5
202010;352590;G;4672900;2;2;0
202010;352590;G;4757100;2;0;2
202010;352590;G;4530703;3;3;0
202010;352590;G;4711301;12;6;6
202010;352590;G;4679604;11;7;4
202010;352590;G;4783101;2;0;2
202010;352590;G;4661300;0;1;-1
202010;352590;G;4744001;3;1;2
202010;352590;G;4781400;2;2;0
202010;352590;G;4781400;0;1;-1
202010;352590;G;4771702;0;1;-1
202010;352590;G;4781400;0;1;-1
202010;352590;G;4752100;0;1;-1
202006;352590;G;4744005;2;1;1
202006;352590;G;4672900;0;2;-2
202006;352590;G;4757100;0;1;-1
202006;352590;G;4753900;10;1;9
202006;352590;G;4789099;1;0;1
202006;352590;G;4789007;0;1;-1
202006;352590;G;4789099;0;1;-1
202006;352590;G;4530703;0;1;-1
202006;352590;G;4772500;0;1;-1
202006;352590;G;4616800;0;1;-1
202006;352590;G;4781400;0;4;-4
202006;352590;G;4693100;11;10;1
202006;352590;G;4511101;6;8;-2
202006;352590;G;4644301;24;9;15
202006;352590;G;4771701;1;0;1
202006;352590;G;4721102;1;0;1
202006;352590;G;4689399;0;7;-7
202006;352590;G;4689301;1;0;1
202006;352590;G;4530703;1;0;1
202006;352590;G;4721104;0;1;-1
202006;352590;G;4687703;1;0;1
202006;352590;G;4634601;1;10;-9
202006;352590;G;4712100;1;0;1
202006;352590;G;4712100;0;1;-1
202006;352590;G;4789099;1;0;1
202006;352590;G;4752100;0;3;-3
202006;352590;G;4530702;1;1;0
202006;352590;G;4687703;0;1;-1
202006;352590;G;4759899;1;0;1
202006;352590;G;4744005;1;0;1
202006;352590;G;4731800;0;1;-1
202006;352590;G;4639701;3;1;2
202006;352590;G;4751201;4;2;2
202006;352590;G;4763602;0;1;-1
202006;352590;G;4731800;0;1;-1
202006;352590;G;4511101;0;2;-2
202006;352590;G;4784900;1;1;0
202006;352590;G;4754701;1;0;1
202006;352590;G;4686902;0;7;-7
202006;352590;G;4773300;0;1;-1
202006;352590;G;4511101;0;1;-1
202006;352590;G;4511101;0;2;-2
202006;352590;G;4520001;0;1;-1
202006;352590;G;4721102;0;2;-2
202006;352590;G;4753900;0;1;-1
202006;352590;G;4789001;0;1;-1
202006;352590;G;4771701;1;1;0
202006;352590;G;4744002;0;1;-1
202006;352590;G;4789007;0;1;-1
202006;352590;G;4754703;0;1;-1
202006;352590;G;4789099;0;1;-1
202006;352590;G;4759899;0;1;-1
202006;352590;G;4754701;0;1;-1
202006;352590;G;4744099;1;0;1
202006;352590;G;4771702;1;0;1
202006;352590;G;4781400;0;1;-1
202006;352590;G;4711302;8;1;7
202006;352590;G;4711302;5;0;5
202006;352590;G;4729699;0;1;-1
202006;352590;G;4751201;2;3;-1
202006;352590;G;4724500;0;1;-1
202006;352590;G;4633801;0;2;-2
202006;352590;G;4713002;0;1;-1
202006;352590;G;4774100;0;1;-1
202006;352590;G;4771701;0;1;-1
202006;352590;G;4783101;0;1;-1
202006;352590;G;4789005;1;0;1
202006;352590;G;4731800;0;1;-1
202006;352590;G;4744005;2;0;2
202006;352590;G;4637106;5;3;2
202006;352590;G;4689399;0;1;-1
202006;352590;G;4672900;0;1;-1
202006;352590;G;4742300;0;2;-2
202006;352590;G;4520001;1;1;0
202006;352590;G;4789002;2;0;2
202006;352590;G;4541202;1;1;0
202006;352590;G;4712100;0;1;-1
202006;352590;G;4511101;0;1;-1
202006;352590;G;4731800;0;6;-6
202006;352590;G;4639701;14;9;5
202006;352590;G;4731800;0;1;-1
202006;352590;G;4771701;1;1;0
202006;352590;G;4712100;0;1;-1
202006;352590;G;4530705;0;1;-1
202006;352590;G;4789002;1;1;0
202006;352590;G;4781400;0;4;-4
202006;352590;G;4755501;0;1;-1
202006;352590;G;4520001;3;0;3
202006;352590;G;4789007;1;2;-1
202006;352590;G;4686902;0;1;-1
202006;352590;G;4753900;0;1;-1
202006;352590;G;4639701;0;1;-1
202006;352590;G;4712100;0;1;-1
202006;352590;G;4789002;0;2;-2
202006;352590;G;4520002;0;1;-1
202006;352590;G;4761002;0;1;-1
202006;352590;G;4731800;0;1;-1
202006;352590;G;4782201;0;1;-1
202006;352590;G;4511101;5;1;4
202006;352590;G;4755502;1;0;1
202006;352590;G;4783101;0;1;-1
202006;352590;G;4789008;0;1;-1
202006;352590;G;4721102;1;1;0
202006;352590;G;4744099;0;1;-1
202006;352590;G;4693100;2;0;2
202006;352590;G;4711302;4;11;-7
202006;352590;G;4774100;0;1;-1
202006;352590;G;4649499;2;2;0
202006;352590;G;4771701;1;0;1
202006;352590;G;4741500;0;1;-1
202006;352590;G;4759899;0;1;-1
202006;352590;G;4649499;1;3;-2
202006;352590;G;4761001;1;0;1
202006;352590;G;4520001;0;1;-1
202006;352590;G;4772500;0;1;-1
202006;352590;G;4712100;1;0;1
202006;352590;G;4633801;0;1;-1
202006;352590;G;4789099;0;1;-1
202006;352590;G;4711302;10;3;7
202006;352590;G;4711301;48;2;46
202006;352590;G;4711302;0;1;-1
202006;352590;G;4511102;2;0;2
202006;352590;G;4754702;1;0;1
202006;352590;G;4761001;0;1;-1
202006;352590;G;4781400;0;1;-1
202006;352590;G;4721102;0;1;-1
202006;352590;G;4759899;0;1;-1
202006;352590;G;4712100;4;2;2
202006;352590;G;4789002;1;0;1
202006;352590;G;4763602;2;0;2
202006;352590;G;4731800;0;1;-1
202006;352590;G;4652400;0;22;-22
202006;352590;G;4711302;11;14;-3
202006;352590;G;4763603;1;0;1
202006;352590;G;4763603;2;1;1
202006;352590;G;4731800;0;1;-1
202006;352590;G;4649410;0;2;-2
202006;352590;G;4530703;0;1;-1
202006;352590;G;4781400;0;1;-1
202006;352590;G;4754702;1;0;1
202006;352590;G;4633801;11;9;2
202006;352590;G;4645103;0;4;-4
202006;352590;G;4731800;0;1;-1
202006;352590;G;4731800;0;1;-1
202006;352590;G;4771701;2;0;2
202006;352590;G;4741500;1;1;0
202006;352590;G;4635402;0;1;-1
202006;352590;G;4789005;0;1;-1
202006;352590;G;4754703;0;1;-1
202006;352590;G;4617600;0;2;-2
202006;352590;G;4722901;0;1;-1
202006;352590;G;4761003;0;1;-1
202006;352590;G;4712100;1;0;1
202006;352590;G;4789001;0;1;-1
202006;352590;G;4721102;0;1;-1
202006;352590;G;4753900;2;1;1
202006;352590;G;4753900;0;1;-1
202006;352590;G;4744002;0;1;-1
202006;352590;G;4789002;0;1;-1
202006;352590;G;4639701;1;0;1
202006;352590;G;4614100;1;2;-1
202006;352590;G;4731800;0;1;-1
202006;352590;G;4729699;0;1;-1
202006;352590;G;4742300;1;0;1
202006;352590;G;4731800;0;1;-1
202006;352590;G;4773300;0;1;-1
202006;352590;G;4781400;0;4;-4
202006;352590;G;4731800;0;2;-2
202006;352590;G;4712100;1;2;-1
202006;352590;G;4530703;0;1;-1
202006;352590;G;4744001;1;0;1
202006;352590;G;4520001;0;1;-1
202006;352590;G;4511101;0;2;-2
202006;352590;G;4530703;0;1;-1
202006;352590;G;4729699;0;1;-1
202006;352590;G;4789099;1;1;0
202006;352590;G;4686902;4;7;-3
202006;352590;G;4530703;1;0;1
202006;352590;G;4511101;3;1;2
202006;352590;G;4669901;0;1;-1
202006;352590;G;4781400;0;1;-1
202006;352590;G;4789099;0;2;-2
202006;352590;G;4754701;8;3;5
202006;352590;G;4754701;0;1;-1
202006;352590;G;4731800;0;1;-1
202006;352590;G;4530703;0;1;-1
202006;352590;G;4789002;0;1;-1
202006;352590;G;4713002;0;1;-1
202006;352590;G;4511102;0;1;-1
202006;352590;G;4511101;1;0;1
202006;352590;G;4724500;6;8;-2
202006;352590;G;4633801;1;2;-1
202006;352590;G;4724500;6;5;1
202006;352590;G;4784900;0;1;-1
202006;352590;G;4772500;0;1;-1
202006;352590;G;4691500;3;5;-2
202006;352590;G;4721103;0;1;-1
202006;352590;G;4520005;0;1;-1
202006;352590;G;4781400;0;1;-1
202006;352590;G;4771701;0;2;-2
202006;352590;G;4712100;0;1;-1
202006;352590;G;4633801;2;0;2
202006;352590;G;4511101;1;2;-1
202006;352590;G;4761003;0;1;-1
202006;352590;G;4742300;0;1;-1
202006;352590;G;4732600;1;0;1
202006;352590;G;4731800;1;1;0
202006;352590;G;4712100;0;1;-1
202006;352590;G;4511101;1;1;0
202006;352590;G;4712100;3;0;3
202006;352590;G;4520001;0;1;-1
202006;352590;G;4623109;0;4;-4
202006;352590;G;4623109;0;1;-1
202006;352590;G;4781400;5;87;-82
202006;352590;G;4511104;0;1;-1
202006;352590;G;4789099;5;0;5
202006;352590;G;4633801;0;1;-1
202006;352590;G;4744002;1;0;1
202006;352590;G;4751201;1;0;1
202006;352590;G;4789005;0;1;-1
202006;352590;G;4789002;0;1;-1
202006;352590;G;4729601;0;2;-2
202006;352590;G;4772500;0;4;-4
202006;352590;G;4789002;0;1;-1
202006;352590;G;4633801;0;1;-1
202006;352590;G;4744002;0;1;-1
202006;352590;G;4751201;0;1;-1
202006;352590;G;4781400;0;1;-1
202006;352590;G;4722901;0;1;-1
202006;352590;G;4744001;0;1;-1
202006;352590;G;4530703;0;1;-1
202006;352590;G;4689301;0;1;-1
202006;352590;G;4761001;0;2;-2
202006;352590;G;4781400;0;1;-1
202006;352590;G;4783101;2;1;1
202006;352590;G;4711302;1;0;1
202006;352590;G;4744001;1;0;1
202006;352590;G;4520002;0;1;-1
202006;352590;G;4782201;0;1;-1
202006;352590;G;4771701;1;0;1
202006;352590;G;4754701;2;0;2
202006;352590;G;4772500;0;1;-1
202006;352590;G;4772500;0;1;-1
202006;352590;G;4691500;8;9;-1
202006;352590;G;4689399;1;0;1
202006;352590;G;4637199;1;0;1
202006;352590;G;4781400;0;2;-2
202006;352590;G;4520005;0;1;-1
202006;352590;G;4774100;1;0;1
202006;352590;G;4763601;2;4;-2
202006;352590;G;4632003;0;1;-1
202006;352590;G;4744001;0;1;-1
202006;352590;G;4744005;0;1;-1
202006;352590;G;4756300;0;1;-1
202006;352590;G;4530703;0;1;-1
202006;352590;G;4646001;0;1;-1
202006;352590;G;4789099;1;0;1
202006;352590;G;4672900;1;1;0
202006;352590;G;4530704;0;1;-1
202006;352590;G;4789099;0;1;-1
202006;352590;G;4754701;42;10;32
202006;352590;G;4744099;0;1;-1
202006;352590;G;4789099;0;1;-1
202006;352590;G;4759899;0;2;-2
202006;352590;G;4511102;0;1;-1
202006;352590;G;4761001;2;3;-1
202006;352590;G;4789004;0;1;-1
202006;352590;G;4763601;0;1;-1
202006;352590;G;4774100;0;1;-1
202006;352590;G;4721104;2;3;-1
202006;352590;G;4637107;0;1;-1
202006;352590;G;4744099;3;2;1
202006;352590;G;4721104;0;1;-1
202006;352590;G;4663000;1;1;0
202006;352590;G;4782201;0;2;-2
202006;352590;G;4729699;0;2;-2
202006;352590;G;4712100;1;0;1
202006;352590;G;4772500;0;1;-1
202006;352590;G;4755502;0;1;-1
202006;352590;G;4712100;0;1;-1
202006;352590;G;4752100;1;0;1
202006;352590;G;4729699;0;1;-1
202006;352590;G;4781400;0;1;-1
202006;352590;G;4712100;0;1;-1
202006;352590;G;4520005;23;1;22
202006;352590;G;4729699;1;0;1
202006;352590;G;4541201;0;4;-4
202006;352590;G;4782201;0;1;-1
202006;352590;G;4771702;3;2;1
202006;352590;G;4789099;0;1;-1
202006;352590;G;4744001;0;1;-1
202006;352590;G;4752100;0;1;-1
202006;352590;G;4754701;0;1;-1
202006;352590;G;4634601;3;1;2
202006;352590;G;4789004;0;2;-2
202006;352590;G;4781400;0;1;-1
202006;352590;G;4789001;0;2;-2
202006;352590;G;4663000;0;1;-1
202006;352590;G;4772500;0;1;-1
202006;352590;G;4789004;0;1;-1
202006;352590;G;4530703;0;1;-1
202006;352590;G;4712100;0;1;-1
202006;352590;G;4771701;0;1;-1
202006;352590;G;4520001;0;1;-1
202006;352590;G;4789001;1;1;0
202006;352590;G;4761001;1;2;-1
202006;352590;G;4722901;2;0;2
202006;352590;G;4722901;0;1;-1
202006;352590;G;4652400;2;0;2
202006;352590;G;4774100;1;0;1
202006;352590;G;4530703;0;2;-2
202006;352590;G;4530703;1;0;1
202006;352590;G;4729699;0;1;-1
202006;352590;G;4530705;1;1;0
202006;352590;G;4721102;1;0;1
202006;352590;G;4721102;0;3;-3
202006;352590;G;4721102;1;0;1
202006;352590;G;4781400;0;1;-1
202006;352590;G;4752100;1;0;1
202006;352590;G;4731800;1;0;1
202006;352590;G;4669999;6;1;5
202006;352590;G;4712100;1;1;0
202006;352590;G;4712100;0;1;-1
202006;352590;G;4789099;0;1;-1
202006;352590;G;4530703;0;1;-1
202006;352590;G;4721102;0;1;-1
202006;352590;G;4754701;1;0;1
202006;352590;G;4645101;18;2;16
202006;352590;G;4744001;0;3;-3
202006;352590;G;4520001;1;1;0
202006;352590;G;4731800;0;4;-4
202006;352590;G;4729699;21;1;20
202006;352590;G;4742300;6;2;4
202006;352590;G;4729699;0;1;-1
202006;352590;G;4646001;0;3;-3
202006;352590;G;4781400;0;1;-1
202006;352590;G;4520001;0;1;-1
202006;352590;G;4774100;0;1;-1
202006;352590;G;4772500;2;0;2
202006;352590;G;4633801;2;0;2
202006;352590;G;4721102;1;0;1
202006;352590;G;4633801;0;1;-1
202006;352590;G;4530703;1;1;0
202006;352590;G;4789099;0;1;-1
202006;352590;G;4639701;5;4;1
202006;352590;G;4520007;1;1;0
202006;352590;G;4722901;1;0;1
202006;352590;G;4753900;33;5;28
202006;352590;G;4530704;0;2;-2
202006;352590;G;4759899;1;0;1
202006;352590;G;4761003;1;0;1
202006;352590;G;4761003;0;1;-1
202006;352590;G;4731800;0;1;-1
202006;352590;G;4723700;1;0;1
202006;352590;G;4530703;0;1;-1
202006;352590;G;4744099;0;1;-1
202006;352590;G;4781400;0;1;-1
202006;352590;G;4633801;1;0;1
202006;352590;G;4781400;1;0;1
202006;352590;G;4614100;0;1;-1
202006;352590;G;4772500;0;3;-3
202006;352590;G;4781400;0;1;-1
202006;352590;G;4771701;0;3;-3
202006;352590;G;4773300;0;1;-1
202006;352590;G;4761001;0;1;-1
202006;352590;G;4744005;1;0;1
202006;352590;G;4520006;3;1;2
202006;352590;G;4721102;1;1;0
202006;352590;G;4771701;1;0;1
202006;352590;G;4729699;1;0;1
202006;352590;G;4789004;0;2;-2
202006;352590;G;4782201;1;0;1
202006;352590;G;4781400;0;1;-1
202006;352590;G;4755501;2;0;2
202006;352590;G;4722901;1;0;1
202006;352590;G;4687702;0;2;-2
202006;352590;G;4713001;1;1;0
202006;352590;G;4711302;1;2;-1
202006;352590;G;4771701;1;0;1
202006;352590;G;4789099;0;1;-1
202006;352590;G;4639701;1;0;1
202006;352590;G;4757100;0;1;-1
202006;352590;G;4789099;3;0;3
202006;352590;G;4741500;0;1;-1
202006;352590;G;4721102;0;1;-1
202006;352590;G;4753900;0;1;-1
202006;352590;G;4712100;2;2;0
202006;352590;G;4789099;1;1;0
202006;352590;G;4772500;3;0;3
202006;352590;G;4721104;0;2;-2
202006;352590;G;4729699;0;1;-1
202006;352590;G;4781400;1;0;1
202006;352590;G;4781400;0;3;-3
202006;352590;G;4744001;1;0;1
202006;352590;G;4744099;0;1;-1
202006;352590;G;4511101;1;1;0
202006;352590;G;4723700;1;1;0
202006;352590;G;4784900;2;0;2
202006;352590;G;4520002;1;0;1
202006;352590;G;4781400;0;1;-1
202006;352590;G;4781400;0;1;-1
202006;352590;G;4711301;5;8;-3
202006;352590;G;4711302;2;0;2
202006;352590;G;4789099;0;1;-1
202006;352590;G;4781400;1;0;1
202006;352590;G;4781400;0;2;-2
202006;352590;G;4729699;1;0;1
202006;352590;G;4781400;0;1;-1
202006;352590;G;4713002;0;1;-1
202006;352590;G;4637199;1;0;1
202006;352590;G;4729699;0;1;-1
202006;352590;G;4774100;1;0;1
202006;352590;G;4722902;0;1;-1
202006;352590;G;4713002;1;0;1
202006;352590;G;4789002;1;1;0
202006;352590;G;4742300;2;0;2
202006;352590;G;4742300;2;1;1
202006;352590;G;4711302;1;0;1
202006;352590;G;4530703;1;0;1
202006;352590;G;4752100;2;1;1
202006;352590;G;4789099;1;0;1
202006;352590;G;4520006;1;1;0
202006;352590;G;4753900;0;1;-1
202006;352590;G;4753900;18;19;-1
202006;352590;G;4753900;0;2;-2
202006;352590;G;4753900;0;3;-3
202006;352590;G;4753900;0;9;-9
202006;352590;G;4781400;0;1;-1
202006;352590;G;4781400;0;3;-3
202006;352590;G;4530703;1;0;1
202006;352590;G;4684299;0;1;-1
202006;352590;G;4724500;1;0;1
202006;352590;G;4744001;0;1;-1
202006;352590;G;4759899;0;1;-1
202006;352590;G;4785799;1;0;1
202006;352590;G;4759899;0;1;-1
202006;352590;G;4669999;5;1;4
202006;352590;G;4669999;0;1;-1
202006;352590;G;4511101;1;0;1
202006;352590;G;4771701;2;1;1
202006;352590;G;4721102;2;0;2
202006;352590;G;4744099;3;0;3
202006;352590;G;4789002;1;0;1
202006;352590;G;4712100;3;0;3
202006;352590;G;4723700;4;1;3
202006;352590;G;4771701;1;0;1
202006;352590;G;4781400;0;3;-3
202006;352590;G;4774100;1;0;1
202006;352590;G;4753900;0;2;-2
202006;352590;G;4753900;0;1;-1
202006;352590;G;4744005;1;0;1
202006;352590;G;4530703;1;1;0
202006;352590;G;4789099;0;1;-1
202006;352590;G;4781400;0;6;-6
202006;352590;G;4781400;0;1;-1
202006;352590;G;4782201;0;18;-18
202006;352590;G;4782201;0;5;-5
202006;352590;G;4782201;0;5;-5
202006;352590;G;4782201;0;3;-3
202006;352590;G;4782201;0;5;-5
202006;352590;G;4782201;0;6;-6
202006;352590;G;4782201;0;21;-21
202006;352590;G;4782201;0;3;-3
202006;352590;G;4711301;24;7;17
202006;352590;G;4771701;1;0;1
202006;352590;G;4744005;0;1;-1
202006;352590;G;4672900;0;1;-1
202006;352590;G;4781400;0;2;-2
202006;352590;G;4646001;1;0;1
202006;352590;G;4744002;2;0;2
202006;352590;G;4639701;1;0;1
202006;352590;G;4731800;0;1;-1
202006;352590;G;4711302;3;14;-11
202006;352590;G;4711302;0;3;-3
202006;352590;G;4721102;0;1;-1
202006;352590;G;4637107;0;1;-1
202006;352590;G;4713001;0;1;-1
202006;352590;G;4731800;0;4;-4
202006;352590;G;4784900;0;1;-1
202006;352590;G;4731800;0;1;-1
202006;352590;G;4772500;3;0;3
202006;352590;G;4744005;0;1;-1
202006;352590;G;4530703;3;1;2
202006;352590;G;4755503;0;1;-1
202006;352590;G;4761003;0;1;-1
202006;352590;G;4711302;1;0;1
202006;352590;G;4783101;0;1;-1
202006;352590;G;4731800;0;1;-1
202006;352590;G;4511101;0;2;-2
202006;352590;G;4689399;5;0;5
202006;352590;G;4530703;0;1;-1
202006;352590;G;4744005;1;0;1
202006;352590;G;4541203;1;0;1
202006;352590;G;4721102;0;1;-1
202006;352590;G;4711302;0;2;-2
202006;352590;G;4711302;0;2;-2
202006;352590;G;4711302;0;1;-1
202006;352590;G;4711302;4;8;-4
202006;352590;G;4711302;18;13;5
202006;352590;G;4711302;2;6;-4
202006;352590;G;4711302;11;17;-6
202006;352590;G;4639701;0;6;-6
202006;352590;G;4711302;2;8;-6
202006;352590;G;4711302;2;4;-2
202006;352590;G;4711302;2;4;-2
202006;352590;G;4711302;4;8;-4
202006;352590;G;4711302;10;19;-9
202006;352590;G;4721102;1;2;-1
202006;352590;G;4511101;0;3;-3
202006;352590;G;4721102;0;1;-1
202006;352590;G;4731800;0;1;-1
202006;352590;G;4711302;4;4;0
202006;352590;G;4711302;5;5;0
202006;352590;G;4711302;3;1;2
202006;352590;G;4711302;3;3;0
202006;352590;G;4711302;4;1;3
202006;352590;G;4633801;3;3;0
202006;352590;G;4647801;0;1;-1
202006;352590;G;4661300;3;2;1
202006;352590;G;4639701;1;0;1
202006;352590;G;4771702;1;0;1
202006;352590;G;4744099;0;1;-1
202006;352590;G;4789008;0;1;-1
202006;352590;G;4771702;2;2;0
202006;352590;G;4755502;1;0;1
202006;352590;G;4530703;1;2;-1
202006;352590;G;4530701;0;1;-1
202006;352590;G;4721102;0;2;-2
202006;352590;G;4789004;0;1;-1
202006;352590;G;4669999;1;1;0
202006;352590;G;4771703;0;1;-1
202006;352590;G;4781400;0;1;-1
202006;352590;G;4781400;0;1;-1
202006;352590;G;4520001;2;0;2
202006;352590;G;4744005;0;1;-1
202006;352590;G;4511101;3;6;-3
202006;352590;G;4789007;0;1;-1
202006;352590;G;4723700;0;1;-1
202006;352590;G;4781400;0;3;-3
202006;352590;G;4649499;1;5;-4
202006;352590;G;4661300;4;2;2
202006;352590;G;4789099;0;1;-1
202006;352590;G;4530703;0;1;-1
202006;352590;G;4789005;1;0;1
202006;352590;G;4649403;1;0;1
202006;352590;G;4753900;0;2;-2
202006;352590;G;4753900;0;1;-1
202006;352590;G;4673700;0;1;-1
202006;352590;G;4530703;0;1;-1
202006;352590;G;4649408;0;1;-1
202006;352590;G;4789099;0;1;-1
202006;352590;G;4763601;0;3;-3
202006;352590;G;4530703;0;1;-1
202006;352590;G;4635402;3;4;-1
202006;352590;G;4721102;1;1;0
202006;352590;G;4633802;0;1;-1
202006;352590;G;4744005;0;1;-1
202006;352590;G;4511104;0;3;-3
202006;352590;G;4530703;0;2;-2
202006;352590;G;4646001;0;1;-1
202006;352590;G;4635402;5;2;3
202006;352590;G;4711302;8;7;1
202006;352590;G;4771701;0;1;-1
202006;352590;G;4771701;2;1;1
202006;352590;G;4771701;3;2;1
202006;352590;G;4771701;0;1;-1
202006;352590;G;4771701;0;1;-1
202006;352590;G;4771701;0;1;-1
202006;352590;G;4771701;0;1;-1
202006;352590;G;4771701;0;2;-2
202006;352590;G;4771701;1;0;1
202006;352590;G;4771701;0;2;-2
202006;352590;G;4771701;0;1;-1
202006;352590;G;4771701;0;1;-1
202006;352590;G;4771701;0;1;-1
202006;352590;G;4771701;0;1;-1
202006;352590;G;4771701;0;1;-1
202006;352590;G;4741500;0;1;-1
202006;352590;G;4637107;0;5;-5
202006;352590;G;4789002;2;2;0
202006;352590;G;4530701;1;1;0
202006;352590;G;4771701;1;0;1
202006;352590;G;4711302;13;25;-12
202006;352590;G;4771702;0;1;-1
202006;352590;G;4684201;0;1;-1
202006;352590;G;4789099;1;1;0
202006;352590;G;4771701;3;1;2
202006;352590;G;4771701;1;0;1
202006;352590;G;4744005;4;1;3
202006;352590;G;4711302;3;0;3
202006;352590;G;4729699;0;1;-1
202006;352590;G;4637199;0;4;-4
202006;352590;G;4744005;1;0;1
202006;352590;G;4623199;2;0;2
202006;352590;G;4645103;0;1;-1
202006;352590;G;4721102;1;0;1
202006;352590;G;4763601;0;1;-1
202006;352590;G;4771701;0;1;-1
202006;352590;G;4771702;2;1;1
202006;352590;G;4530703;1;0;1
202006;352590;G;4511101;3;2;1
202006;352590;G;4759899;1;2;-1
202006;352590;G;4754702;1;0;1
202006;352590;G;4741500;1;0;1
202006;352590;G;4789099;0;1;-1
202006;352590;G;4789099;1;1;0
202006;352590;G;4692300;1;2;-1
202006;352590;G;4635402;0;8;-8
202006;352590;G;4669901;0;1;-1
202006;352590;G;4789002;0;1;-1
202006;352590;G;4744001;1;0;1
202006;352590;G;4520001;0;2;-2
202006;352590;G;4711302;1;2;-1
202006;352590;G;4711301;5;9;-4
202006;352590;G;4530703;1;1;0
202006;352590;G;4711301;0;1;-1
202006;352590;G;4541201;0;7;-7
202006;352590;G;4781400;0;1;-1
202006;352590;G;4771702;1;0;1
202103;352590;G;4752100;0;1;-1
202103;352590;G;4744005;1;0;1
202103;352590;G;4772500;1;0;1
202103;352590;G;4789099;0;1;-1
202103;352590;G;4753900;3;6;-3
202103;352590;G;4712100;0;1;-1
202103;352590;G;4721102;2;1;1
202103;352590;G;4744002;1;0;1
202103;352590;G;4649406;5;0;5
202103;352590;G;4672900;1;1;0
202103;352590;G;4789099;1;0;1
202103;352590;G;4754701;1;0;1
202103;352590;G;4772500;0;1;-1
202103;352590;G;4633801;3;0;3
202103;352590;G;4763604;0;1;-1
202103;352590;G;4511102;0;1;-1
202103;352590;G;4771702;3;2;1
202103;352590;G;4530705;1;0;1
202103;352590;G;4732600;0;1;-1
202103;352590;G;4753900;0;1;-1
202103;352590;G;4530703;0;1;-1
202103;352590;G;4789099;1;0;1
202103;352590;G;4711301;2;14;-12
202103;352590;G;4511101;4;4;0
202103;352590;G;4644301;64;46;18
202103;352590;G;4771701;0;1;-1
202103;352590;G;4721102;0;2;-2
202103;352590;G;4689399;1;1;0
202103;352590;G;4652400;0;1;-1
202103;352590;G;4689301;0;1;-1
202103;352590;G;4530705;0;1;-1
202103;352590;G;4751201;1;5;-4
202103;352590;G;4649499;1;0;1
202103;352590;G;4789099;2;0;2
202103;352590;G;4741500;0;1;-1
202103;352590;G;4732600;0;1;-1
202103;352590;G;4687703;0;1;-1
202103;352590;G;4634601;15;3;12
202103;352590;G;4712100;2;2;0
202103;352590;G;4530701;1;0;1
202103;352590;G;4744005;1;0;1
202103;352590;G;4530701;2;2;0
202103;352590;G;4712100;1;0;1
202103;352590;G;4530702;3;0;3
202103;352590;G;4687701;1;0;1
202103;352590;G;4744005;2;1;1
202103;352590;G;4744005;0;1;-1
202103;352590;G;4781400;0;1;-1
202103;352590;G;4649403;2;0;2
202103;352590;G;4751201;1;1;0
202103;352590;G;4763602;0;1;-1
202103;352590;G;4789099;0;1;-1
202103;352590;G;4781400;0;1;-1
202103;352590;G;4511101;1;0;1
202103;352590;G;4754701;1;0;1
202103;352590;G;4619200;1;0;1
202103;352590;G;4789099;1;0;1
202103;352590;G;4511101;1;1;0
202103;352590;G;4789099;1;0;1
202103;352590;G;4729699;0;1;-1
202103;352590;G;4744005;0;1;-1
202103;352590;G;4530705;1;0;1
202103;352590;G;4781400;0;2;-2
202103;352590;G;4722901;0;1;-1
202103;352590;G;4789099;2;1;1
202103;352590;G;4755503;1;0;1
202103;352590;G;4741500;2;0;2
202103;352590;G;4789001;0;1;-1
202103;352590;G;4771702;1;2;-1
202103;352590;G;4771701;1;1;0
202103;352590;G;4752100;1;0;1
202103;352590;G;4689399;1;0;1
202103;352590;G;4646001;1;4;-3
202103;352590;G;4772500;0;1;-1
202103;352590;G;4744099;1;2;-1
202103;352590;G;4781400;2;0;2
202103;352590;G;4711302;1;1;0
202103;352590;G;4711302;3;3;0
202103;352590;G;4712100;0;2;-2
202103;352590;G;4755503;0;1;-1
202103;352590;G;4530703;1;0;1
202103;352590;G;4724500;1;0;1
202103;352590;G;4781400;1;0;1
202103;352590;G;4754701;1;0;1
202103;352590;G;4755502;1;0;1
202103;352590;G;4755502;0;1;-1
202103;352590;G;4744005;2;1;1
202103;352590;G;4721104;0;1;-1
202103;352590;G;4789005;1;0;1
202103;352590;G;4744005;2;1;1
202103;352590;G;4637106;6;6;0
202103;352590;G;4649499;0;3;-3
202103;352590;G;4771701;2;0;2
202103;352590;G;4781400;1;1;0
202103;352590;G;4672900;1;2;-1
202103;352590;G;4789099;1;1;0
202103;352590;G;4530703;1;0;1
202103;352590;G;4520001;0;1;-1
202103;352590;G;4781400;0;1;-1
202103;352590;G;4789002;2;1;1
202103;352590;G;4541202;2;0;2
202103;352590;G;4511101;3;0;3
202103;352590;G;4753900;0;2;-2
202103;352590;G;4731800;1;2;-1
202103;352590;G;4639701;12;10;2
202103;352590;G;4757100;0;1;-1
202103;352590;G;4751201;1;0;1
202103;352590;G;4789007;0;1;-1
202103;352590;G;4744005;0;1;-1
202103;352590;G;4511102;0;1;-1
202103;352590;G;4789002;0;1;-1
202103;352590;G;4789099;3;2;1
202103;352590;G;4520001;2;1;1
202103;352590;G;4789007;8;1;7
202103;352590;G;4753900;2;2;0
202103;352590;G;4757100;0;1;-1
202103;352590;G;4664800;0;1;-1
202103;352590;G;4724500;2;11;-9
202103;352590;G;4724500;1;2;-1
202103;352590;G;4511101;1;0;1
202103;352590;G;4689399;0;1;-1
202103;352590;G;4520002;0;2;-2
202103;352590;G;4729699;2;1;1
202103;352590;G;4530703;4;2;2
202103;352590;G;4731800;1;1;0
202103;352590;G;4511101;2;7;-5
202103;352590;G;4781400;0;1;-1
202103;352590;G;4520001;1;0;1
202103;352590;G;4687703;1;1;0
202103;352590;G;4722901;0;1;-1
202103;352590;G;4755502;1;0;1
202103;352590;G;4789008;1;0;1
202103;352590;G;4781400;0;2;-2
202103;352590;G;4744002;2;3;-1
202103;352590;G;4541203;1;1;0
202103;352590;G;4721102;1;1;0
202103;352590;G;4774100;0;1;-1
202103;352590;G;4669999;0;1;-1
202103;352590;G;4687702;2;1;1
202103;352590;G;4693100;1;0;1
202103;352590;G;4711302;11;8;3
202103;352590;G;4774100;0;2;-2
202103;352590;G;4753900;2;0;2
202103;352590;G;4789099;1;0;1
202103;352590;G;4781400;0;1;-1
202103;352590;G;4741500;1;0;1
202103;352590;G;4639701;1;1;0
202103;352590;G;4744099;1;0;1
202103;352590;G;4759899;0;5;-5
202103;352590;G;4759899;0;4;-4
202103;352590;G;4759899;0;4;-4
202103;352590;G;4649499;13;4;9
202103;352590;G;4761001;0;3;-3
202103;352590;G;4744099;1;0;1
202103;352590;G;4520001;0;1;-1
202103;352590;G;4712100;3;2;1
202103;352590;G;4789004;0;1;-1
202103;352590;G;4645101;0;1;-1
202103;352590;G;4711302;4;0;4
202103;352590;G;4711301;6;11;-5
202103;352590;G;4711302;0;2;-2
202103;352590;G;4511102;2;1;1
202103;352590;G;4751201;0;1;-1
202103;352590;G;4744001;0;1;-1
202103;352590;G;4753900;0;1;-1
202103;352590;G;4530703;1;0;1
202103;352590;G;4744005;1;0;1
202103;352590;G;4781400;0;1;-1
202103;352590;G;4759899;1;1;0
202103;352590;G;4530703;2;0;2
202103;352590;G;4781400;1;0;1
202103;352590;G;4712100;6;3;3
202103;352590;G;4789002;2;0;2
202103;352590;G;4789002;0;2;-2
202103;352590;G;4763602;0;1;-1
202103;352590;G;4781400;0;1;-1
202103;352590;G;4687702;1;0;1
202103;352590;G;4711302;23;11;12
202103;352590;G;4713002;0;1;-1
202103;352590;G;4763603;4;2;2
202103;352590;G;4731800;2;0;2
202103;352590;G;4663000;1;0;1
202103;352590;G;4530703;0;1;-1
202103;352590;G;4781400;9;2;7
202103;352590;G;4530703;1;0;1
202103;352590;G;4530703;1;0;1
202103;352590;G;4530703;0;1;-1
202103;352590;G;4774100;1;0;1
202103;352590;G;4633801;1;5;-4
202103;352590;G;4744099;1;0;1
202103;352590;G;4685100;0;1;-1
202103;352590;G;4731800;1;0;1
202103;352590;G;4619200;1;0;1
202103;352590;G;4771701;1;0;1
202103;352590;G;4652400;1;1;0
202103;352590;G;4744003;0;2;-2
202103;352590;G;4731800;2;2;0
202103;352590;G;4635402;6;5;1
202103;352590;G;4744002;1;0;1
202103;352590;G;4520001;1;0;1
202103;352590;G;4754703;4;2;2
202103;352590;G;4617600;0;1;-1
202103;352590;G;4721102;1;2;-1
202103;352590;G;4759899;0;1;-1
202103;352590;G;4774100;1;0;1
202103;352590;G;4520001;0;2;-2
202103;352590;G;4772500;2;1;1
202103;352590;G;4754702;0;1;-1
202103;352590;G;4781400;1;0;1
202103;352590;G;4742300;0;2;-2
202103;352590;G;4511101;1;1;0
202103;352590;G;4753900;1;2;-1
202103;352590;G;4753900;0;2;-2
202103;352590;G;4789099;3;1;2
202103;352590;G;4639701;0;1;-1
202103;352590;G;4721104;0;1;-1
202103;352590;G;4530703;0;1;-1
202103;352590;G;4781400;0;1;-1
202103;352590;G;4751201;2;0;2
202103;352590;G;4751201;0;1;-1
202103;352590;G;4744001;4;1;3
202103;352590;G;4686902;1;1;0
202103;352590;G;4771701;1;0;1
202103;352590;G;4755502;0;3;-3
202103;352590;G;4759899;1;0;1
202103;352590;G;4729699;2;1;1
202103;352590;G;4752100;0;1;-1
202103;352590;G;4731800;0;1;-1
202103;352590;G;4731800;2;2;0
202103;352590;G;4759899;1;0;1
202103;352590;G;4731800;1;0;1
202103;352590;G;4712100;0;1;-1
202103;352590;G;4530703;1;1;0
202103;352590;G;4744001;4;1;3
202103;352590;G;4744099;1;0;1
202103;352590;G;4789004;1;0;1
202103;352590;G;4729699;2;5;-3
202103;352590;G;4663000;2;0;2
202103;352590;G;4721104;1;0;1
202103;352590;G;4773300;2;0;2
202103;352590;G;4781400;0;1;-1
202103;352590;G;4754701;1;0;1
202103;352590;G;4782201;0;1;-1
202103;352590;G;4721102;0;1;-1
202103;352590;G;4530703;1;0;1
202103;352590;G;4729699;5;7;-2
202103;352590;G;4754703;0;1;-1
202103;352590;G;4789099;2;2;0
202103;352590;G;4686902;5;3;2
202103;352590;G;4530703;0;1;-1
202103;352590;G;4784900;0;1;-1
202103;352590;G;4511101;1;2;-1
202103;352590;G;4789099;0;2;-2
202103;352590;G;4754701;1;4;-3
202103;352590;G;4731800;1;0;1
202103;352590;G;4731800;2;2;0
202103;352590;G;4789005;6;2;4
202103;352590;G;4754701;1;1;0
202103;352590;G;4771701;2;0;2
202103;352590;G;4772500;0;2;-2
202103;352590;G;4722901;1;1;0
202103;352590;G;4789099;0;1;-1
202103;352590;G;4511102;0;1;-1
202103;352590;G;4530703;1;0;1
202103;352590;G;4511101;0;1;-1
202103;352590;G;4686902;5;3;2
202103;352590;G;4724500;5;10;-5
202103;352590;G;4633801;0;5;-5
202103;352590;G;4724500;9;9;0
202103;352590;G;4751201;0;1;-1
202103;352590;G;4772500;0;1;-1
202103;352590;G;4618499;1;0;1
202103;352590;G;4691500;6;6;0
202103;352590;G;4781400;0;1;-1
202103;352590;G;4721103;0;1;-1
202103;352590;G;4520006;0;1;-1
202103;352590;G;4731800;0;1;-1
202103;352590;G;4633801;0;1;-1
202103;352590;G;4647802;1;0;1
202103;352590;G;4511101;1;2;-1
202103;352590;G;4520004;1;1;0
202103;352590;G;4754701;10;4;6
202103;352590;G;4754701;1;0;1
202103;352590;G;4713002;0;1;-1
202103;352590;G;4772500;0;1;-1
202103;352590;G;4530703;1;0;1
202103;352590;G;4732600;1;0;1
202103;352590;G;4731800;1;2;-1
202103;352590;G;4771701;0;1;-1
202103;352590;G;4712100;3;2;1
202103;352590;G;4687703;1;0;1
202103;352590;G;4781400;0;1;-1
202103;352590;G;4530703;0;1;-1
202103;352590;G;4712100;0;1;-1
202103;352590;G;4669999;0;1;-1
202103;352590;G;4623109;6;3;3
202103;352590;G;4781400;0;8;-8
202103;352590;G;4511104;2;0;2
202103;352590;G;4789099;8;2;6
202103;352590;G;4789005;0;1;-1
202103;352590;G;4761003;3;1;2
202103;352590;G;4781400;0;1;-1
202103;352590;G;4781400;0;2;-2
202103;352590;G;4744002;2;0;2
202103;352590;G;4781400;1;0;1
202103;352590;G;4773300;0;1;-1
202103;352590;G;4781400;1;0;1
202103;352590;G;4731800;1;0;1
202103;352590;G;4649499;2;1;1
202103;352590;G;4520007;4;2;2
202103;352590;G;4789002;4;0;4
202103;352590;G;4782201;1;0;1
202103;352590;G;4781400;1;3;-2
202103;352590;G;4520001;0;13;-13
202103;352590;G;4731800;1;0;1
202103;352590;G;4722901;1;0;1
202103;352590;G;4771701;0;1;-1
202103;352590;G;4530703;0;1;-1
202103;352590;G;4713002;0;1;-1
202103;352590;G;4781400;1;3;-2
202103;352590;G;4781400;0;1;-1
202103;352590;G;4781400;1;0;1
202103;352590;G;4744099;2;2;0
202103;352590;G;4759899;1;0;1
202103;352590;G;4744001;2;0;2
202103;352590;G;4619200;1;1;0
202103;352590;G;4743100;3;2;1
202103;352590;G;4761002;1;0;1
202103;352590;G;4772500;0;1;-1
202103;352590;G;4530701;2;1;1
202103;352590;G;4691500;18;16;2
202103;352590;G;4637199;3;0;3
202103;352590;G;4763601;0;1;-1
202103;352590;G;4619200;1;0;1
202103;352590;G;4774100;0;1;-1
202103;352590;G;4712100;1;1;0
202103;352590;G;4689399;2;1;1
202103;352590;G;4669999;5;3;2
202103;352590;G;4732600;0;1;-1
202103;352590;G;4632003;1;0;1
202103;352590;G;4781400;0;1;-1
202103;352590;G;4686902;0;2;-2
202103;352590;G;4530703;1;1;0
202103;352590;G;4784900;0;1;-1
202103;352590;G;4763603;0;1;-1
202103;352590;G;4789099;0;3;-3
202103;352590;G;4530704;2;7;-5
202103;352590;G;4753900;2;1;1
202103;352590;G;4530705;1;1;0
202103;352590;G;4771701;2;1;1
202103;352590;G;4744001;0;1;-1
202103;352590;G;4754701;4;4;0
202103;352590;G;4781400;0;2;-2
202103;352590;G;4520007;1;0;1
202103;352590;G;4744099;1;2;-1
202103;352590;G;4781400;0;1;-1
202103;352590;G;4530703;4;1;3
202103;352590;G;4761001;0;1;-1
202103;352590;G;4789004;1;0;1
202103;352590;G;4623109;2;1;1
202103;352590;G;4729699;0;1;-1
202103;352590;G;4713002;0;1;-1
202103;352590;G;4781400;0;1;-1
202103;352590;G;4741500;0;2;-2
202103;352590;G;4744099;0;1;-1
202103;352590;G;4721104;18;6;12
202103;352590;G;4637107;7;1;6
202103;352590;G;4754701;2;0;2
202103;352590;G;4754701;1;0;1
202103;352590;G;4693100;1;0;1
202103;352590;G;4757100;0;2;-2
202103;352590;G;4782201;0;5;-5
202103;352590;G;4520002;1;0;1
202103;352590;G;4781400;0;1;-1
202103;352590;G;4520002;0;1;-1
202103;352590;G;4782201;0;7;-7
202103;352590;G;4781400;1;1;0
202103;352590;G;4782201;0;1;-1
202103;352590;G;4755502;2;2;0
202103;352590;G;4712100;0;2;-2
202103;352590;G;4721102;0;1;-1
202103;352590;G;4781400;0;1;-1
202103;352590;G;4774100;2;1;1
202103;352590;G;4781400;0;1;-1
202103;352590;G;4742300;1;0;1
202103;352590;G;4711302;0;1;-1
202103;352590;G;4751201;3;2;1
202103;352590;G;4789001;1;0;1
202103;352590;G;4520005;9;14;-5
202103;352590;G;4781400;0;1;-1
202103;352590;G;4721104;1;1;0
202103;352590;G;4663000;4;5;-1
202103;352590;G;4541201;0;1;-1
202103;352590;G;4752100;0;1;-1
202103;352590;G;4782201;2;0;2
202103;352590;G;4741500;0;1;-1
202103;352590;G;4771702;1;4;-3
202103;352590;G;4789099;1;1;0
202103;352590;G;4752100;1;1;0
202103;352590;G;4753900;1;0;1
202103;352590;G;4789002;2;0;2
202103;352590;G;4634601;0;1;-1
202103;352590;G;4789004;1;0;1
202103;352590;G;4530703;1;0;1
202103;352590;G;4781400;0;1;-1
202103;352590;G;4713002;1;2;-1
202103;352590;G;4732600;2;0;2
202103;352590;G;4642701;0;1;-1
202103;352590;G;4751201;1;1;0
202103;352590;G;4789004;1;0;1
202103;352590;G;4783101;0;2;-2
202103;352590;G;4781400;0;1;-1
202103;352590;G;4724500;1;1;0
202103;352590;G;4789099;1;0;1
202103;352590;G;4520001;1;1;0
202103;352590;G;4712100;1;1;0
202103;352590;G;4753900;0;1;-1
202103;352590;G;4789001;0;1;-1
202103;352590;G;4774100;0;1;-1
202103;352590;G;4744099;1;0;1
202103;352590;G;4761001;0;2;-2
202103;352590;G;4722901;0;1;-1
202103;352590;G;4520002;0;1;-1
202103;352590;G;4652400;5;1;4
202103;352590;G;4752100;0;1;-1
202103;352590;G;4744002;1;0;1
202103;352590;G;4713002;0;2;-2
202103;352590;G;4520001;1;0;1
202103;352590;G;4721102;1;1;0
202103;352590;G;4721102;1;0;1
202103;352590;G;4774100;0;1;-1
202103;352590;G;4721102;2;1;1
202103;352590;G;4783101;1;0;1
202103;352590;G;4781400;1;0;1
202103;352590;G;4781400;0;1;-1
202103;352590;G;4789002;0;1;-1
202103;352590;G;4754701;5;0;5
202103;352590;G;4781400;0;2;-2
202103;352590;G;4520001;1;0;1
202103;352590;G;4752100;0;1;-1
202103;352590;G;4781400;1;0;1
202103;352590;G;4781400;1;1;0
202103;352590;G;4731800;3;2;1
202103;352590;G;4669999;11;5;6
202103;352590;G;4672900;0;1;-1
202103;352590;G;4754701;0;1;-1
202103;352590;G;4712100;2;0;2
202103;352590;G;4771701;0;1;-1
202103;352590;G;4789001;1;0;1
202103;352590;G;4712100;0;1;-1
202103;352590;G;4530703;1;0;1
202103;352590;G;4645101;22;7;15
202103;352590;G;4771701;0;1;-1
202103;352590;G;4741500;0;1;-1
202103;352590;G;4772500;1;0;1
202103;352590;G;4789001;0;1;-1
202103;352590;G;4721102;1;0;1
202103;352590;G;4721102;0;4;-4
202103;352590;G;4789099;0;1;-1
202103;352590;G;4744005;1;0;1
202103;352590;G;4618499;1;0;1
202103;352590;G;4731800;1;1;0
202103;352590;G;4713004;2;7;-5
202103;352590;G;4520001;1;0;1
202103;352590;G;4774100;2;0;2
202103;352590;G;4752100;1;0;1
202103;352590;G;4759899;1;0;1
202103;352590;G;4511102;0;1;-1
202103;352590;G;4731800;2;1;1
202103;352590;G;4649499;0;1;-1
202103;352590;G;4713002;0;1;-1
202103;352590;G;4729699;2;6;-4
202103;352590;G;4789099;1;0;1
202103;352590;G;4781400;0;1;-1
202103;352590;G;4679699;0;1;-1
202103;352590;G;4633801;0;1;-1
202103;352590;G;4646001;0;1;-1
202103;352590;G;4712100;0;1;-1
202103;352590;G;4754701;1;0;1
202103;352590;G;4781400;0;1;-1
202103;352590;G;4781400;1;2;-1
202103;352590;G;4783101;1;1;0
202103;352590;G;4729602;1;0;1
202103;352590;G;4530703;2;0;2
202103;352590;G;4530703;0;1;-1
202103;352590;G;4679603;3;1;2
202103;352590;G;4633801;5;1;4
202103;352590;G;4530703;3;1;2
202103;352590;G;4711302;2;1;1
202103;352590;G;4751201;1;0;1
202103;352590;G;4639701;1;10;-9
202103;352590;G;4520007;1;1;0
202103;352590;G;4520004;0;1;-1
202103;352590;G;4712100;0;1;-1
202103;352590;G;4753900;3;14;-11
202103;352590;G;4754701;0;1;-1
202103;352590;G;4781400;0;1;-1
202103;352590;G;4781400;0;1;-1
202103;352590;G;4774100;1;0;1
202103;352590;G;4759899;0;1;-1
202103;352590;G;4731800;1;0;1
202103;352590;G;4781400;0;1;-1
202103;352590;G;4789099;1;1;0
202103;352590;G;4646001;0;3;-3
202103;352590;G;4781400;0;2;-2
202103;352590;G;4637199;5;0;5
202103;352590;G;4782201;1;0;1
202103;352590;G;4530705;0;1;-1
202103;352590;G;4761003;1;0;1
202103;352590;G;4722901;0;1;-1
202103;352590;G;4754702;1;0;1
202103;352590;G;4744099;1;0;1
202103;352590;G;4781400;0;1;-1
202103;352590;G;4781400;1;1;0
202103;352590;G;4755502;1;0;1
202103;352590;G;4789099;0;1;-1
202103;352590;G;4722901;2;0;2
202103;352590;G;4781400;0;1;-1
202103;352590;G;4789099;0;1;-1
202103;352590;G;4646001;1;0;1
202103;352590;G;4724500;1;1;0
202103;352590;G;4755502;1;1;0
202103;352590;G;4789004;1;0;1
202103;352590;G;4729699;0;1;-1
202103;352590;G;4774100;0;1;-1
202103;352590;G;4774100;1;1;0
202103;352590;G;4721102;1;0;1
202103;352590;G;4759899;1;1;0
202103;352590;G;4729602;1;0;1
202103;352590;G;4729602;2;1;1
202103;352590;G;4724500;1;0;1
202103;352590;G;4772500;1;0;1
202103;352590;G;4781400;0;1;-1
202103;352590;G;4789005;0;1;-1
202103;352590;G;4520006;0;2;-2
202103;352590;G;4721102;1;1;0
202103;352590;G;4722901;0;1;-1
202103;352590;G;4686902;0;1;-1
202103;352590;G;4772500;1;0;1
202103;352590;G;4789001;2;0;2
202103;352590;G;4771701;0;2;-2
202103;352590;G;4771701;1;0;1
202103;352590;G;4781400;0;1;-1
202103;352590;G;4789099;1;0;1
202103;352590;G;4789004;1;1;0
202103;352590;G;4721102;0;1;-1
202103;352590;G;4722901;1;0;1
202103;352590;G;4687702;4;0;4
202103;352590;G;4687702;0;2;-2
202103;352590;G;4772500;0;1;-1
202103;352590;G;4693100;0;11;-11
202103;352590;G;4772500;1;0;1
202103;352590;G;4520003;5;0;5
202103;352590;G;4711302;2;1;1
202103;352590;G;4721102;0;1;-1
202103;352590;G;4763601;0;1;-1
202103;352590;G;4633801;4;0;4
202103;352590;G;4729602;0;1;-1
202103;352590;G;4649410;0;1;-1
202103;352590;G;4789004;0;2;-2
202103;352590;G;4722901;0;1;-1
202103;352590;G;4721102;1;0;1
202103;352590;G;4789005;0;1;-1
202103;352590;G;4541206;0;1;-1
202103;352590;G;4789099;1;0;1
202103;352590;G;4783102;0;1;-1
202103;352590;G;4729602;1;0;1
202103;352590;G;4763601;0;1;-1
202103;352590;G;4789099;1;1;0
202103;352590;G;4752100;0;1;-1
202103;352590;G;4729699;0;1;-1
202103;352590;G;4679699;1;0;1
202103;352590;G;4712100;1;1;0
202103;352590;G;4712100;0;1;-1
202103;352590;G;4789099;0;2;-2
202103;352590;G;4772500;1;3;-2
202103;352590;G;4771701;1;1;0
202103;352590;G;4712100;0;1;-1
202103;352590;G;4781400;1;1;0
202103;352590;G;4781400;0;1;-1
202103;352590;G;4781400;1;0;1
202103;352590;G;4729699;0;3;-3
202103;352590;G;4773300;1;0;1
202103;352590;G;4744099;5;0;5
202103;352590;G;4723700;1;1;0
202103;352590;G;4781400;0;1;-1
202103;352590;G;4712100;1;0;1
202103;352590;G;4711301;10;5;5
202103;352590;G;4781400;1;1;0
202103;352590;G;4679603;0;3;-3
202103;352590;G;4783101;0;2;-2
202103;352590;G;4789004;1;0;1
202103;352590;G;4711302;1;0;1
202103;352590;G;4731800;1;2;-1
202103;352590;G;4732600;1;0;1
202103;352590;G;4781400;0;6;-6
202103;352590;G;4781400;1;0;1
202103;352590;G;4782201;0;1;-1
202103;352590;G;4729699;0;1;-1
202103;352590;G;4789001;1;0;1
202103;352590;G;4639701;1;14;-13
202103;352590;G;4520001;0;1;-1
202103;352590;G;4752100;2;4;-2
202103;352590;G;4637199;8;2;6
202103;352590;G;4744005;0;2;-2
202103;352590;G;4729699;0;1;-1
202103;352590;G;4722902;1;0;1
202103;352590;G;4724500;1;0;1
202103;352590;G;4520003;1;0;1
202103;352590;G;4713002;0;1;-1
202103;352590;G;4789002;13;3;10
202103;352590;G;4781400;0;2;-2
202103;352590;G;4781400;0;1;-1
202103;352590;G;4741500;1;0;1
202103;352590;G;4742300;2;0;2
202103;352590;G;4763602;1;0;1
202103;352590;G;4781400;3;0;3
202103;352590;G;4712100;1;0;1
202103;352590;G;4742300;0;1;-1
202103;352590;G;4782201;0;1;-1
202103;352590;G;4711302;1;0;1
202103;352590;G;4755503;1;0;1
202103;352590;G;4520006;3;1;2
202103;352590;G;4789001;1;0;1
202103;352590;G;4789001;0;2;-2
202103;352590;G;4711302;0;2;-2
202103;352590;G;4753900;0;4;-4
202103;352590;G;4753900;39;49;-10
202103;352590;G;4753900;1;5;-4
202103;352590;G;4753900;1;3;-2
202103;352590;G;4753900;0;2;-2
202103;352590;G;4753900;50;24;26
202103;352590;G;4753900;1;0;1
202103;352590;G;4753900;1;0;1
202103;352590;G;4712100;0;1;-1
202103;352590;G;4712100;0;6;-6
202103;352590;G;4781400;1;0;1
202103;352590;G;4781400;0;6;-6
202103;352590;G;4781400;1;8;-7
202103;352590;G;4781400;0;1;-1
202103;352590;G;4520005;0;1;-1
202103;352590;G;4773300;1;0;1
202103;352590;G;4742300;1;1;0
202103;352590;G;4729699;1;0;1
202103;352590;G;4723700;1;0;1
202103;352590;G;4721104;0;1;-1
202103;352590;G;4721104;0;1;-1
202103;352590;G;4752100;0;1;-1
202103;352590;G;4784900;0;1;-1
202103;352590;G;4741500;1;0;1
202103;352590;G;4763602;0;2;-2
202103;352590;G;4785799;0;2;-2
202103;352590;G;4781400;0;2;-2
202103;352590;G;4781400;0;2;-2
202103;352590;G;4789004;2;0;2
202103;352590;G;4721102;1;3;-2
202103;352590;G;4772500;0;1;-1
202103;352590;G;4669999;13;5;8
202103;352590;G;4729602;0;1;-1
202103;352590;G;4772500;0;1;-1
202103;352590;G;4782201;0;1;-1
202103;352590;G;4771701;1;0;1
202103;352590;G;4520002;1;0;1
202103;352590;G;4771701;2;0;2
202103;352590;G;4774100;0;1;-1
202103;352590;G;4782201;2;0;2
202103;352590;G;4774100;0;1;-1
202103;352590;G;4781400;1;0;1
202103;352590;G;4721102;1;0;1
202103;352590;G;4781400;0;1;-1
202103;352590;G;4731800;1;0;1
202103;352590;G;4781400;1;1;0
202103;352590;G;4781400;0;2;-2
202103;352590;G;4520002;0;1;-1
202103;352590;G;4744099;1;0;1
202103;352590;G;4754701;1;0;1
202103;352590;G;4712100;1;0;1
202103;352590;G;4721104;2;0;2
202103;352590;G;4729699;2;0;2
202103;352590;G;4781400;0;1;-1
202103;352590;G;4774100;3;0;3
202103;352590;G;4781400;1;0;1
202103;352590;G;4723700;1;0;1
202103;352590;G;4520001;1;0;1
202103;352590;G;4721104;0;1;-1
202103;352590;G;4530703;3;0;3
202103;352590;G;4771701;0;1;-1
202103;352590;G;4754701;2;0;2
202103;352590;G;4771701;1;0;1
202103;352590;G;4781400;1;1;0
202103;352590;G;4744001;2;1;1
202103;352590;G;4781400;1;0;1
202103;352590;G;4781400;2;0;2
202103;352590;G;4773300;0;1;-1
202103;352590;G;4729602;1;0;1
202103;352590;G;4781400;3;0;3
202103;352590;G;4759899;12;3;9
202103;352590;G;4781400;2;0;2
202103;352590;G;4713002;1;0;1
202103;352590;G;4781400;0;1;-1
202103;352590;G;4772500;1;0;1
202103;352590;G;4686902;1;1;0
202103;352590;G;4530703;2;2;0
202103;352590;G;4782201;1;1;0
202103;352590;G;4530703;1;0;1
202103;352590;G;4713001;0;2;-2
202103;352590;G;4759899;1;0;1
202103;352590;G;4729699;0;1;-1
202103;352590;G;4744005;2;1;1
202103;352590;G;4781400;0;1;-1
202103;352590;G;4771701;1;0;1
202103;352590;G;4635499;2;0;2
202103;352590;G;4729699;5;0;5
202103;352590;G;4789003;1;0;1
202103;352590;G;4633801;1;0;1
202103;352590;G;4743100;1;0;1
202103;352590;G;4669999;4;1;3
202103;352590;G;4729699;0;1;-1
202103;352590;G;4772500;4;0;4
202103;352590;G;4774100;1;0;1
202103;352590;G;4774100;2;0;2
202103;352590;G;4753900;0;1;-1
202103;352590;G;4753900;0;1;-1
202103;352590;G;4772500;0;1;-1
202103;352590;G;4789099;0;1;-1
202103;352590;G;4744005;1;1;0
202103;352590;G;4789099;1;0;1
202103;352590;G;4755502;1;0;1
202103;352590;G;4781400;2;6;-4
202103;352590;G;4781400;2;1;1
202103;352590;G;4782201;1;3;-2
202103;352590;G;4782201;1;5;-4
202103;352590;G;4782201;1;2;-1
202103;352590;G;4782201;1;3;-2
202103;352590;G;4782201;4;12;-8
202103;352590;G;4782201;1;0;1
202103;352590;G;4711301;4;10;-6
202103;352590;G;4731800;4;4;0
202103;352590;G;4771701;3;1;2
202103;352590;G;4672900;1;0;1
202103;352590;G;4713002;0;1;-1
202103;352590;G;4530705;1;2;-1
202103;352590;G;4781400;2;1;1
202103;352590;G;4646001;1;0;1
202103;352590;G;4744002;2;3;-1
202103;352590;G;4639701;4;6;-2
202103;352590;G;4754701;2;1;1
202103;352590;G;4781400;2;1;1
202103;352590;G;4711302;2;1;1
202103;352590;G;4711302;4;2;2
202103;352590;G;4789002;0;1;-1
202103;352590;G;4637107;2;3;-1
202103;352590;G;4711302;1;0;1
202103;352590;G;4713004;2;4;-2
202103;352590;G;4713004;1;0;1
202103;352590;G;4712100;1;0;1
202103;352590;G;4731800;1;0;1
202103;352590;G;4731800;1;0;1
202103;352590;G;4712100;0;1;-1
202103;352590;G;4784900;0;1;-1
202103;352590;G;4731800;1;0;1
202103;352590;G;4781400;1;1;0
202103;352590;G;4741500;0;1;-1
202103;352590;G;4772500;1;0;1
202103;352590;G;4511102;0;1;-1
202103;352590;G;4530703;2;1;1
202103;352590;G;4755503;0;1;-1
202103;352590;G;4744005;1;1;0
202103;352590;G;4731800;2;0;2
202103;352590;G;4783101;1;0;1
202103;352590;G;4744099;3;1;2
202103;352590;G;4763602;1;2;-1
202103;352590;G;4731800;1;1;0
202103;352590;G;4511101;1;3;-2
202103;352590;G;4689399;0;2;-2
202103;352590;G;4783101;0;1;-1
202103;352590;G;4729699;1;0;1
202103;352590;G;4511104;2;1;1
202103;352590;G;4530703;2;1;1
202103;352590;G;4530705;1;1;0
202103;352590;G;4530703;0;1;-1
202103;352590;G;4541203;1;0;1
202103;352590;G;4731800;1;1;0
202103;352590;G;4711302;1;4;-3
202103;352590;G;4711302;0;13;-13
202103;352590;G;4711302;0;3;-3
202103;352590;G;4711302;2;6;-4
202103;352590;G;4711302;4;13;-9
202103;352590;G;4711302;0;1;-1
202103;352590;G;4711302;9;17;-8
202103;352590;G;4711302;0;1;-1
202103;352590;G;4711302;2;10;-8
202103;352590;G;4639701;60;1;59
202103;352590;G;4711302;3;6;-3
202103;352590;G;4711302;2;1;1
202103;352590;G;4711302;2;1;1
202103;352590;G;4711302;3;1;2
202103;352590;G;4711302;1;9;-8
202103;352590;G;4511101;3;2;1
202103;352590;G;4721102;0;1;-1
202103;352590;G;4771701;0;1;-1
202103;352590;G;4744099;1;1;0
202103;352590;G;4711302;12;5;7
202103;352590;G;4711302;6;5;1
202103;352590;G;4711302;4;4;0
202103;352590;G;4711302;5;2;3
202103;352590;G;4711302;2;2;0
202103;352590;G;4731800;1;0;1
202103;352590;G;4633801;5;4;1
202103;352590;G;4687703;4;0;4
202103;352590;G;4541203;0;1;-1
202103;352590;G;4744099;2;1;1
202103;352590;G;4647801;0;1;-1
202103;352590;G;4661300;9;9;0
202103;352590;G;4639701;0;2;-2
202103;352590;G;4744099;1;1;0
202103;352590;G;4782201;0;1;-1
202103;352590;G;4771702;7;4;3
202103;352590;G;4755502;0;1;-1
202103;352590;G;4530703;1;1;0
202103;352590;G;4721102;1;1;0
202103;352590;G;4789004;1;0;1
202103;352590;G;4669999;7;6;1
202103;352590;G;4722901;0;1;-1
202103;352590;G;4731800;1;0;1
202103;352590;G;4663000;1;0;1
202103;352590;G;4761003;0;1;-1
202103;352590;G;4520006;2;0;2
202103;352590;G;4781400;0;1;-1
202103;352590;G;4781400;0;1;-1
202103;352590;G;4732600;1;0;1
202103;352590;G;4530705;0;1;-1
202103;352590;G;4712100;1;1;0
202103;352590;G;4712100;3;1;2
202103;352590;G;4712100;1;1;0
202103;352590;G;4530703;0;1;-1
202103;352590;G;4511101;2;1;1
202103;352590;G;4530703;0;1;-1
202103;352590;G;4789002;0;1;-1
202103;352590;G;4774100;1;0;1
202103;352590;G;4771702;1;0;1
202103;352590;G;4712100;0;1;-1
202103;352590;G;4649499;1;1;0
202103;352590;G;4661300;5;0;5
202103;352590;G;4721102;0;1;-1
202103;352590;G;4781400;0;2;-2
202103;352590;G;4761003;0;1;-1
202103;352590;G;4753900;0;1;-1
202103;352590;G;4761003;1;2;-1
202103;352590;G;4731800;1;0;1
202103;352590;G;4789001;1;0;1
202103;352590;G;4774100;0;1;-1
202103;352590;G;4763602;0;2;-2
202103;352590;G;4530703;0;1;-1
202103;352590;G;4712100;1;0;1
202103;352590;G;4761003;1;2;-1
202103;352590;G;4789099;1;1;0
202103;352590;G;4635402;12;15;-3
202103;352590;G;4520001;2;1;1
202103;352590;G;4721102;0;1;-1
202103;352590;G;4741500;3;0;3
202103;352590;G;4731800;1;0;1
202103;352590;G;4530703;0;1;-1
202103;352590;G;4744005;0;1;-1
202103;352590;G;4672900;1;0;1
202103;352590;G;4743100;0;1;-1
202103;352590;G;4530701;0;3;-3
202103;352590;G;4771701;0;1;-1
202103;352590;G;4530703;2;2;0
202103;352590;G;4744005;3;0;3
202103;352590;G;4511104;0;2;-2
202103;352590;G;4633802;1;0;1
202103;352590;G;4530703;0;1;-1
202103;352590;G;4713004;0;1;-1
202103;352590;G;4713004;0;3;-3
202103;352590;G;4646001;1;1;0
202103;352590;G;4646001;1;0;1
202103;352590;G;4635402;8;4;4
202103;352590;G;4647801;2;2;0
202103;352590;G;4711302;8;3;5
202103;352590;G;4771701;1;1;0
202103;352590;G;4771701;0;1;-1
202103;352590;G;4771701;1;1;0
202103;352590;G;4645101;1;0;1
202103;352590;G;4771701;1;0;1
202103;352590;G;4771701;1;1;0
202103;352590;G;4771701;1;1;0
202103;352590;G;4771701;0;1;-1
202103;352590;G;4771701;0;1;-1
202103;352590;G;4771701;1;0;1
202103;352590;G;4771701;2;0;2
202103;352590;G;4771701;0;2;-2
202103;352590;G;4771701;0;3;-3
202103;352590;G;4771701;2;2;0
202103;352590;G;4771701;1;2;-1
202103;352590;G;4771701;0;2;-2
202103;352590;G;4771701;2;0;2
202103;352590;G;4771701;0;1;-1
202103;352590;G;4771701;1;0;1
202103;352590;G;4782202;2;2;0
202103;352590;G;4741500;0;1;-1
202103;352590;G;4759899;0;3;-3
202103;352590;G;4637107;2;1;1
202103;352590;G;4789002;7;1;6
202103;352590;G;4744099;1;0;1
202103;352590;G;4530701;2;1;1
202103;352590;G;4755503;0;1;-1
202103;352590;G;4771701;1;0;1
202103;352590;G;4731800;0;1;-1
202103;352590;G;4712100;0;1;-1
202103;352590;G;4789099;1;0;1
202103;352590;G;4731800;0;4;-4
202103;352590;G;4731800;0;1;-1
202103;352590;G;4782201;1;1;0
202103;352590;G;4663000;1;0;1
202103;352590;G;4530701;0;1;-1
202103;352590;G;4789099;0;1;-1
202103;352590;G;4721102;1;0;1
202103;352590;G;4530703;1;0;1
202103;352590;G;4755502;0;1;-1
202103;352590;G;4711302;38;25;13
202103;352590;G;4783101;0;3;-3
202103;352590;G;4530703;1;0;1
202103;352590;G;4771702;0;1;-1
202103;352590;G;4684201;2;1;1
202103;352590;G;4789099;1;1;0
202103;352590;G;4771701;2;1;1
202103;352590;G;4771701;1;1;0
202103;352590;G;4744005;0;1;-1
202103;352590;G;4711302;1;0;1
202103;352590;G;4729699;0;2;-2
202103;352590;G;4520001;0;1;-1
202103;352590;G;4789099;1;0;1
202103;352590;G;4744005;3;0;3
202103;352590;G;4623199;6;0;6
202103;352590;G;4789001;0;1;-1
202103;352590;G;4520007;0;1;-1
202103;352590;G;4520001;0;1;-1
202103;352590;G;4530703;0;1;-1
202103;352590;G;4755501;1;0;1
202103;352590;G;4712100;0;1;-1
202103;352590;G;4751201;2;0;2
202103;352590;G;4637199;3;0;3
202103;352590;G;4712100;1;1;0
202103;352590;G;4712100;0;1;-1
202103;352590;G;4771702;5;1;4
202103;352590;G;4771701;1;1;0
202103;352590;G;4744005;0;1;-1
202103;352590;G;4744005;1;0;1
202103;352590;G;4741500;2;1;1
202103;352590;G;4741500;1;0;1
202103;352590;G;4741500;2;0;2
202103;352590;G;4741500;1;0;1
202103;352590;G;4741500;1;0;1
202103;352590;G;4781400;0;1;-1
202103;352590;G;4761003;1;0;1
202103;352590;G;4744002;0;1;-1
202103;352590;G;4663000;1;0;1
202103;352590;G;4789099;0;1;-1
202103;352590;G;4692300;2;2;0
202103;352590;G;4520005;0;8;-8
202103;352590;G;4635402;5;2;3
202103;352590;G;4744099;2;2;0
202103;352590;G;4711302;2;0;2
202103;352590;G;4771701;0;1;-1
202103;352590;G;4754703;1;1;0
202103;352590;G;4711301;4;7;-3
202103;352590;G;4672900;5;2;3
202103;352590;G;4781400;0;1;-1
202103;352590;G;4530703;0;2;-2
202103;352590;G;4711301;2;3;-1
202103;352590;G;4679604;0;2;-2
202103;352590;G;4541201;0;1;-1
202103;352590;G;4783101;0;1;-1
202103;352590;G;4783101;2;0;2
202103;352590;G;4781400;3;2;1
202103;352590;G;4781400;1;2;-1
202103;352590;G;4642702;1;0;1
202012;352590;G;4751201;2;1;1
202012;352590;G;4752100;2;2;0
202012;352590;G;4772500;1;0;1
202012;352590;G;4712100;1;0;1
202012;352590;G;4744005;1;0;1
202012;352590;G;4744005;0;1;-1
202012;352590;G;4789099;0;1;-1
202012;352590;G;4789099;0;2;-2
202012;352590;G;4732600;0;1;-1
202012;352590;G;4753900;0;2;-2
202012;352590;G;4753900;1;0;1
202012;352590;G;4721102;0;1;-1
202012;352590;G;4672900;3;1;2
202012;352590;G;4781400;0;1;-1
202012;352590;G;4789007;0;1;-1
202012;352590;G;4530703;0;1;-1
202012;352590;G;4772500;1;2;-1
202012;352590;G;4721104;0;1;-1
202012;352590;G;4633801;1;1;0
202012;352590;G;4771702;2;0;2
202012;352590;G;4530705;1;0;1
202012;352590;G;4789099;2;0;2
202012;352590;G;4729699;0;1;-1
202012;352590;G;4755502;0;1;-1
202012;352590;G;4732600;0;1;-1
202012;352590;G;4789099;0;1;-1
202012;352590;G;4693100;7;12;-5
202012;352590;G;4511101;1;1;0
202012;352590;G;4646001;1;0;1
202012;352590;G;4742300;0;1;-1
202012;352590;G;4644301;28;22;6
202012;352590;G;4771701;1;2;-1
202012;352590;G;4721102;1;0;1
202012;352590;G;4652400;0;1;-1
202012;352590;G;4781400;0;1;-1
202012;352590;G;4751201;0;1;-1
202012;352590;G;4744001;1;0;1
202012;352590;G;4639701;1;0;1
202012;352590;G;4721104;0;1;-1
202012;352590;G;4634601;6;19;-13
202012;352590;G;4712100;1;0;1
202012;352590;G;4752100;1;1;0
202012;352590;G;4712100;1;0;1
202012;352590;G;4751201;2;0;2
202012;352590;G;4763603;0;1;-1
202012;352590;G;4530701;3;1;2
202012;352590;G;4530702;2;1;1
202012;352590;G;4687703;1;0;1
202012;352590;G;4759899;2;2;0
202012;352590;G;4744005;1;1;0
202012;352590;G;4639701;5;10;-5
202012;352590;G;4731800;0;1;-1
202012;352590;G;4754701;1;1;0
202012;352590;G;4781400;3;0;3
202012;352590;G;4511101;5;3;2
202012;352590;G;4731800;1;0;1
202012;352590;G;4784900;1;0;1
202012;352590;G;4530703;0;2;-2
202012;352590;G;4731800;1;1;0
202012;352590;G;4712100;0;1;-1
202012;352590;G;4511101;2;1;1
202012;352590;G;4511102;1;0;1
202012;352590;G;4722901;0;1;-1
202012;352590;G;4721104;1;0;1
202012;352590;G;4744005;1;0;1
202012;352590;G;4520001;0;2;-2
202012;352590;G;4781400;1;1;0
202012;352590;G;4722901;0;1;-1
202012;352590;G;4754701;0;1;-1
202012;352590;G;4789099;0;1;-1
202012;352590;G;4754702;0;1;-1
202012;352590;G;4713001;2;0;2
202012;352590;G;4679601;1;0;1
202012;352590;G;4789001;0;2;-2
202012;352590;G;4789001;2;0;2
202012;352590;G;4771702;2;0;2
202012;352590;G;4752100;2;0;2
202012;352590;G;4752100;1;1;0
202012;352590;G;4689399;0;1;-1
202012;352590;G;4639701;1;1;0
202012;352590;G;4744002;0;1;-1
202012;352590;G;4783101;2;0;2
202012;352590;G;4646001;1;2;-1
202012;352590;G;4789004;1;0;1
202012;352590;G;4772500;4;4;0
202012;352590;G;4759899;1;0;1
202012;352590;G;4731800;0;1;-1
202012;352590;G;4744099;1;3;-2
202012;352590;G;4781400;6;0;6
202012;352590;G;4753900;0;1;-1
202012;352590;G;4711302;1;0;1
202012;352590;G;4711302;1;0;1
202012;352590;G;4754701;1;0;1
202012;352590;G;4755503;0;1;-1
202012;352590;G;4751201;0;1;-1
202012;352590;G;4781400;0;2;-2
202012;352590;G;4686902;0;2;-2
202012;352590;G;4633801;0;1;-1
202012;352590;G;4781400;1;0;1
202012;352590;G;4744005;5;2;3
202012;352590;G;4721104;1;0;1
202012;352590;G;4789099;2;0;2
202012;352590;G;4731800;0;1;-1
202012;352590;G;4744005;0;1;-1
202012;352590;G;4637106;6;5;1
202012;352590;G;4759801;1;0;1
202012;352590;G;4756300;1;1;0
202012;352590;G;4649499;0;1;-1
202012;352590;G;4530703;0;19;-19
202012;352590;G;4639701;1;0;1
202012;352590;G;4530703;0;2;-2
202012;352590;G;4721102;2;1;1
202012;352590;G;4781400;0;1;-1
202012;352590;G;4781400;0;3;-3
202012;352590;G;4781400;0;2;-2
202012;352590;G;4781400;0;4;-4
202012;352590;G;4541202;1;0;1
202012;352590;G;4744003;1;0;1
202012;352590;G;4511101;1;1;0
202012;352590;G;4753900;1;0;1
202012;352590;G;4731800;0;2;-2
202012;352590;G;4639701;10;4;6
202012;352590;G;4781400;0;1;-1
202012;352590;G;4712100;1;0;1
202012;352590;G;4789007;1;1;0
202012;352590;G;4731800;1;1;0
202012;352590;G;4781400;1;0;1
202012;352590;G;4789002;0;1;-1
202012;352590;G;4759899;1;0;1
202012;352590;G;4520001;1;1;0
202012;352590;G;4789007;4;1;3
202012;352590;G;4753900;0;2;-2
202012;352590;G;4664800;3;1;2
202012;352590;G;4773300;2;1;1
202012;352590;G;4724500;14;12;2
202012;352590;G;4712100;1;0;1
202012;352590;G;4511101;2;0;2
202012;352590;G;4771701;0;1;-1
202012;352590;G;4689399;0;2;-2
202012;352590;G;4731800;2;0;2
202012;352590;G;4520002;1;4;-3
202012;352590;G;4729699;3;1;2
202012;352590;G;4530703;2;3;-1
202012;352590;G;4731800;3;2;1
202012;352590;G;4782201;22;2;20
202012;352590;G;4511101;7;7;0
202012;352590;G;4781400;0;1;-1
202012;352590;G;4789001;0;1;-1
202012;352590;G;4687703;0;2;-2
202012;352590;G;4722901;0;1;-1
202012;352590;G;4781400;1;0;1
202012;352590;G;4755502;2;3;-1
202012;352590;G;4781400;2;0;2
202012;352590;G;4744002;0;1;-1
202012;352590;G;4772500;1;1;0
202012;352590;G;4633801;0;1;-1
202012;352590;G;4520006;0;1;-1
202012;352590;G;4687702;2;1;1
202012;352590;G;4693100;2;0;2
202012;352590;G;4711302;14;11;3
202012;352590;G;4774100;1;0;1
202012;352590;G;4753900;0;2;-2
202012;352590;G;4721104;1;0;1
202012;352590;G;4751201;0;1;-1
202012;352590;G;4759899;1;0;1
202012;352590;G;4744099;1;0;1
202012;352590;G;4772500;2;0;2
202012;352590;G;4759899;0;8;-8
202012;352590;G;4759899;0;4;-4
202012;352590;G;4759899;0;2;-2
202012;352590;G;4759899;0;3;-3
202012;352590;G;4649499;0;8;-8
202012;352590;G;4744099;1;0;1
202012;352590;G;4753900;2;0;2
202012;352590;G;4712100;0;3;-3
202012;352590;G;4711302;10;6;4
202012;352590;G;4711301;20;10;10
202012;352590;G;4789002;1;0;1
202012;352590;G;4753900;1;0;1
202012;352590;G;4761001;0;2;-2
202012;352590;G;4530703;0;2;-2
202012;352590;G;4781400;1;0;1
202012;352590;G;4759899;0;1;-1
202012;352590;G;4789001;1;0;1
202012;352590;G;4520005;1;0;1
202012;352590;G;4712100;0;3;-3
202012;352590;G;4789002;15;5;10
202012;352590;G;4763602;10;2;8
202012;352590;G;4781400;1;1;0
202012;352590;G;4687702;0;1;-1
202012;352590;G;4711302;5;12;-7
202012;352590;G;4763603;1;1;0
202012;352590;G;4763603;3;1;2
202012;352590;G;4731800;3;2;1
202012;352590;G;4530703;1;0;1
202012;352590;G;4530703;0;1;-1
202012;352590;G;4781400;3;5;-2
202012;352590;G;4530703;0;1;-1
202012;352590;G;4729699;1;0;1
202012;352590;G;4722901;0;1;-1
202012;352590;G;4633801;1;4;-3
202012;352590;G;4781400;0;1;-1
202012;352590;G;4520005;1;1;0
202012;352590;G;4685100;1;0;1
202012;352590;G;4771701;1;1;0
202012;352590;G;4771701;1;1;0
202012;352590;G;4752100;0;1;-1
202012;352590;G;4741500;1;2;-1
202012;352590;G;4741500;1;1;0
202012;352590;G;4731800;1;1;0
202012;352590;G;4635402;2;3;-1
202012;352590;G;4744001;0;2;-2
202012;352590;G;4754703;2;2;0
202012;352590;G;4617600;2;5;-3
202012;352590;G;4721102;1;3;-2
202012;352590;G;4722901;2;0;2
202012;352590;G;4772500;1;1;0
202012;352590;G;4774100;0;1;-1
202012;352590;G;4781400;1;0;1
202012;352590;G;4511101;2;2;0
202012;352590;G;4744099;0;1;-1
202012;352590;G;4753900;2;3;-1
202012;352590;G;4753900;0;1;-1
202012;352590;G;4789099;0;1;-1
202012;352590;G;4530703;5;1;4
202012;352590;G;4781400;0;1;-1
202012;352590;G;4751201;2;0;2
202012;352590;G;4744001;2;0;2
202012;352590;G;4686902;1;0;1
202012;352590;G;4771701;1;0;1
202012;352590;G;4755502;2;0;2
202012;352590;G;4755502;0;1;-1
202012;352590;G;4761001;1;0;1
202012;352590;G;4752100;1;0;1
202012;352590;G;4731800;1;2;-1
202012;352590;G;4530703;0;3;-3
202012;352590;G;4731800;0;1;-1
202012;352590;G;4530703;0;2;-2
202012;352590;G;4744001;2;1;1
202012;352590;G;4772500;1;0;1
202012;352590;G;4729699;2;6;-4
202012;352590;G;4721104;1;2;-1
202012;352590;G;4771701;0;1;-1
202012;352590;G;4511101;0;1;-1
202012;352590;G;4530703;0;1;-1
202012;352590;G;4729699;6;5;1
202012;352590;G;4744001;0;1;-1
202012;352590;G;4789099;0;1;-1
202012;352590;G;4686902;3;3;0
202012;352590;G;4712100;0;1;-1
202012;352590;G;4759899;0;5;-5
202012;352590;G;4781400;1;1;0
202012;352590;G;4511101;1;2;-1
202012;352590;G;4754701;23;10;13
202012;352590;G;4754701;0;1;-1
202012;352590;G;4759899;2;0;2
202012;352590;G;4789005;1;1;0
202012;352590;G;4754701;0;1;-1
202012;352590;G;4713002;1;1;0
202012;352590;G;4530703;0;1;-1
202012;352590;G;4686902;3;1;2
202012;352590;G;4724500;17;5;12
202012;352590;G;4633801;3;1;2
202012;352590;G;4724500;19;9;10
202012;352590;G;4663000;0;1;-1
202012;352590;G;4789004;1;0;1
202012;352590;G;4721102;1;0;1
202012;352590;G;4772500;1;1;0
202012;352590;G;4691500;2;4;-2
202012;352590;G;4721103;1;0;1
202012;352590;G;4712100;0;2;-2
202012;352590;G;4731800;1;1;0
202012;352590;G;4618402;4;2;2
202012;352590;G;4771701;1;0;1
202012;352590;G;4712100;0;1;-1
202012;352590;G;4647801;1;1;0
202012;352590;G;4731800;0;1;-1
202012;352590;G;4782201;0;1;-1
202012;352590;G;4744002;0;2;-2
202012;352590;G;4754701;1;3;-2
202012;352590;G;4530703;1;0;1
202012;352590;G;4755501;0;1;-1
202012;352590;G;4530703;0;1;-1
202012;352590;G;4731800;5;3;2
202012;352590;G;4712100;3;3;0
202012;352590;G;4771701;0;1;-1
202012;352590;G;4729699;3;0;3
202012;352590;G;4731800;0;1;-1
202012;352590;G;4623109;2;1;1
202012;352590;G;4781400;2;40;-38
202012;352590;G;4789099;5;8;-3
202012;352590;G;4761003;1;0;1
202012;352590;G;4782201;0;1;-1
202012;352590;G;4781400;0;6;-6
202012;352590;G;4781400;0;6;-6
202012;352590;G;4633801;1;0;1
202012;352590;G;4744002;0;1;-1
202012;352590;G;4663000;0;6;-6
202012;352590;G;4751201;1;0;1
202012;352590;G;4781400;0;1;-1
202012;352590;G;4731800;0;1;-1
202012;352590;G;4649499;0;2;-2
202012;352590;G;4649401;1;0;1
202012;352590;G;4782201;0;2;-2
202012;352590;G;4782201;0;2;-2
202012;352590;G;4782201;0;7;-7
202012;352590;G;4721102;0;1;-1
202012;352590;G;4520001;0;1;-1
202012;352590;G;4789002;1;0;1
202012;352590;G;4781400;0;1;-1
202012;352590;G;4722901;1;0;1
202012;352590;G;4713002;1;0;1
202012;352590;G;4729699;2;0;2
202012;352590;G;4530703;2;0;2
202012;352590;G;4781400;0;2;-2
202012;352590;G;4781400;13;2;11
202012;352590;G;4781400;23;21;2
202012;352590;G;4781400;12;9;3
202012;352590;G;4712100;0;1;-1
202012;352590;G;4772500;2;2;0
202012;352590;G;4789002;3;0;3
202012;352590;G;4783101;0;1;-1
202012;352590;G;4711302;0;1;-1
202012;352590;G;4744099;0;3;-3
202012;352590;G;4520005;0;2;-2
202012;352590;G;4744001;1;0;1
202012;352590;G;4782201;8;8;0
202012;352590;G;4771701;2;0;2
202012;352590;G;4754701;2;0;2
202012;352590;G;4781400;0;1;-1
202012;352590;G;4772500;1;1;0
202012;352590;G;4772500;0;2;-2
202012;352590;G;4772500;2;0;2
202012;352590;G;4772500;1;0;1
202012;352590;G;4691500;8;8;0
202012;352590;G;4619200;0;1;-1
202012;352590;G;4761003;1;0;1
202012;352590;G;4689399;1;5;-4
202012;352590;G;4669999;2;3;-1
202012;352590;G;4763601;0;2;-2
202012;352590;G;4781400;1;0;1
202012;352590;G;4652400;1;0;1
202012;352590;G;4781400;6;6;0
202012;352590;G;4772500;0;4;-4
202012;352590;G;4744005;1;0;1
202012;352590;G;4646001;0;1;-1
202012;352590;G;4789099;0;2;-2
202012;352590;G;4744001;1;0;1
202012;352590;G;4530704;3;3;0
202012;352590;G;4789099;0;1;-1
202012;352590;G;4530705;1;0;1
202012;352590;G;4771701;1;2;-1
202012;352590;G;4744001;0;1;-1
202012;352590;G;4754701;13;8;5
202012;352590;G;4633801;0;4;-4
202012;352590;G;4744099;0;2;-2
202012;352590;G;4759899;0;1;-1
202012;352590;G;4772500;0;1;-1
202012;352590;G;4530703;0;1;-1
202012;352590;G;4761001;2;5;-3
202012;352590;G;4724500;3;2;1
202012;352590;G;4623109;2;0;2
202012;352590;G;4763601;2;0;2
202012;352590;G;4772500;2;1;1
202012;352590;G;4741500;0;1;-1
202012;352590;G;4520001;1;0;1
202012;352590;G;4721104;4;9;-5
202012;352590;G;4637107;0;1;-1
202012;352590;G;4754701;1;1;0
202012;352590;G;4754701;6;0;6
202012;352590;G;4752100;2;1;1
202012;352590;G;4744005;0;1;-1
202012;352590;G;4782201;2;0;2
202012;352590;G;4772500;3;4;-1
202012;352590;G;4782201;5;1;4
202012;352590;G;4771701;0;1;-1
202012;352590;G;4781400;0;1;-1
202012;352590;G;4712100;0;1;-1
202012;352590;G;4712100;0;1;-1
202012;352590;G;4782201;10;8;2
202012;352590;G;4781400;1;0;1
202012;352590;G;4782201;1;0;1
202012;352590;G;4782201;1;0;1
202012;352590;G;4755502;4;1;3
202012;352590;G;4721102;3;0;3
202012;352590;G;4781400;0;2;-2
202012;352590;G;4721104;1;0;1
202012;352590;G;4789099;0;1;-1
202012;352590;G;4751201;1;0;1
202012;352590;G;4729699;2;0;2
202012;352590;G;4781400;0;1;-1
202012;352590;G;4763601;1;0;1
202012;352590;G;4520005;0;9;-9
202012;352590;G;4721104;1;0;1
202012;352590;G;4721104;3;1;2
202012;352590;G;4752100;0;1;-1
202012;352590;G;4614100;0;1;-1
202012;352590;G;4771702;4;3;1
202012;352590;G;4789099;0;1;-1
202012;352590;G;4744001;0;1;-1
202012;352590;G;4752100;1;0;1
202012;352590;G;4781400;1;0;1
202012;352590;G;4789004;1;1;0
202012;352590;G;4789099;0;1;-1
202012;352590;G;4687702;1;0;1
202012;352590;G;4713002;1;0;1
202012;352590;G;4520005;2;2;0
202012;352590;G;4731800;1;0;1
202012;352590;G;4782201;0;1;-1
202012;352590;G;4751201;1;0;1
202012;352590;G;4789004;1;0;1
202012;352590;G;4774100;0;1;-1
202012;352590;G;4781400;1;1;0
202012;352590;G;4781400;0;1;-1
202012;352590;G;4772500;0;1;-1
202012;352590;G;4772500;0;2;-2
202012;352590;G;4752100;0;1;-1
202012;352590;G;4781400;2;1;1
202012;352590;G;4754701;1;0;1
202012;352590;G;4530703;2;1;1
202012;352590;G;4781400;0;1;-1
202012;352590;G;4753900;5;1;4
202012;352590;G;4789001;1;0;1
202012;352590;G;4774100;1;1;0
202012;352590;G;4761001;0;1;-1
202012;352590;G;4722901;1;1;0
202012;352590;G;4520002;1;0;1
202012;352590;G;4652400;1;1;0
202012;352590;G;4752100;1;0;1
202012;352590;G;4752100;1;0;1
202012;352590;G;4713002;0;2;-2
202012;352590;G;4530705;0;1;-1
202012;352590;G;4721102;0;1;-1
202012;352590;G;4721102;2;1;1
202012;352590;G;4774100;2;1;1
202012;352590;G;4781400;1;1;0
202012;352590;G;4789002;0;1;-1
202012;352590;G;4754701;1;0;1
202012;352590;G;4721102;0;1;-1
202012;352590;G;4530703;0;1;-1
202012;352590;G;4781400;13;9;4
202012;352590;G;4712100;1;0;1
202012;352590;G;4781400;0;2;-2
202012;352590;G;4731800;1;3;-2
202012;352590;G;4772500;0;1;-1
202012;352590;G;4669999;3;3;0
202012;352590;G;4672900;0;1;-1
202012;352590;G;4754701;2;0;2
202012;352590;G;4789099;0;1;-1
202012;352590;G;4721102;0;1;-1
202012;352590;G;4729699;1;1;0
202012;352590;G;4672900;0;1;-1
202012;352590;G;4763601;0;1;-1
202012;352590;G;4712100;1;0;1
202012;352590;G;4781400;1;0;1
202012;352590;G;4530703;2;0;2
202012;352590;G;4789002;0;1;-1
202012;352590;G;4645101;3;5;-2
202012;352590;G;4772500;1;0;1
202012;352590;G;4789001;1;0;1
202012;352590;G;4721102;0;1;-1
202012;352590;G;4789099;2;0;2
202012;352590;G;4789099;1;1;0
202012;352590;G;4744001;0;1;-1
202012;352590;G;4731800;2;2;0
202012;352590;G;4713001;6;5;1
202012;352590;G;4511101;0;1;-1
202012;352590;G;4754701;1;2;-1
202012;352590;G;4731800;0;1;-1
202012;352590;G;4713002;0;1;-1
202012;352590;G;4729699;3;2;1
202012;352590;G;4520001;1;0;1
202012;352590;G;4781400;1;0;1
202012;352590;G;4789099;0;1;-1
202012;352590;G;4742300;0;1;-1
202012;352590;G;4646001;1;1;0
202012;352590;G;4754701;0;1;-1
202012;352590;G;4782201;0;1;-1
202012;352590;G;4781400;1;0;1
202012;352590;G;4781400;1;1;0
202012;352590;G;4783101;1;1;0
202012;352590;G;4530703;0;2;-2
202012;352590;G;4711302;0;1;-1
202012;352590;G;4639701;7;12;-5
202012;352590;G;4712100;2;2;0
202012;352590;G;4753900;3;4;-1
202012;352590;G;4759899;0;1;-1
202012;352590;G;4771701;0;1;-1
202012;352590;G;4744001;1;0;1
202012;352590;G;4731800;0;1;-1
202012;352590;G;4789001;1;0;1
202012;352590;G;4757100;0;1;-1
202012;352590;G;4781400;1;0;1
202012;352590;G;4721103;0;2;-2
202012;352590;G;4782201;0;1;-1
202012;352590;G;4530705;0;1;-1
202012;352590;G;4744099;2;0;2
202012;352590;G;4781400;3;1;2
202012;352590;G;4759899;0;1;-1
202012;352590;G;4781400;1;0;1
202012;352590;G;4744099;3;2;1
202012;352590;G;4781400;2;2;0
202012;352590;G;4789004;1;0;1
202012;352590;G;4646001;0;2;-2
202012;352590;G;4759899;1;0;1
202012;352590;G;4789099;1;0;1
202012;352590;G;4744005;1;0;1
202012;352590;G;4729699;0;1;-1
202012;352590;G;4729699;0;1;-1
202012;352590;G;4774100;0;1;-1
202012;352590;G;4759899;1;0;1
202012;352590;G;4724500;1;0;1
202012;352590;G;4729602;6;0;6
202012;352590;G;4713002;1;0;1
202012;352590;G;4721103;2;2;0
202012;352590;G;4520006;0;1;-1
202012;352590;G;4721102;2;1;1
202012;352590;G;4752100;2;1;1
202012;352590;G;4771701;1;0;1
202012;352590;G;4781400;3;0;3
202012;352590;G;4731800;1;0;1
202012;352590;G;4781400;1;0;1
202012;352590;G;4789004;0;1;-1
202012;352590;G;4789004;1;1;0
202012;352590;G;4754701;1;0;1
202012;352590;G;4687702;0;5;-5
202012;352590;G;4729602;0;1;-1
202012;352590;G;4721102;1;1;0
202012;352590;G;4511102;0;1;-1
202012;352590;G;4755503;0;2;-2
202012;352590;G;4783101;1;0;1
202012;352590;G;4520002;1;0;1
202012;352590;G;4729699;2;0;2
202012;352590;G;4729699;1;0;1
202012;352590;G;4721104;0;1;-1
202012;352590;G;4789099;1;0;1
202012;352590;G;4789099;0;1;-1
202012;352590;G;4781400;0;1;-1
202012;352590;G;4679699;1;0;1
202012;352590;G;4712100;1;0;1
202012;352590;G;4789099;0;1;-1
202012;352590;G;4781400;0;1;-1
202012;352590;G;4782201;0;3;-3
202012;352590;G;4772500;2;0;2
202012;352590;G;4721104;1;0;1
202012;352590;G;4789099;4;1;3
202012;352590;G;4781400;3;2;1
202012;352590;G;4782202;0;1;-1
202012;352590;G;4744099;0;1;-1
202012;352590;G;4511101;1;0;1
202012;352590;G;4530705;2;1;1
202012;352590;G;4723700;1;0;1
202012;352590;G;4520001;0;1;-1
202012;352590;G;4771701;1;1;0
202012;352590;G;4781400;0;1;-1
202012;352590;G;4711301;5;5;0
202012;352590;G;4511102;0;1;-1
202012;352590;G;4783101;1;1;0
202012;352590;G;4711302;1;1;0
202012;352590;G;4713002;0;1;-1
202012;352590;G;4520005;1;1;0
202012;352590;G;4781400;0;1;-1
202012;352590;G;4781400;3;4;-1
202012;352590;G;4530702;0;1;-1
202012;352590;G;4782201;2;0;2
202012;352590;G;4789001;3;1;2
202012;352590;G;4639701;53;13;40
202012;352590;G;4637199;4;2;2
202012;352590;G;4761003;3;0;3
202012;352590;G;4729699;0;1;-1
202012;352590;G;4721104;2;0;2
202012;352590;G;4774100;1;0;1
202012;352590;G;4722902;0;1;-1
202012;352590;G;4724500;1;1;0
202012;352590;G;4729699;0;1;-1
202012;352590;G;4789002;0;4;-4
202012;352590;G;4781400;2;0;2
202012;352590;G;4511102;0;1;-1
202012;352590;G;4781400;3;4;-1
202012;352590;G;4621400;1;0;1
202012;352590;G;4742300;0;3;-3
202012;352590;G;4530703;1;0;1
202012;352590;G;4712100;2;0;2
202012;352590;G;4771701;0;1;-1
202012;352590;G;4774100;1;1;0
202012;352590;G;4789099;0;1;-1
202012;352590;G;4772500;1;0;1
202012;352590;G;4520006;1;0;1
202012;352590;G;4754701;0;1;-1
202012;352590;G;4711302;11;18;-7
202012;352590;G;4711302;2;7;-5
202012;352590;G;4752100;1;0;1
202012;352590;G;4753900;1;0;1
202012;352590;G;4753900;91;39;52
202012;352590;G;4753900;3;3;0
202012;352590;G;4753900;1;1;0
202012;352590;G;4753900;0;1;-1
202012;352590;G;4753900;21;52;-31
202012;352590;G;4753900;0;1;-1
202012;352590;G;4712100;0;1;-1
202012;352590;G;4712100;2;1;1
202012;352590;G;4781400;19;7;12
202012;352590;G;4781400;12;6;6
202012;352590;G;4781400;0;1;-1
202012;352590;G;4744005;1;0;1
202012;352590;G;4781400;4;0;4
202012;352590;G;4637199;0;1;-1
202012;352590;G;4752100;0;1;-1
202012;352590;G;4744001;0;2;-2
202012;352590;G;4782201;0;2;-2
202012;352590;G;4731800;1;0;1
202012;352590;G;4763602;6;4;2
202012;352590;G;4785799;1;0;1
202012;352590;G;4511102;1;0;1
202012;352590;G;4781400;1;3;-2
202012;352590;G;4771701;1;0;1
202012;352590;G;4669999;3;3;0
202012;352590;G;4669999;1;1;0
202012;352590;G;4729602;1;1;0
202012;352590;G;4772500;1;0;1
202012;352590;G;4759899;3;0;3
202012;352590;G;4771701;2;1;1
202012;352590;G;4763602;1;1;0
202012;352590;G;4771701;2;1;1
202012;352590;G;4530703;0;1;-1
202012;352590;G;4774100;2;2;0
202012;352590;G;4774100;6;6;0
202012;352590;G;4774100;6;4;2
202012;352590;G;4721102;2;0;2
202012;352590;G;4731800;2;2;0
202012;352590;G;4744099;1;0;1
202012;352590;G;4633801;2;0;2
202012;352590;G;4781400;1;1;0
202012;352590;G;4713002;2;0;2
202012;352590;G;4729699;1;0;1
202012;352590;G;4723700;1;0;1
202012;352590;G;4761003;0;1;-1
202012;352590;G;4781400;0;1;-1
202012;352590;G;4782201;4;0;4
202012;352590;G;4751201;1;0;1
202012;352590;G;4723700;1;0;1
202012;352590;G;4781400;5;0;5
202012;352590;G;4781400;1;0;1
202012;352590;G;4789099;1;0;1
202012;352590;G;4781400;1;0;1
202012;352590;G;4729699;2;0;2
202012;352590;G;4729602;2;0;2
202012;352590;G;4781400;2;0;2
202012;352590;G;4686902;8;1;7
202012;352590;G;4520002;1;1;0
202012;352590;G;4789001;1;0;1
202012;352590;G;4782201;1;0;1
202012;352590;G;4789099;0;1;-1
202012;352590;G;4713001;1;1;0
202012;352590;G;4729699;0;1;-1
202012;352590;G;4755501;1;0;1
202012;352590;G;4520001;1;0;1
202012;352590;G;4772500;4;0;4
202012;352590;G;4713002;1;0;1
202012;352590;G;4635499;3;0;3
202012;352590;G;4689302;1;0;1
202012;352590;G;4520005;1;0;1
202012;352590;G;4647801;1;0;1
202012;352590;G;4753900;1;0;1
202012;352590;G;4753900;1;0;1
202012;352590;G;4772500;2;2;0
202012;352590;G;4744005;3;1;2
202012;352590;G;4789002;0;1;-1
202012;352590;G;4755502;1;0;1
202012;352590;G;4781400;12;0;12
202012;352590;G;4781400;6;1;5
202012;352590;G;4782201;3;3;0
202012;352590;G;4782201;5;3;2
202012;352590;G;4782201;3;1;2
202012;352590;G;4782201;1;1;0
202012;352590;G;4782201;3;7;-4
202012;352590;G;4782201;1;0;1
202012;352590;G;4711301;10;8;2
202012;352590;G;4731800;3;1;2
202012;352590;G;4771701;1;1;0
202012;352590;G;4672900;1;0;1
202012;352590;G;4722901;0;1;-1
202012;352590;G;4782201;4;4;0
202012;352590;G;4781400;7;2;5
202012;352590;G;4744002;1;3;-2
202012;352590;G;4639701;1;3;-2
202012;352590;G;4754701;1;1;0
202012;352590;G;4781400;15;14;1
202012;352590;G;4781400;2;1;1
202012;352590;G;4530703;0;1;-1
202012;352590;G;4711302;0;2;-2
202012;352590;G;4711302;2;2;0
202012;352590;G;4789002;1;0;1
202012;352590;G;4637107;1;0;1
202012;352590;G;4713001;1;0;1
202012;352590;G;4713001;0;1;-1
202012;352590;G;4774100;1;1;0
202012;352590;G;4731800;0;2;-2
202012;352590;G;4781400;1;0;1
202012;352590;G;4741500;1;0;1
202012;352590;G;4772500;1;0;1
202012;352590;G;4530703;1;1;0
202012;352590;G;4755503;0;1;-1
202012;352590;G;4761003;1;0;1
202012;352590;G;4731800;0;1;-1
202012;352590;G;4783101;1;0;1
202012;352590;G;4744099;1;0;1
202012;352590;G;4530703;2;2;0
202012;352590;G;4731800;2;0;2
202012;352590;G;4511101;1;0;1
202012;352590;G;4744001;0;1;-1
202012;352590;G;4729699;1;0;1
202012;352590;G;4530703;0;1;-1
202012;352590;G;4511104;1;1;0
202012;352590;G;4530705;1;0;1
202012;352590;G;4712100;2;0;2
202012;352590;G;4541203;1;0;1
202012;352590;G;4771701;1;0;1
202012;352590;G;4731800;1;1;0
202012;352590;G;4711302;0;1;-1
202012;352590;G;4711302;2;0;2
202012;352590;G;4711302;80;10;70
202012;352590;G;4711302;1;1;0
202012;352590;G;4711302;2;1;1
202012;352590;G;4731800;1;0;1
202012;352590;G;4711302;7;4;3
202012;352590;G;4711302;1;1;0
202012;352590;G;4711302;11;9;2
202012;352590;G;4711302;3;5;-2
202012;352590;G;4711302;8;7;1
202012;352590;G;4711302;11;5;6
202012;352590;G;4711302;1;1;0
202012;352590;G;4711302;7;3;4
202012;352590;G;4711302;5;3;2
202012;352590;G;4711302;12;7;5
202012;352590;G;4511101;3;1;2
202012;352590;G;4721104;0;1;-1
202012;352590;G;4711302;10;7;3
202012;352590;G;4711302;4;5;-1
202012;352590;G;4711302;12;1;11
202012;352590;G;4711302;11;2;9
202012;352590;G;4711302;8;2;6
202012;352590;G;4633801;4;3;1
202012;352590;G;4759899;1;0;1
202012;352590;G;4541203;0;1;-1
202012;352590;G;4647801;0;2;-2
202012;352590;G;4771701;0;1;-1
202012;352590;G;4661300;15;6;9
202012;352590;G;4639701;3;3;0
202012;352590;G;4744099;0;3;-3
202012;352590;G;4782201;14;9;5
202012;352590;G;4782201;28;23;5
202012;352590;G;4771702;13;8;5
202012;352590;G;4755502;1;1;0
202012;352590;G;4530703;1;0;1
202012;352590;G;4530701;0;1;-1
202012;352590;G;4721102;2;2;0
202012;352590;G;4789004;3;2;1
202012;352590;G;4669999;0;5;-5
202012;352590;G;4789004;0;1;-1
202012;352590;G;4663000;1;0;1
202012;352590;G;4663000;1;0;1
202012;352590;G;4530705;0;1;-1
202012;352590;G;4712100;4;1;3
202012;352590;G;4520001;1;0;1
202012;352590;G;4744002;0;1;-1
202012;352590;G;4712100;2;0;2
202012;352590;G;4712100;0;1;-1
202012;352590;G;4744005;2;0;2
202012;352590;G;4530703;1;0;1
202012;352590;G;4511101;7;3;4
202012;352590;G;4687702;0;2;-2
202012;352590;G;4530703;0;1;-1
202012;352590;G;4789007;1;0;1
202012;352590;G;4649499;0;1;-1
202012;352590;G;4661300;5;0;5
202012;352590;G;4763604;1;0;1
202012;352590;G;4781400;0;1;-1
202012;352590;G;4753900;2;0;2
202012;352590;G;4753900;1;2;-1
202012;352590;G;4761003;1;0;1
202012;352590;G;4520001;0;1;-1
202012;352590;G;4731800;0;1;-1
202012;352590;G;4530703;1;0;1
202012;352590;G;4774100;1;0;1
202012;352590;G;4721103;1;0;1
202012;352590;G;4530703;1;0;1
202012;352590;G;4781400;0;1;-1
202012;352590;G;4771701;1;0;1
202012;352590;G;4781400;1;0;1
202012;352590;G;4761003;0;1;-1
202012;352590;G;4763601;1;0;1
202012;352590;G;4763601;12;10;2
202012;352590;G;4635402;3;6;-3
202012;352590;G;4731800;0;1;-1
202012;352590;G;4781400;0;1;-1
202012;352590;G;4520001;2;0;2
202012;352590;G;4721102;1;1;0
202012;352590;G;4731800;1;0;1
202012;352590;G;4741500;1;0;1
202012;352590;G;4789004;1;0;1
202012;352590;G;4633802;0;1;-1
202012;352590;G;4731800;4;1;3
202012;352590;G;4731800;1;0;1
202012;352590;G;4744005;0;1;-1
202012;352590;G;4511104;1;3;-2
202012;352590;G;4713001;0;1;-1
202012;352590;G;4713004;3;4;-1
202012;352590;G;4635402;3;3;0
202012;352590;G;4781400;0;3;-3
202012;352590;G;4781400;1;1;0
202012;352590;G;4711302;6;3;3
202012;352590;G;4771701;1;0;1
202012;352590;G;4771701;0;1;-1
202012;352590;G;4771701;1;2;-1
202012;352590;G;4771701;1;0;1
202012;352590;G;4771701;3;0;3
202012;352590;G;4771701;0;1;-1
202012;352590;G;4771701;1;2;-1
202012;352590;G;4771701;1;2;-1
202012;352590;G;4771701;1;0;1
202012;352590;G;4771701;0;1;-1
202012;352590;G;4771701;2;0;2
202012;352590;G;4771701;1;0;1
202012;352590;G;4771701;3;0;3
202012;352590;G;4771701;1;0;1
202012;352590;G;4771701;2;0;2
202012;352590;G;4635402;0;1;-1
202012;352590;G;4743100;0;2;-2
202012;352590;G;4782202;1;0;1
202012;352590;G;4782202;1;2;-1
202012;352590;G;4744005;0;1;-1
202012;352590;G;4759899;1;1;0
202012;352590;G;4637107;0;1;-1
202012;352590;G;4789002;6;4;2
202012;352590;G;4744099;1;0;1
202012;352590;G;4771701;0;1;-1
202012;352590;G;4731800;2;2;0
202012;352590;G;4731800;1;0;1
202012;352590;G;4731800;1;1;0
202012;352590;G;4530703;1;0;1
202012;352590;G;4663000;0;1;-1
202012;352590;G;4711302;39;27;12
202012;352590;G;4783101;1;0;1
202012;352590;G;4783101;2;0;2
202012;352590;G;4789099;0;1;-1
202012;352590;G;4684201;0;1;-1
202012;352590;G;4789099;1;0;1
202012;352590;G;4771701;3;2;1
202012;352590;G;4744005;2;0;2
202012;352590;G;4530703;0;1;-1
202012;352590;G;4520001;1;0;1
202012;352590;G;4711302;2;0;2
202012;352590;G;4722901;2;1;1
202012;352590;G;4729699;5;5;0
202012;352590;G;4789099;1;1;0
202012;352590;G;4530703;0;3;-3
202012;352590;G;4744005;2;0;2
202012;352590;G;4623199;1;0;1
202012;352590;G;4789001;0;3;-3
202012;352590;G;4721102;1;0;1
202012;352590;G;4761003;0;1;-1
202012;352590;G;4530703;0;1;-1
202012;352590;G;4530703;0;1;-1
202012;352590;G;4771701;1;0;1
202012;352590;G;4751201;0;1;-1
202012;352590;G;4722901;1;0;1
202012;352590;G;4771702;2;2;0
202012;352590;G;4511101;1;0;1
202012;352590;G;4782202;1;0;1
202012;352590;G;4741500;2;1;1
202012;352590;G;4741500;1;0;1
202012;352590;G;4741500;0;1;-1
202012;352590;G;4741500;0;1;-1
202012;352590;G;4744005;1;1;0
202012;352590;G;4781400;0;2;-2
202012;352590;G;4789099;1;0;1
202012;352590;G;4731800;1;0;1
202012;352590;G;4731800;0;1;-1
202012;352590;G;4692300;4;4;0
202012;352590;G;4520005;17;2;15
202012;352590;G;4744001;0;1;-1
202012;352590;G;4743100;0;2;-2
202012;352590;G;4635402;15;9;6
202012;352590;G;4771701;0;1;-1
202012;352590;G;4711301;17;16;1
202012;352590;G;4672900;5;5;0
202012;352590;G;4781400;1;0;1
202012;352590;G;4530703;4;1;3
202012;352590;G;4711301;1;2;-1
202012;352590;G;4639701;0;1;-1
202012;352590;G;4679604;3;6;-3
202012;352590;G;4783101;0;1;-1
202012;352590;G;4661300;4;0;4
202012;352590;G;4781400;1;1;0
202012;352590;G;4781400;1;2;-1
202012;352590;G;4759801;0;1;-1
202012;352590;G;4771702;0;1;-1
202008;352590;G;4789099;1;0;1
202008;352590;G;4751201;1;0;1
202008;352590;G;4752100;1;2;-1
202008;352590;G;4772500;0;1;-1
202008;352590;G;4712100;0;1;-1
202008;352590;G;4789099;3;1;2
202008;352590;G;4757100;0;1;-1
202008;352590;G;4753900;6;19;-13
202008;352590;G;4753900;0;2;-2
202008;352590;G;4721102;1;0;1
202008;352590;G;4672900;1;1;0
202008;352590;G;4789099;1;0;1
202008;352590;G;4783101;0;1;-1
202008;352590;G;4530703;0;1;-1
202008;352590;G;4633801;2;1;1
202008;352590;G;4771702;1;0;1
202008;352590;G;4530703;0;1;-1
202008;352590;G;4616800;1;0;1
202008;352590;G;4693100;5;7;-2
202008;352590;G;4511101;4;2;2
202008;352590;G;4742300;3;1;2
202008;352590;G;4644301;9;19;-10
202008;352590;G;4771701;1;0;1
202008;352590;G;4754701;1;0;1
202008;352590;G;4752100;0;1;-1
202008;352590;G;4724500;2;0;2
202008;352590;G;4712100;0;1;-1
202008;352590;G;4781400;1;1;0
202008;352590;G;4689399;0;3;-3
202008;352590;G;4652400;3;0;3
202008;352590;G;4772500;1;1;0
202008;352590;G;4751201;2;0;2
202008;352590;G;4649499;0;1;-1
202008;352590;G;4639701;0;2;-2
202008;352590;G;4789099;0;1;-1
202008;352590;G;4755502;0;1;-1
202008;352590;G;4755502;0;1;-1
202008;352590;G;4634601;16;4;12
202008;352590;G;4724500;1;0;1
202008;352590;G;4712100;0;1;-1
202008;352590;G;4530703;0;1;-1
202008;352590;G;4712100;1;2;-1
202008;352590;G;4530701;4;2;2
202008;352590;G;4712100;2;0;2
202008;352590;G;4530702;2;1;1
202008;352590;G;4687703;1;0;1
202008;352590;G;4744005;1;0;1
202008;352590;G;4744005;1;0;1
202008;352590;G;4731800;0;1;-1
202008;352590;G;4731800;1;0;1
202008;352590;G;4649403;0;1;-1
202008;352590;G;4639701;1;3;-2
202008;352590;G;4751201;2;0;2
202008;352590;G;4763602;0;1;-1
202008;352590;G;4789001;0;1;-1
202008;352590;G;4731800;1;1;0
202008;352590;G;4721102;0;1;-1
202008;352590;G;4511101;0;2;-2
202008;352590;G;4784900;0;1;-1
202008;352590;G;4731800;0;1;-1
202008;352590;G;4754701;1;0;1
202008;352590;G;4619200;1;0;1
202008;352590;G;4673700;0;1;-1
202008;352590;G;4511101;0;2;-2
202008;352590;G;4511102;2;1;1
202008;352590;G;4772500;0;1;-1
202008;352590;G;4721102;0;1;-1
202008;352590;G;4722901;1;1;0
202008;352590;G;4781400;0;2;-2
202008;352590;G;4789099;0;2;-2
202008;352590;G;4713001;2;0;2
202008;352590;G;4789099;1;0;1
202008;352590;G;4771702;0;1;-1
202008;352590;G;4752100;0;1;-1
202008;352590;G;4724500;0;1;-1
202008;352590;G;4639701;1;2;-1
202008;352590;G;4744002;0;1;-1
202008;352590;G;4754701;0;1;-1
202008;352590;G;4646001;2;2;0
202008;352590;G;4744099;2;3;-1
202008;352590;G;4781400;0;1;-1
202008;352590;G;4711302;0;1;-1
202008;352590;G;4520005;2;0;2
202008;352590;G;4751201;1;0;1
202008;352590;G;4754701;0;1;-1
202008;352590;G;4754701;1;0;1
202008;352590;G;4774100;1;0;1
202008;352590;G;4744005;2;0;2
202008;352590;G;4721104;0;1;-1
202008;352590;G;4744005;6;1;5
202008;352590;G;4637106;2;3;-1
202008;352590;G;4663000;1;0;1
202008;352590;G;4771701;0;1;-1
202008;352590;G;4530703;3;3;0
202008;352590;G;4672900;0;4;-4
202008;352590;G;4639701;0;1;-1
202008;352590;G;4771701;1;0;1
202008;352590;G;4541202;1;0;1
202008;352590;G;4511101;1;0;1
202008;352590;G;4639701;9;7;2
202008;352590;G;4729699;1;0;1
202008;352590;G;4781400;0;1;-1
202008;352590;G;4731800;1;1;0
202008;352590;G;4789002;1;1;0
202008;352590;G;4761003;0;1;-1
202008;352590;G;4789001;0;1;-1
202008;352590;G;4753900;3;0;3
202008;352590;G;4724500;7;0;7
202008;352590;G;4511101;0;2;-2
202008;352590;G;4672900;1;0;1
202008;352590;G;4520002;0;1;-1
202008;352590;G;4729699;0;2;-2
202008;352590;G;4781400;1;0;1
202008;352590;G;4744002;3;0;3
202008;352590;G;4751201;0;1;-1
202008;352590;G;4530703;4;0;4
202008;352590;G;4731800;1;0;1
202008;352590;G;4782201;0;1;-1
202008;352590;G;4511101;7;4;3
202008;352590;G;4520001;1;0;1
202008;352590;G;4687703;1;1;0
202008;352590;G;4755502;4;1;3
202008;352590;G;4783101;0;1;-1
202008;352590;G;4731800;1;0;1
202008;352590;G;4781400;0;1;-1
202008;352590;G;4744002;1;0;1
202008;352590;G;4712100;1;0;1
202008;352590;G;4774100;1;0;1
202008;352590;G;4711302;7;8;-1
202008;352590;G;4774100;0;1;-1
202008;352590;G;4753900;0;1;-1
202008;352590;G;4649499;2;2;0
202008;352590;G;4751201;1;0;1
202008;352590;G;4759899;0;1;-1
202008;352590;G;4772500;0;1;-1
202008;352590;G;4741500;1;0;1
202008;352590;G;4759899;0;1;-1
202008;352590;G;4759899;0;1;-1
202008;352590;G;4759899;0;2;-2
202008;352590;G;4649499;5;6;-1
202008;352590;G;4761001;0;1;-1
202008;352590;G;4520001;1;0;1
202008;352590;G;4781400;0;1;-1
202008;352590;G;4744002;0;1;-1
202008;352590;G;4712100;0;1;-1
202008;352590;G;4711302;3;4;-1
202008;352590;G;4711301;17;9;8
202008;352590;G;4711302;1;0;1
202008;352590;G;4511102;1;0;1
202008;352590;G;4789002;0;1;-1
202008;352590;G;4761001;1;0;1
202008;352590;G;4530703;0;3;-3
202008;352590;G;4744005;0;1;-1
202008;352590;G;4789001;1;0;1
202008;352590;G;4781400;0;1;-1
202008;352590;G;4669999;1;0;1
202008;352590;G;4789099;1;0;1
202008;352590;G;4712100;1;2;-1
202008;352590;G;4789002;1;0;1
202008;352590;G;4763602;1;2;-1
202008;352590;G;4731800;3;2;1
202008;352590;G;4781400;1;0;1
202008;352590;G;4652400;0;10;-10
202008;352590;G;4520001;0;1;-1
202008;352590;G;4711302;9;15;-6
202008;352590;G;4763603;1;0;1
202008;352590;G;4763603;1;0;1
202008;352590;G;4789004;0;1;-1
202008;352590;G;4771701;1;0;1
202008;352590;G;4530703;1;2;-1
202008;352590;G;4781400;3;2;1
202008;352590;G;4530703;0;1;-1
202008;352590;G;4633801;16;5;11
202008;352590;G;4781400;0;1;-1
202008;352590;G;4771701;1;1;0
202008;352590;G;4771701;1;0;1
202008;352590;G;4771701;0;1;-1
202008;352590;G;4652400;2;0;2
202008;352590;G;4741500;3;0;3
202008;352590;G;4741500;3;0;3
202008;352590;G;4741500;1;0;1
202008;352590;G;4731800;2;0;2
202008;352590;G;4635402;0;1;-1
202008;352590;G;4744002;1;0;1
202008;352590;G;4789005;0;1;-1
202008;352590;G;4722901;1;0;1
202008;352590;G;4771702;0;1;-1
202008;352590;G;4754702;0;1;-1
202008;352590;G;4789001;1;0;1
202008;352590;G;4511101;2;0;2
202008;352590;G;4649401;1;0;1
202008;352590;G;4782201;0;1;-1
202008;352590;G;4530703;0;1;-1
202008;352590;G;4753900;3;6;-3
202008;352590;G;4753900;2;1;1
202008;352590;G;4639701;0;1;-1
202008;352590;G;4744001;1;0;1
202008;352590;G;4530703;1;1;0
202008;352590;G;4751201;0;1;-1
202008;352590;G;4771701;1;0;1
202008;352590;G;4729699;0;1;-1
202008;352590;G;4752100;1;0;1
202008;352590;G;4759801;0;1;-1
202008;352590;G;4731800;1;1;0
202008;352590;G;4789004;0;1;-1
202008;352590;G;4731800;1;0;1
202008;352590;G;4687703;0;1;-1
202008;352590;G;4731800;0;1;-1
202008;352590;G;4744001;1;0;1
202008;352590;G;4771701;1;0;1
202008;352590;G;4781400;0;1;-1
202008;352590;G;4729699;0;3;-3
202008;352590;G;4663000;1;0;1
202008;352590;G;4721104;0;1;-1
202008;352590;G;4789001;0;1;-1
202008;352590;G;4511101;1;0;1
202008;352590;G;4729699;0;1;-1
202008;352590;G;4744003;0;1;-1
202008;352590;G;4789099;0;3;-3
202008;352590;G;4686902;3;2;1
202008;352590;G;4743100;1;1;0
202008;352590;G;4511101;4;1;3
202008;352590;G;4789099;1;2;-1
202008;352590;G;4530703;1;0;1
202008;352590;G;4754701;23;1;22
202008;352590;G;4754701;2;0;2
202008;352590;G;4754701;1;0;1
202008;352590;G;4530703;0;1;-1
202008;352590;G;4731800;0;1;-1
202008;352590;G;4754701;1;0;1
202008;352590;G;4520001;1;0;1
202008;352590;G;4771701;2;1;1
202008;352590;G;4689399;0;1;-1
202008;352590;G;4722901;0;1;-1
202008;352590;G;4713002;0;1;-1
202008;352590;G;4771704;0;1;-1
202008;352590;G;4711302;0;2;-2
202008;352590;G;4686902;1;0;1
202008;352590;G;4724500;9;11;-2
202008;352590;G;4633801;2;2;0
202008;352590;G;4724500;17;11;6
202008;352590;G;4781400;0;1;-1
202008;352590;G;4663000;1;0;1
202008;352590;G;4721102;0;1;-1
202008;352590;G;4781400;0;1;-1
202008;352590;G;4691500;5;8;-3
202008;352590;G;4541205;0;1;-1
202008;352590;G;4520005;1;1;0
202008;352590;G;4774100;0;1;-1
202008;352590;G;4771701;0;1;-1
202008;352590;G;4712100;1;1;0
202008;352590;G;4511101;1;1;0
202008;352590;G;4781400;0;1;-1
202008;352590;G;4731800;0;1;-1
202008;352590;G;4782201;1;0;1
202008;352590;G;4713002;0;1;-1
202008;352590;G;4520004;0;1;-1
202008;352590;G;4789004;0;1;-1
202008;352590;G;4744003;1;0;1
202008;352590;G;4731800;0;2;-2
202008;352590;G;4712100;2;2;0
202008;352590;G;4511101;0;1;-1
202008;352590;G;4645103;1;0;1
202008;352590;G;4712100;1;1;0
202008;352590;G;4669999;1;1;0
202008;352590;G;4623109;3;4;-1
202008;352590;G;4781400;4;64;-60
202008;352590;G;4511104;1;0;1
202008;352590;G;4789099;0;2;-2
202008;352590;G;4761003;0;1;-1
202008;352590;G;4781400;1;0;1
202008;352590;G;4781400;0;1;-1
202008;352590;G;4633801;0;1;-1
202008;352590;G;4789005;0;1;-1
202008;352590;G;4773300;0;1;-1
202008;352590;G;4723700;0;1;-1
202008;352590;G;4731800;1;0;1
202008;352590;G;4649499;6;0;6
202008;352590;G;4772500;0;26;-26
202008;352590;G;4649401;0;1;-1
202008;352590;G;4713002;0;1;-1
202008;352590;G;4784900;1;0;1
202008;352590;G;4789004;0;1;-1
202008;352590;G;4731800;0;1;-1
202008;352590;G;4743100;1;0;1
202008;352590;G;4511102;0;1;-1
202008;352590;G;4530703;1;1;0
202008;352590;G;4781400;5;0;5
202008;352590;G;4781400;0;2;-2
202008;352590;G;4634601;0;1;-1
202008;352590;G;4781400;4;2;2
202008;352590;G;4712100;0;1;-1
202008;352590;G;4729602;1;0;1
202008;352590;G;4789002;0;1;-1
202008;352590;G;4783101;1;0;1
202008;352590;G;4711302;1;0;1
202008;352590;G;4712100;0;1;-1
202008;352590;G;4754701;1;0;1
202008;352590;G;4755503;1;0;1
202008;352590;G;4520005;4;1;3
202008;352590;G;4744001;1;1;0
202008;352590;G;4771701;1;0;1
202008;352590;G;4754701;1;2;-1
202008;352590;G;4743100;4;0;4
202008;352590;G;4530703;0;1;-1
202008;352590;G;4543900;0;1;-1
202008;352590;G;4691500;5;9;-4
202008;352590;G;4743100;1;0;1
202008;352590;G;4637199;2;1;1
202008;352590;G;4687702;0;1;-1
202008;352590;G;4637199;1;0;1
202008;352590;G;4619200;2;2;0
202008;352590;G;4689399;1;1;0
202008;352590;G;4772500;1;0;1
202008;352590;G;4669999;4;5;-1
202008;352590;G;4763601;6;2;4
202008;352590;G;4772500;1;1;0
202008;352590;G;4530703;1;1;0
202008;352590;G;4744005;1;0;1
202008;352590;G;4784900;1;0;1
202008;352590;G;4763603;0;1;-1
202008;352590;G;4789099;1;2;-1
202008;352590;G;4744001;1;0;1
202008;352590;G;4530704;1;1;0
202008;352590;G;4753900;1;0;1
202008;352590;G;4771701;1;0;1
202008;352590;G;4520005;2;0;2
202008;352590;G;4744001;0;1;-1
202008;352590;G;4754701;70;14;56
202008;352590;G;4744099;0;2;-2
202008;352590;G;4771702;0;1;-1
202008;352590;G;4759899;2;0;2
202008;352590;G;4771701;1;0;1
202008;352590;G;4761001;0;2;-2
202008;352590;G;4724500;1;2;-1
202008;352590;G;4772500;2;0;2
202008;352590;G;4741500;1;0;1
202008;352590;G;4774100;2;0;2
202008;352590;G;4520001;1;1;0
202008;352590;G;4721104;4;2;2
202008;352590;G;4637107;3;2;1
202008;352590;G;4754701;0;3;-3
202008;352590;G;4744099;4;9;-5
202008;352590;G;4782201;1;1;0
202008;352590;G;4520002;1;0;1
202008;352590;G;4712100;1;0;1
202008;352590;G;4712100;2;1;1
202008;352590;G;4781400;0;1;-1
202008;352590;G;4774100;0;1;-1
202008;352590;G;4755502;0;1;-1
202008;352590;G;4781400;1;0;1
202008;352590;G;4771701;1;1;0
202008;352590;G;4744005;0;1;-1
202008;352590;G;4712100;0;2;-2
202008;352590;G;4751201;2;2;0
202008;352590;G;4729699;0;1;-1
202008;352590;G;4520005;20;6;14
202008;352590;G;4789004;0;1;-1
202008;352590;G;4541201;1;0;1
202008;352590;G;4712100;0;1;-1
202008;352590;G;4771702;3;1;2
202008;352590;G;4789099;1;0;1
202008;352590;G;4752100;0;3;-3
202008;352590;G;4783102;0;1;-1
202008;352590;G;4781400;0;1;-1
202008;352590;G;4744001;1;0;1
202008;352590;G;4789001;0;1;-1
202008;352590;G;4789004;1;1;0
202008;352590;G;4774100;2;0;2
202008;352590;G;4781400;2;0;2
202008;352590;G;4724500;1;3;-2
202008;352590;G;4723700;0;1;-1
202008;352590;G;4771701;2;1;1
202008;352590;G;4520001;0;1;-1
202008;352590;G;4761001;2;0;2
202008;352590;G;4520002;1;0;1
202008;352590;G;4652400;9;4;5
202008;352590;G;4752100;0;1;-1
202008;352590;G;4752100;1;0;1
202008;352590;G;4751201;1;0;1
202008;352590;G;4530703;0;1;-1
202008;352590;G;4721102;0;2;-2
202008;352590;G;4721102;0;1;-1
202008;352590;G;4663000;1;1;0
202008;352590;G;4781400;1;0;1
202008;352590;G;4731800;1;1;0
202008;352590;G;4781400;0;2;-2
202008;352590;G;4713002;1;0;1
202008;352590;G;4669999;4;2;2
202008;352590;G;4754701;1;1;0
202008;352590;G;4789099;0;2;-2
202008;352590;G;4789001;1;1;0
202008;352590;G;4763601;1;1;0
202008;352590;G;4789003;1;0;1
202008;352590;G;4781400;0;1;-1
202008;352590;G;4645101;0;1;-1
202008;352590;G;4722901;1;0;1
202008;352590;G;4721102;0;2;-2
202008;352590;G;4729699;1;0;1
202008;352590;G;4744099;1;0;1
202008;352590;G;4731800;0;1;-1
202008;352590;G;4511101;0;1;-1
202008;352590;G;4744001;0;2;-2
202008;352590;G;4511101;1;0;1
202008;352590;G;4731800;1;0;1
202008;352590;G;4729699;25;7;18
202008;352590;G;4679699;0;2;-2
202008;352590;G;4789099;1;0;1
202008;352590;G;4742300;0;2;-2
202008;352590;G;4753900;1;2;-1
202008;352590;G;4646001;0;2;-2
202008;352590;G;4754701;0;1;-1
202008;352590;G;4729699;0;1;-1
202008;352590;G;4783101;0;3;-3
202008;352590;G;4772500;0;4;-4
202008;352590;G;4679603;3;1;2
202008;352590;G;4754703;1;0;1
202008;352590;G;4633801;0;1;-1
202008;352590;G;4530703;2;0;2
202008;352590;G;4753900;1;1;0
202008;352590;G;4711302;2;1;1
202008;352590;G;4753900;0;1;-1
202008;352590;G;4639701;14;5;9
202008;352590;G;4753900;4;6;-2
202008;352590;G;4759899;0;1;-1
202008;352590;G;4757100;1;0;1
202008;352590;G;4712100;0;1;-1
202008;352590;G;4789099;1;0;1
202008;352590;G;4781400;2;0;2
202008;352590;G;4729699;0;2;-2
202008;352590;G;4724500;1;0;1
202008;352590;G;4633801;0;1;-1
202008;352590;G;4781400;1;0;1
202008;352590;G;4759899;2;0;2
202008;352590;G;4781400;0;1;-1
202008;352590;G;4789004;0;1;-1
202008;352590;G;4773300;0;1;-1
202008;352590;G;4530703;0;1;-1
202008;352590;G;4530703;1;0;1
202008;352590;G;4789099;0;1;-1
202008;352590;G;4744005;0;1;-1
202008;352590;G;4789099;0;2;-2
202008;352590;G;4774100;1;0;1
202008;352590;G;4721104;1;0;1
202008;352590;G;4520006;1;1;0
202008;352590;G;4723700;1;0;1
202008;352590;G;4729699;2;1;1
202008;352590;G;4789004;1;0;1
202008;352590;G;4789004;1;0;1
202008;352590;G;4722901;0;1;-1
202008;352590;G;4687702;0;1;-1
202008;352590;G;4713001;2;0;2
202008;352590;G;4711302;0;1;-1
202008;352590;G;4633801;1;0;1
202008;352590;G;4729699;0;1;-1
202008;352590;G;4789099;1;0;1
202008;352590;G;4752100;1;0;1
202008;352590;G;4729699;1;0;1
202008;352590;G;4530705;0;1;-1
202008;352590;G;4712100;0;1;-1
202008;352590;G;4712100;1;0;1
202008;352590;G;4789099;3;0;3
202008;352590;G;4789099;0;1;-1
202008;352590;G;4744002;1;0;1
202008;352590;G;4782201;1;0;1
202008;352590;G;4772500;7;0;7
202008;352590;G;4789099;5;2;3
202008;352590;G;4781400;2;0;2
202008;352590;G;4781400;0;1;-1
202008;352590;G;4781400;0;2;-2
202008;352590;G;4721102;1;2;-1
202008;352590;G;4789004;1;1;0
202008;352590;G;4511101;2;0;2
202008;352590;G;4530705;1;0;1
202008;352590;G;4721104;0;1;-1
202008;352590;G;4772500;0;1;-1
202008;352590;G;4723700;1;0;1
202008;352590;G;4781400;0;1;-1
202008;352590;G;4784900;1;0;1
202008;352590;G;4520001;2;0;2
202008;352590;G;4711301;9;9;0
202008;352590;G;4781400;0;2;-2
202008;352590;G;4691500;1;0;1
202008;352590;G;4711302;2;0;2
202008;352590;G;4781400;0;2;-2
202008;352590;G;4781400;2;2;0
202008;352590;G;4530703;1;0;1
202008;352590;G;4530702;2;1;1
202008;352590;G;4752100;1;1;0
202008;352590;G;4713002;0;1;-1
202008;352590;G;4637199;3;1;2
202008;352590;G;4771701;1;0;1
202008;352590;G;4722902;1;0;1
202008;352590;G;4641901;1;0;1
202008;352590;G;4781400;0;1;-1
202008;352590;G;4713002;2;0;2
202008;352590;G;4789002;1;0;1
202008;352590;G;4742300;1;0;1
202008;352590;G;4763602;0;1;-1
202008;352590;G;4742300;1;0;1
202008;352590;G;4711302;0;1;-1
202008;352590;G;4752100;1;1;0
202008;352590;G;4530703;0;1;-1
202008;352590;G;4754701;2;0;2
202008;352590;G;4711302;0;1;-1
202008;352590;G;4753900;0;1;-1
202008;352590;G;4753900;30;49;-19
202008;352590;G;4753900;0;2;-2
202008;352590;G;4753900;0;1;-1
202008;352590;G;4753900;8;5;3
202008;352590;G;4753900;0;1;-1
202008;352590;G;4712100;2;2;0
202008;352590;G;4712100;4;0;4
202008;352590;G;4752100;1;1;0
202008;352590;G;4781400;2;0;2
202008;352590;G;4684299;2;0;2
202008;352590;G;4520002;1;0;1
202008;352590;G;4729699;0;1;-1
202008;352590;G;4723700;0;1;-1
202008;352590;G;4774100;1;0;1
202008;352590;G;4752100;1;0;1
202008;352590;G;4520001;1;1;0
202008;352590;G;4712100;0;1;-1
202008;352590;G;4687703;1;0;1
202008;352590;G;4785799;4;1;3
202008;352590;G;4771701;1;0;1
202008;352590;G;4789004;1;0;1
202008;352590;G;4669999;3;1;2
202008;352590;G;4729602;3;2;1
202008;352590;G;4772500;0;1;-1
202008;352590;G;4782201;3;0;3
202008;352590;G;4771701;1;0;1
202008;352590;G;4761001;1;0;1
202008;352590;G;4771701;1;1;0
202008;352590;G;4774100;2;0;2
202008;352590;G;4781400;1;1;0
202008;352590;G;4721102;0;1;-1
202008;352590;G;4635402;0;1;-1
202008;352590;G;4774100;2;0;2
202008;352590;G;4744099;1;0;1
202008;352590;G;4781400;1;0;1
202008;352590;G;4781400;1;0;1
202008;352590;G;4723700;1;0;1
202008;352590;G;4520001;2;0;2
202008;352590;G;4721104;2;0;2
202008;352590;G;4761003;1;0;1
202008;352590;G;4754701;2;0;2
202008;352590;G;4742300;4;0;4
202008;352590;G;4744001;2;0;2
202008;352590;G;4721104;2;0;2
202008;352590;G;4789001;2;0;2
202008;352590;G;4752100;1;0;1
202008;352590;G;4773300;3;0;3
202008;352590;G;4711302;0;1;-1
202008;352590;G;4774100;1;0;1
202008;352590;G;4753900;0;3;-3
202008;352590;G;4744005;0;1;-1
202008;352590;G;4731800;0;1;-1
202008;352590;G;4721102;1;0;1
202008;352590;G;4530703;1;0;1
202008;352590;G;4781400;0;2;-2
202008;352590;G;4782201;1;2;-1
202008;352590;G;4711301;18;3;15
202008;352590;G;4771701;0;1;-1
202008;352590;G;4672900;1;0;1
202008;352590;G;4713002;0;1;-1
202008;352590;G;4744002;2;0;2
202008;352590;G;4639701;10;5;5
202008;352590;G;4754701;0;1;-1
202008;352590;G;4711302;3;3;0
202008;352590;G;4711302;3;0;3
202008;352590;G;4789002;1;0;1
202008;352590;G;4711302;1;1;0
202008;352590;G;4713001;2;0;2
202008;352590;G;4712100;1;0;1
202008;352590;G;4731800;1;1;0
202008;352590;G;4784900;0;1;-1
202008;352590;G;4731800;1;1;0
202008;352590;G;4781400;2;0;2
202008;352590;G;4781400;1;0;1
202008;352590;G;4772500;0;1;-1
202008;352590;G;4744005;1;0;1
202008;352590;G;4763604;1;0;1
202008;352590;G;4530703;1;0;1
202008;352590;G;4755503;1;0;1
202008;352590;G;4731800;1;0;1
202008;352590;G;4616800;0;1;-1
202008;352590;G;4711302;0;1;-1
202008;352590;G;4712100;0;1;-1
202008;352590;G;4731800;0;1;-1
202008;352590;G;4744099;4;2;2
202008;352590;G;4530703;1;0;1
202008;352590;G;4511104;1;0;1
202008;352590;G;4530705;1;0;1
202008;352590;G;4672900;0;2;-2
202008;352590;G;4771701;1;1;0
202008;352590;G;4771701;1;2;-1
202008;352590;G;4731800;1;0;1
202008;352590;G;4711302;2;2;0
202008;352590;G;4711302;0;2;-2
202008;352590;G;4711302;0;2;-2
202008;352590;G;4711302;6;5;1
202008;352590;G;4731800;1;1;0
202008;352590;G;4711302;8;10;-2
202008;352590;G;4711302;4;1;3
202008;352590;G;4711302;16;16;0
202008;352590;G;4711302;1;4;-3
202008;352590;G;4711302;4;7;-3
202008;352590;G;4639701;0;1;-1
202008;352590;G;4711302;5;2;3
202008;352590;G;4711302;1;0;1
202008;352590;G;4711302;3;2;1
202008;352590;G;4711302;5;5;0
202008;352590;G;4711302;15;9;6
202008;352590;G;4721102;1;0;1
202008;352590;G;4511101;1;0;1
202008;352590;G;4744005;1;1;0
202008;352590;G;4635499;0;1;-1
202008;352590;G;4744099;1;0;1
202008;352590;G;4711302;2;3;-1
202008;352590;G;4711302;5;3;2
202008;352590;G;4711302;0;2;-2
202008;352590;G;4711302;3;3;0
202008;352590;G;4711302;1;1;0
202008;352590;G;4731800;1;0;1
202008;352590;G;4633801;7;6;1
202008;352590;G;4647801;0;3;-3
202008;352590;G;4661300;20;2;18
202008;352590;G;4744001;0;1;-1
202008;352590;G;4639701;0;2;-2
202008;352590;G;4771702;0;1;-1
202008;352590;G;4782201;2;0;2
202008;352590;G;4782201;0;2;-2
202008;352590;G;4771702;6;4;2
202008;352590;G;4530703;1;0;1
202008;352590;G;4530701;1;0;1
202008;352590;G;4721102;1;0;1
202008;352590;G;4789004;1;0;1
202008;352590;G;4669999;1;0;1
202008;352590;G;4771701;0;1;-1
202008;352590;G;4732600;0;1;-1
202008;352590;G;4712100;1;0;1
202008;352590;G;4712100;1;0;1
202008;352590;G;4712100;0;1;-1
202008;352590;G;4744005;1;0;1
202008;352590;G;4511101;8;1;7
202008;352590;G;4789007;2;0;2
202008;352590;G;4731800;0;1;-1
202008;352590;G;4520001;1;0;1
202008;352590;G;4771702;1;0;1
202008;352590;G;4649499;1;0;1
202008;352590;G;4661300;4;1;3
202008;352590;G;4520001;1;0;1
202008;352590;G;4649403;2;0;2
202008;352590;G;4511102;1;0;1
202008;352590;G;4673700;1;0;1
202008;352590;G;4744005;1;0;1
202008;352590;G;4761003;0;1;-1
202008;352590;G;4541205;1;2;-1
202008;352590;G;4647801;0;1;-1
202008;352590;G;4789099;1;0;1
202008;352590;G;4781400;0;1;-1
202008;352590;G;4789099;2;0;2
202008;352590;G;4635402;11;9;2
202008;352590;G;4781400;0;5;-5
202008;352590;G;4772500;0;1;-1
202008;352590;G;4721102;1;0;1
202008;352590;G;4741500;2;0;2
202008;352590;G;4731800;1;0;1
202008;352590;G;4530703;2;0;2
202008;352590;G;4789099;0;1;-1
202008;352590;G;4771701;2;0;2
202008;352590;G;4744005;1;1;0
202008;352590;G;4511104;0;1;-1
202008;352590;G;4633802;3;0;3
202008;352590;G;4633802;0;1;-1
202008;352590;G;4713001;1;0;1
202008;352590;G;4713004;9;1;8
202008;352590;G;4646001;1;0;1
202008;352590;G;4635402;4;13;-9
202008;352590;G;4711302;2;1;1
202008;352590;G;4771701;0;1;-1
202008;352590;G;4771701;1;0;1
202008;352590;G;4771701;1;0;1
202008;352590;G;4771701;0;1;-1
202008;352590;G;4771701;0;2;-2
202008;352590;G;4771701;0;1;-1
202008;352590;G;4771701;0;1;-1
202008;352590;G;4771701;2;1;1
202008;352590;G;4771701;1;0;1
202008;352590;G;4771701;1;1;0
202008;352590;G;4771701;1;0;1
202008;352590;G;4771701;3;0;3
202008;352590;G;4771701;0;1;-1
202008;352590;G;4771701;2;0;2
202008;352590;G;4771701;2;0;2
202008;352590;G;4771701;1;0;1
202008;352590;G;4771701;0;1;-1
202008;352590;G;4635402;3;0;3
202008;352590;G;4782202;0;2;-2
202008;352590;G;4759899;1;1;0
202008;352590;G;4789002;3;1;2
202008;352590;G;4744099;0;1;-1
202008;352590;G;4530701;1;2;-1
202008;352590;G;4711302;27;10;17
202008;352590;G;4771702;1;1;0
202008;352590;G;4684201;1;0;1
202008;352590;G;4789099;2;0;2
202008;352590;G;4771701;3;1;2
202008;352590;G;4771701;1;0;1
202008;352590;G;4771701;1;0;1
202008;352590;G;4744005;1;0;1
202008;352590;G;4729699;0;1;-1
202008;352590;G;4520001;0;1;-1
202008;352590;G;4744005;3;1;2
202008;352590;G;4623199;1;0;1
202008;352590;G;4753900;1;1;0
202008;352590;G;4771702;0;1;-1
202008;352590;G;4530703;1;0;1
202008;352590;G;4511101;9;1;8
202008;352590;G;4754702;1;0;1
202008;352590;G;4744005;1;0;1
202008;352590;G;4741500;1;0;1
202008;352590;G;4741500;0;1;-1
202008;352590;G;4741500;0;2;-2
202008;352590;G;4744005;0;1;-1
202008;352590;G;4771702;1;0;1
202008;352590;G;4663000;2;0;2
202008;352590;G;4530703;0;1;-1
202008;352590;G;4789099;0;2;-2
202008;352590;G;4731800;0;1;-1
202008;352590;G;4692300;2;1;1
202008;352590;G;4635402;0;1;-1
202008;352590;G;4789002;0;1;-1
202008;352590;G;4744099;1;1;0
202008;352590;G;4711302;2;1;1
202008;352590;G;4711301;13;11;2
202008;352590;G;4672900;12;0;12
202008;352590;G;4781400;1;0;1
202008;352590;G;4530703;3;2;1
202008;352590;G;4711301;0;2;-2
202008;352590;G;4679604;0;1;-1
202008;352590;G;4541201;1;2;-1
202008;352590;G;4783101;0;2;-2
202008;352590;G;4661300;0;1;-1
202008;352590;G;4751201;1;1;0
202008;352590;G;4781400;0;1;-1
202008;352590;G;4721102;1;0;1
202008;352590;G;4752100;1;0;1
202101;352590;G;4751201;0;1;-1
202101;352590;G;4712100;1;0;1
202101;352590;G;4744005;0;1;-1
202101;352590;G;4754703;1;0;1
202101;352590;G;4672900;3;0;3
202101;352590;G;4744001;0;1;-1
202101;352590;G;4757100;0;25;-25
202101;352590;G;4753900;2;8;-6
202101;352590;G;4721102;0;1;-1
202101;352590;G;4649404;0;1;-1
202101;352590;G;4672900;1;2;-1
202101;352590;G;4530703;1;0;1
202101;352590;G;4754701;1;1;0
202101;352590;G;4772500;1;0;1
202101;352590;G;4530703;0;1;-1
202101;352590;G;4633801;1;0;1
202101;352590;G;4763604;1;1;0
202101;352590;G;4616800;0;1;-1
202101;352590;G;4530703;1;0;1
202101;352590;G;4732600;1;0;1
202101;352590;G;4711301;18;12;6
202101;352590;G;4511101;5;5;0
202101;352590;G;4742300;0;2;-2
202101;352590;G;4644301;41;29;12
202101;352590;G;4771701;0;1;-1
202101;352590;G;4789099;1;0;1
202101;352590;G;4721102;2;1;1
202101;352590;G;4781400;2;0;2
202101;352590;G;4771701;1;2;-1
202101;352590;G;4652400;0;3;-3
202101;352590;G;4689301;0;1;-1
202101;352590;G;4751201;0;2;-2
202101;352590;G;4643502;0;2;-2
202101;352590;G;4639701;0;2;-2
202101;352590;G;4789099;0;1;-1
202101;352590;G;4721104;1;0;1
202101;352590;G;4634601;19;47;-28
202101;352590;G;4712100;0;1;-1
202101;352590;G;4712100;1;1;0
202101;352590;G;4751201;0;1;-1
202101;352590;G;4763603;1;1;0
202101;352590;G;4530701;1;0;1
202101;352590;G;4712100;1;0;1
202101;352590;G;4530702;3;1;2
202101;352590;G;4759899;0;5;-5
202101;352590;G;4763601;0;1;-1
202101;352590;G;4731800;2;0;2
202101;352590;G;4744005;1;0;1
202101;352590;G;4751201;1;1;0
202101;352590;G;4763602;1;0;1
202101;352590;G;4731800;1;0;1
202101;352590;G;4781400;0;3;-3
202101;352590;G;4511101;0;2;-2
202101;352590;G;4614100;0;1;-1
202101;352590;G;4619200;2;0;2
202101;352590;G;4530703;0;1;-1
202101;352590;G;4731800;0;1;-1
202101;352590;G;4774100;1;0;1
202101;352590;G;4511101;2;10;-8
202101;352590;G;4511101;1;3;-2
202101;352590;G;4722901;1;0;1
202101;352590;G;4684299;0;1;-1
202101;352590;G;4530705;1;0;1
202101;352590;G;4781400;0;2;-2
202101;352590;G;4722901;0;1;-1
202101;352590;G;4754701;0;1;-1
202101;352590;G;4789099;1;0;1
202101;352590;G;4754702;1;0;1
202101;352590;G;4755503;0;1;-1
202101;352590;G;4679601;0;1;-1
202101;352590;G;4782201;0;1;-1
202101;352590;G;4789001;0;1;-1
202101;352590;G;4752100;2;1;1
202101;352590;G;4752100;1;0;1
202101;352590;G;4724500;0;1;-1
202101;352590;G;4771701;0;1;-1
202101;352590;G;4689399;1;1;0
202101;352590;G;4639701;3;0;3
202101;352590;G;4744002;0;2;-2
202101;352590;G;4729699;0;1;-1
202101;352590;G;4789099;0;1;-1
202101;352590;G;4789004;0;1;-1
202101;352590;G;4646001;2;1;1
202101;352590;G;4789004;0;1;-1
202101;352590;G;4754701;1;0;1
202101;352590;G;4732600;0;1;-1
202101;352590;G;4744099;0;1;-1
202101;352590;G;4771702;1;1;0
202101;352590;G;4781400;0;6;-6
202101;352590;G;4711302;0;5;-5
202101;352590;G;4712100;1;1;0
202101;352590;G;4520005;0;2;-2
202101;352590;G;4729699;0;4;-4
202101;352590;G;4520001;0;1;-1
202101;352590;G;4759801;3;0;3
202101;352590;G;4754701;1;0;1
202101;352590;G;4754701;1;0;1
202101;352590;G;4754701;1;0;1
202101;352590;G;4774100;1;0;1
202101;352590;G;4781400;0;2;-2
202101;352590;G;4744005;2;0;2
202101;352590;G;4530702;0;1;-1
202101;352590;G;4721104;0;1;-1
202101;352590;G;4789099;1;2;-1
202101;352590;G;4637106;9;6;3
202101;352590;G;4774100;0;1;-1
202101;352590;G;4744001;0;1;-1
202101;352590;G;4649499;1;2;-1
202101;352590;G;4530703;3;1;2
202101;352590;G;4672900;3;1;2
202101;352590;G;4530703;1;1;0
202101;352590;G;4721102;1;0;1
202101;352590;G;4520001;1;0;1
202101;352590;G;4789002;1;0;1
202101;352590;G;4541202;0;1;-1
202101;352590;G;4744003;0;1;-1
202101;352590;G;4511101;2;4;-2
202101;352590;G;4743100;1;0;1
202101;352590;G;4731800;4;2;2
202101;352590;G;4639701;10;12;-2
202101;352590;G;4731800;1;0;1
202101;352590;G;4771702;2;0;2
202101;352590;G;4789002;0;2;-2
202101;352590;G;4789099;1;2;-1
202101;352590;G;4731800;0;1;-1
202101;352590;G;4759899;0;1;-1
202101;352590;G;4789007;0;2;-2
202101;352590;G;4753900;1;2;-1
202101;352590;G;4781400;0;1;-1
202101;352590;G;4773300;1;0;1
202101;352590;G;4724500;3;9;-6
202101;352590;G;4724500;0;1;-1
202101;352590;G;4511101;2;0;2
202101;352590;G;4731800;0;2;-2
202101;352590;G;4520002;2;0;2
202101;352590;G;4781400;0;1;-1
202101;352590;G;4530703;9;3;6
202101;352590;G;4731800;4;0;4
202101;352590;G;4782201;6;28;-22
202101;352590;G;4789099;0;1;-1
202101;352590;G;4723700;0;1;-1
202101;352590;G;4511101;7;5;2
202101;352590;G;4687703;0;1;-1
202101;352590;G;4744001;0;1;-1
202101;352590;G;4755502;1;2;-1
202101;352590;G;4781400;0;2;-2
202101;352590;G;4744002;1;0;1
202101;352590;G;4541203;1;0;1
202101;352590;G;4761001;0;1;-1
202101;352590;G;4721102;1;1;0
202101;352590;G;4711302;3;7;-4
202101;352590;G;4774100;3;1;2
202101;352590;G;4649499;1;0;1
202101;352590;G;4771701;0;2;-2
202101;352590;G;4721104;0;2;-2
202101;352590;G;4759899;0;1;-1
202101;352590;G;4686902;2;1;1
202101;352590;G;4744099;0;1;-1
202101;352590;G;4789099;0;1;-1
202101;352590;G;4772500;0;1;-1
202101;352590;G;4772500;0;3;-3
202101;352590;G;4741500;2;0;2
202101;352590;G;4759899;6;2;4
202101;352590;G;4759899;4;0;4
202101;352590;G;4759899;2;0;2
202101;352590;G;4759899;2;0;2
202101;352590;G;4649499;9;8;1
202101;352590;G;4761001;2;3;-1
202101;352590;G;4753900;0;1;-1
202101;352590;G;4712100;0;7;-7
202101;352590;G;4789004;0;1;-1
202101;352590;G;4789099;1;0;1
202101;352590;G;4645101;0;4;-4
202101;352590;G;4711302;3;5;-2
202101;352590;G;4711301;12;5;7
202101;352590;G;4711302;2;0;2
202101;352590;G;4511102;0;1;-1
202101;352590;G;4789002;0;1;-1
202101;352590;G;4761001;2;0;2
202101;352590;G;4759899;0;1;-1
202101;352590;G;4530703;0;1;-1
202101;352590;G;4712100;4;2;2
202101;352590;G;4789002;5;0;5
202101;352590;G;4751201;1;0;1
202101;352590;G;4763602;0;6;-6
202101;352590;G;4721102;0;1;-1
202101;352590;G;4763601;0;1;-1
202101;352590;G;4520001;1;1;0
202101;352590;G;4711302;4;10;-6
202101;352590;G;4763603;1;0;1
202101;352590;G;4731800;1;2;-1
202101;352590;G;4754701;0;1;-1
202101;352590;G;4729699;1;0;1
202101;352590;G;4530703;1;2;-1
202101;352590;G;4530703;0;1;-1
202101;352590;G;4530703;2;0;2
202101;352590;G;4722901;1;0;1
202101;352590;G;4633801;18;6;12
202101;352590;G;4744099;0;2;-2
202101;352590;G;4751201;0;1;-1
202101;352590;G;4731800;1;0;1
202101;352590;G;4722901;0;1;-1
202101;352590;G;4752100;1;0;1
202101;352590;G;4741500;2;0;2
202101;352590;G;4741500;1;0;1
202101;352590;G;4731800;2;0;2
202101;352590;G;4635402;4;1;3
202101;352590;G;4520001;0;1;-1
202101;352590;G;4754703;2;0;2
202101;352590;G;4520005;0;1;-1
202101;352590;G;4617600;1;3;-2
202101;352590;G;4721102;4;2;2
202101;352590;G;4722901;0;1;-1
202101;352590;G;4761003;2;0;2
202101;352590;G;4752100;0;1;-1
202101;352590;G;4744005;0;1;-1
202101;352590;G;4754702;0;1;-1
202101;352590;G;4712100;0;1;-1
202101;352590;G;4789001;0;1;-1
202101;352590;G;4781400;1;1;0
202101;352590;G;4511101;1;0;1
202101;352590;G;4782201;0;1;-1
202101;352590;G;4744001;1;0;1
202101;352590;G;4530703;0;1;-1
202101;352590;G;4753900;4;2;2
202101;352590;G;4753900;0;1;-1
202101;352590;G;4789099;1;0;1
202101;352590;G;4639701;1;2;-1
202101;352590;G;4530703;4;2;2
202101;352590;G;4744001;3;1;2
202101;352590;G;4686902;0;1;-1
202101;352590;G;4755502;1;0;1
202101;352590;G;4729699;0;1;-1
202101;352590;G;4729699;0;1;-1
202101;352590;G;4789099;0;1;-1
202101;352590;G;4761001;0;1;-1
202101;352590;G;4784900;0;1;-1
202101;352590;G;4731800;1;0;1
202101;352590;G;4543900;1;0;1
202101;352590;G;4530703;1;1;0
202101;352590;G;4744001;1;0;1
202101;352590;G;4763603;1;0;1
202101;352590;G;4781400;0;1;-1
202101;352590;G;4729699;3;3;0
202101;352590;G;4663000;0;1;-1
202101;352590;G;4729699;0;1;-1
202101;352590;G;4789001;1;0;1
202101;352590;G;4511101;4;1;3
202101;352590;G;4729699;1;7;-6
202101;352590;G;4755502;0;1;-1
202101;352590;G;4744003;1;0;1
202101;352590;G;4789002;0;1;-1
202101;352590;G;4789099;1;1;0
202101;352590;G;4686902;1;4;-3
202101;352590;G;4781400;1;0;1
202101;352590;G;4511101;4;2;2
202101;352590;G;4789099;1;0;1
202101;352590;G;4774100;1;0;1
202101;352590;G;4774100;0;1;-1
202101;352590;G;4754701;2;5;-3
202101;352590;G;4754701;0;1;-1
202101;352590;G;4731800;3;0;3
202101;352590;G;4754701;0;1;-1
202101;352590;G;4530703;0;2;-2
202101;352590;G;4772500;2;5;-3
202101;352590;G;4713002;1;1;0
202101;352590;G;4711302;3;2;1
202101;352590;G;4511102;1;0;1
202101;352590;G;4511101;1;1;0
202101;352590;G;4686902;1;2;-1
202101;352590;G;4724500;6;16;-10
202101;352590;G;4633801;1;1;0
202101;352590;G;4724500;9;26;-17
202101;352590;G;4691500;3;3;0
202101;352590;G;4789001;0;2;-2
202101;352590;G;4712100;1;0;1
202101;352590;G;4771701;0;2;-2
202101;352590;G;4712100;2;0;2
202101;352590;G;4511101;3;5;-2
202101;352590;G;4729699;0;1;-1
202101;352590;G;4781400;0;1;-1
202101;352590;G;4782201;1;1;0
202101;352590;G;4520004;2;1;1
202101;352590;G;4754701;2;11;-9
202101;352590;G;4713002;0;2;-2
202101;352590;G;4729699;1;0;1
202101;352590;G;4530703;1;0;1
202101;352590;G;4744003;1;0;1
202101;352590;G;4761003;1;0;1
202101;352590;G;4753900;0;1;-1
202101;352590;G;4742300;1;0;1
202101;352590;G;4721102;0;1;-1
202101;352590;G;4771701;1;3;-2
202101;352590;G;4731800;2;4;-2
202101;352590;G;4712100;0;2;-2
202101;352590;G;4645103;0;1;-1
202101;352590;G;4729699;1;1;0
202101;352590;G;4530703;1;1;0
202101;352590;G;4712100;1;1;0
202101;352590;G;4623109;1;0;1
202101;352590;G;4781400;0;230;-230
202101;352590;G;4511104;2;2;0
202101;352590;G;4789099;5;9;-4
202101;352590;G;4761003;2;0;2
202101;352590;G;4782201;0;1;-1
202101;352590;G;4781400;2;1;1
202101;352590;G;4781400;0;1;-1
202101;352590;G;4759801;1;0;1
202101;352590;G;4633801;0;1;-1
202101;352590;G;4744002;1;0;1
202101;352590;G;4520005;0;1;-1
202101;352590;G;4789005;1;0;1
202101;352590;G;4789099;1;0;1
202101;352590;G;4754701;1;1;0
202101;352590;G;4633801;1;0;1
202101;352590;G;4649499;0;4;-4
202101;352590;G;4520007;3;0;3
202101;352590;G;4744099;0;1;-1
202101;352590;G;4781400;1;3;-2
202101;352590;G;4520001;0;1;-1
202101;352590;G;4789004;1;0;1
202101;352590;G;4530703;1;1;0
202101;352590;G;4781400;0;13;-13
202101;352590;G;4781400;3;18;-15
202101;352590;G;4781400;0;7;-7
202101;352590;G;4712100;1;0;1
202101;352590;G;4772500;1;1;0
202101;352590;G;4757100;0;1;-1
202101;352590;G;4789002;1;1;0
202101;352590;G;4744005;0;1;-1
202101;352590;G;4712100;1;0;1
202101;352590;G;4781400;0;1;-1
202101;352590;G;4744099;1;0;1
202101;352590;G;4520005;0;1;-1
202101;352590;G;4782201;0;2;-2
202101;352590;G;4771701;2;0;2
202101;352590;G;4772500;0;2;-2
202101;352590;G;4772500;1;1;0
202101;352590;G;4772500;0;1;-1
202101;352590;G;4772500;0;1;-1
202101;352590;G;4530701;1;1;0
202101;352590;G;4691500;4;9;-5
202101;352590;G;4637199;3;0;3
202101;352590;G;4687702;0;1;-1
202101;352590;G;4663000;1;0;1
202101;352590;G;4763601;1;0;1
202101;352590;G;4619200;0;1;-1
202101;352590;G;4761003;2;0;2
202101;352590;G;4689399;5;2;3
202101;352590;G;4669999;4;4;0
202101;352590;G;4781400;0;2;-2
202101;352590;G;4722901;0;1;-1
202101;352590;G;4781400;0;1;-1
202101;352590;G;4686902;0;1;-1
202101;352590;G;4772500;0;4;-4
202101;352590;G;4784900;1;0;1
202101;352590;G;4731800;1;1;0
202101;352590;G;4763603;1;0;1
202101;352590;G;4763603;0;1;-1
202101;352590;G;4646001;1;1;0
202101;352590;G;4789099;2;2;0
202101;352590;G;4744001;0;1;-1
202101;352590;G;4530704;5;2;3
202101;352590;G;4789099;1;0;1
202101;352590;G;4771701;0;1;-1
202101;352590;G;4744001;0;2;-2
202101;352590;G;4754701;7;35;-28
202101;352590;G;4744099;1;0;1
202101;352590;G;4511101;0;1;-1
202101;352590;G;4759899;0;5;-5
202101;352590;G;4530703;5;0;5
202101;352590;G;4761001;2;0;2
202101;352590;G;4724500;1;1;0
202101;352590;G;4623109;2;1;1
202101;352590;G;4763601;2;0;2
202101;352590;G;4772500;1;0;1
202101;352590;G;4721104;18;3;15
202101;352590;G;4637107;36;1;35
202101;352590;G;4754701;1;1;0
202101;352590;G;4754701;1;0;1
202101;352590;G;4752100;1;0;1
202101;352590;G;4757100;2;0;2
202101;352590;G;4782201;1;2;-1
202101;352590;G;4781400;0;1;-1
202101;352590;G;4772500;2;0;2
202101;352590;G;4781400;2;0;2
202101;352590;G;4712100;1;0;1
202101;352590;G;4782201;3;8;-5
202101;352590;G;4782201;0;1;-1
202101;352590;G;4755502;1;1;0
202101;352590;G;4712100;1;0;1
202101;352590;G;4771701;0;1;-1
202101;352590;G;4751201;3;0;3
202101;352590;G;4520005;13;8;5
202101;352590;G;4781400;0;1;-1
202101;352590;G;4721104;8;1;7
202101;352590;G;4663000;8;4;4
202101;352590;G;4541201;0;1;-1
202101;352590;G;4752100;0;1;-1
202101;352590;G;4741500;1;1;0
202101;352590;G;4771702;0;1;-1
202101;352590;G;4789004;1;0;1
202101;352590;G;4752100;1;0;1
202101;352590;G;4782201;0;1;-1
202101;352590;G;4781400;0;1;-1
202101;352590;G;4634601;0;2;-2
202101;352590;G;4789004;1;1;0
202101;352590;G;4781400;1;1;0
202101;352590;G;4687702;0;1;-1
202101;352590;G;4744001;1;0;1
202101;352590;G;4732600;1;2;-1
202101;352590;G;4713002;0;1;-1
202101;352590;G;4751201;0;2;-2
202101;352590;G;4789004;1;1;0
202101;352590;G;4781400;0;1;-1
202101;352590;G;4774100;1;0;1
202101;352590;G;4783101;1;0;1
202101;352590;G;4757100;2;0;2
202101;352590;G;4724500;0;2;-2
202101;352590;G;4772500;1;0;1
202101;352590;G;4772500;2;1;1
202101;352590;G;4752100;1;0;1
202101;352590;G;4754701;1;0;1
202101;352590;G;4721102;1;0;1
202101;352590;G;4530703;1;0;1
202101;352590;G;4520001;0;3;-3
202101;352590;G;4753900;0;3;-3
202101;352590;G;4520002;0;1;-1
202101;352590;G;4789001;0;1;-1
202101;352590;G;4761001;0;2;-2
202101;352590;G;4520002;1;0;1
202101;352590;G;4652400;2;1;1
202101;352590;G;4744002;2;0;2
202101;352590;G;4530705;1;1;0
202101;352590;G;4721102;2;1;1
202101;352590;G;4721102;0;1;-1
202101;352590;G;4721102;0;1;-1
202101;352590;G;4789002;1;2;-1
202101;352590;G;4781400;1;2;-1
202101;352590;G;4744099;1;0;1
202101;352590;G;4755502;0;1;-1
202101;352590;G;4721102;1;0;1
202101;352590;G;4752100;0;1;-1
202101;352590;G;4781400;0;8;-8
202101;352590;G;4712100;0;1;-1
202101;352590;G;4781400;1;2;-1
202101;352590;G;4781400;0;1;-1
202101;352590;G;4731800;6;2;4
202101;352590;G;4772500;0;1;-1
202101;352590;G;4669999;2;3;-1
202101;352590;G;4712100;0;1;-1
202101;352590;G;4754701;0;2;-2
202101;352590;G;4712100;0;1;-1
202101;352590;G;4771701;1;1;0
202101;352590;G;4721102;1;0;1
202101;352590;G;4781400;1;0;1
202101;352590;G;4530703;1;1;0
202101;352590;G;4752100;0;1;-1
202101;352590;G;4789002;0;1;-1
202101;352590;G;4754701;0;1;-1
202101;352590;G;4645101;0;2;-2
202101;352590;G;4741500;1;0;1
202101;352590;G;4781400;1;0;1
202101;352590;G;4731800;0;1;-1
202101;352590;G;4713004;3;16;-13
202101;352590;G;4520001;2;5;-3
202101;352590;G;4774100;0;1;-1
202101;352590;G;4520001;0;1;-1
202101;352590;G;4649499;0;2;-2
202101;352590;G;4713002;1;0;1
202101;352590;G;4754701;0;1;-1
202101;352590;G;4729699;2;5;-3
202101;352590;G;4520001;1;0;1
202101;352590;G;4781400;0;1;-1
202101;352590;G;4679699;0;1;-1
202101;352590;G;4633801;1;0;1
202101;352590;G;4646001;0;2;-2
202101;352590;G;4782201;1;1;0
202101;352590;G;4781400;0;1;-1
202101;352590;G;4781400;0;1;-1
202101;352590;G;4751201;0;1;-1
202101;352590;G;4729602;0;2;-2
202101;352590;G;4679603;1;2;-1
202101;352590;G;4530703;1;3;-2
202101;352590;G;4711302;4;0;4
202101;352590;G;4751201;1;0;1
202101;352590;G;4639701;8;12;-4
202101;352590;G;4520007;1;1;0
202101;352590;G;4753900;4;8;-4
202101;352590;G;4759899;4;1;3
202101;352590;G;4754701;1;0;1
202101;352590;G;4781400;1;0;1
202101;352590;G;4723700;0;1;-1
202101;352590;G;4712100;0;1;-1
202101;352590;G;4782201;2;2;0
202101;352590;G;4530703;1;0;1
202101;352590;G;4723700;0;1;-1
202101;352590;G;4789099;1;0;1
202101;352590;G;4722901;1;0;1
202101;352590;G;4781400;1;4;-3
202101;352590;G;4724500;1;0;1
202101;352590;G;4781400;0;1;-1
202101;352590;G;4646001;1;1;0
202101;352590;G;4724500;0;1;-1
202101;352590;G;4759899;0;1;-1
202101;352590;G;4541205;1;0;1
202101;352590;G;4789099;0;1;-1
202101;352590;G;4774100;0;1;-1
202101;352590;G;4761001;5;0;5
202101;352590;G;4729699;0;1;-1
202101;352590;G;4774100;1;0;1
202101;352590;G;4774100;3;2;1
202101;352590;G;4721102;0;1;-1
202101;352590;G;4759899;0;1;-1
202101;352590;G;4724500;1;1;0
202101;352590;G;4729602;5;0;5
202101;352590;G;4712100;2;0;2
202101;352590;G;4729699;0;1;-1
202101;352590;G;4713002;1;1;0
202101;352590;G;4781400;1;1;0
202101;352590;G;4520006;3;0;3
202101;352590;G;4721102;1;2;-1
202101;352590;G;4686902;5;0;5
202101;352590;G;4771701;3;1;2
202101;352590;G;4771701;0;1;-1
202101;352590;G;4781400;0;1;-1
202101;352590;G;4729699;0;1;-1
202101;352590;G;4789004;1;0;1
202101;352590;G;4782201;0;1;-1
202101;352590;G;4782201;0;1;-1
202101;352590;G;4789099;1;0;1
202101;352590;G;4722901;1;0;1
202101;352590;G;4687702;5;5;0
202101;352590;G;4772500;2;0;2
202101;352590;G;4713004;0;6;-6
202101;352590;G;4693100;1;1;0
202101;352590;G;4520003;0;1;-1
202101;352590;G;4711302;0;1;-1
202101;352590;G;4771704;1;0;1
202101;352590;G;4781400;1;1;0
202101;352590;G;4633801;2;1;1
202101;352590;G;4729699;2;0;2
202101;352590;G;4789099;2;2;0
202101;352590;G;4729602;0;2;-2
202101;352590;G;4772500;0;1;-1
202101;352590;G;4520002;0;1;-1
202101;352590;G;4752100;1;2;-1
202101;352590;G;4530705;0;2;-2
202101;352590;G;4530705;0;1;-1
202101;352590;G;4744002;0;1;-1
202101;352590;G;4782201;0;1;-1
202101;352590;G;4772500;6;2;4
202101;352590;G;4789099;5;3;2
202101;352590;G;4789004;0;1;-1
202101;352590;G;4729699;1;0;1
202101;352590;G;4645101;1;0;1
202101;352590;G;4763601;0;1;-1
202101;352590;G;4744099;2;0;2
202101;352590;G;4511101;1;1;0
202101;352590;G;4721104;0;1;-1
202101;352590;G;4781400;0;4;-4
202101;352590;G;4781400;3;0;3
202101;352590;G;4771701;1;0;1
202101;352590;G;4623109;1;0;1
202101;352590;G;4781400;1;0;1
202101;352590;G;4781400;0;1;-1
202101;352590;G;4711301;0;7;-7
202101;352590;G;4781400;0;1;-1
202101;352590;G;4781400;0;1;-1
202101;352590;G;4754701;0;1;-1
202101;352590;G;4789099;2;0;2
202101;352590;G;4520005;0;2;-2
202101;352590;G;4781400;0;1;-1
202101;352590;G;4781400;2;1;1
202101;352590;G;4781400;1;0;1
202101;352590;G;4530703;1;0;1
202101;352590;G;4782201;0;3;-3
202101;352590;G;4530701;2;2;0
202101;352590;G;4729699;1;1;0
202101;352590;G;4774100;1;1;0
202101;352590;G;4639701;20;20;0
202101;352590;G;4520001;0;1;-1
202101;352590;G;4752100;1;0;1
202101;352590;G;4637199;8;0;8
202101;352590;G;4761003;1;0;1
202101;352590;G;4744005;0;1;-1
202101;352590;G;4713002;0;1;-1
202101;352590;G;4789002;6;2;4
202101;352590;G;4781400;0;1;-1
202101;352590;G;4742300;2;0;2
202101;352590;G;4781400;14;0;14
202101;352590;G;4712100;0;2;-2
202101;352590;G;4782201;0;1;-1
202101;352590;G;4757100;2;0;2
202101;352590;G;4773300;1;2;-1
202101;352590;G;4774100;0;1;-1
202101;352590;G;4520006;3;1;2
202101;352590;G;4711302;1;0;1
202101;352590;G;4711302;1;0;1
202101;352590;G;4752100;0;1;-1
202101;352590;G;4753900;0;2;-2
202101;352590;G;4753900;17;20;-3
202101;352590;G;4753900;2;2;0
202101;352590;G;4753900;0;3;-3
202101;352590;G;4753900;1;3;-2
202101;352590;G;4753900;16;7;9
202101;352590;G;4753900;0;2;-2
202101;352590;G;4752100;0;1;-1
202101;352590;G;4712100;1;1;0
202101;352590;G;4712100;7;2;5
202101;352590;G;4744099;2;0;2
202101;352590;G;4781400;4;5;-1
202101;352590;G;4781400;2;8;-6
202101;352590;G;4752100;3;0;3
202101;352590;G;4781400;1;1;0
202101;352590;G;4742300;2;0;2
202101;352590;G;4684299;0;1;-1
202101;352590;G;4781400;1;0;1
202101;352590;G;4637199;1;0;1
202101;352590;G;4724500;2;0;2
202101;352590;G;4752100;0;1;-1
202101;352590;G;4520001;1;0;1
202101;352590;G;4782201;0;1;-1
202101;352590;G;4763602;2;1;1
202101;352590;G;4754702;0;1;-1
202101;352590;G;4781400;2;0;2
202101;352590;G;4789007;1;0;1
202101;352590;G;4771701;0;1;-1
202101;352590;G;4669999;7;3;4
202101;352590;G;4669999;0;2;-2
202101;352590;G;4619200;1;0;1
202101;352590;G;4771701;0;1;-1
202101;352590;G;4774100;0;1;-1
202101;352590;G;4771701;0;1;-1
202101;352590;G;4530703;0;1;-1
202101;352590;G;4774100;1;0;1
202101;352590;G;4713002;1;0;1
202101;352590;G;4781400;1;3;-2
202101;352590;G;4781400;2;1;1
202101;352590;G;4731800;1;0;1
202101;352590;G;4781400;3;0;3
202101;352590;G;4781400;3;1;2
202101;352590;G;4781400;5;0;5
202101;352590;G;4530701;1;0;1
202101;352590;G;4744099;0;1;-1
202101;352590;G;4754701;1;0;1
202101;352590;G;4633801;1;1;0
202101;352590;G;4781400;1;0;1
202101;352590;G;4713002;0;3;-3
202101;352590;G;4723700;1;0;1
202101;352590;G;4761003;1;1;0
202101;352590;G;4781400;0;3;-3
202101;352590;G;4520001;1;0;1
202101;352590;G;4771701;1;1;0
202101;352590;G;4530703;5;0;5
202101;352590;G;4789099;1;0;1
202101;352590;G;4781400;0;3;-3
202101;352590;G;4789099;2;0;2
202101;352590;G;4744001;2;1;1
202101;352590;G;4784900;1;0;1
202101;352590;G;4789099;0;1;-1
202101;352590;G;4781400;2;0;2
202101;352590;G;4773300;1;0;1
202101;352590;G;4744005;0;2;-2
202101;352590;G;4781400;1;1;0
202101;352590;G;4774100;0;1;-1
202101;352590;G;4729699;1;2;-1
202101;352590;G;4686902;3;4;-1
202101;352590;G;4789001;0;1;-1
202101;352590;G;4782201;0;1;-1
202101;352590;G;4781400;0;1;-1
202101;352590;G;4530703;0;2;-2
202101;352590;G;4713001;0;1;-1
202101;352590;G;4759899;2;0;2
202101;352590;G;4729699;1;0;1
202101;352590;G;4744005;3;0;3
202101;352590;G;4741500;2;0;2
202101;352590;G;4755501;0;1;-1
202101;352590;G;4773300;1;0;1
202101;352590;G;4772500;3;0;3
202101;352590;G;4635499;3;1;2
202101;352590;G;4520005;0;1;-1
202101;352590;G;4633801;1;0;1
202101;352590;G;4783101;1;0;1
202101;352590;G;4729699;2;0;2
202101;352590;G;4520005;1;0;1
202101;352590;G;4647801;1;0;1
202101;352590;G;4774100;1;2;-1
202101;352590;G;4753900;0;1;-1
202101;352590;G;4789099;2;0;2
202101;352590;G;4530703;0;1;-1
202101;352590;G;4789099;1;0;1
202101;352590;G;4781400;0;1;-1
202101;352590;G;4781400;8;10;-2
202101;352590;G;4781400;5;2;3
202101;352590;G;4782201;0;1;-1
202101;352590;G;4782201;2;0;2
202101;352590;G;4782201;4;9;-5
202101;352590;G;4782201;1;0;1
202101;352590;G;4711301;1;6;-5
202101;352590;G;4731800;0;1;-1
202101;352590;G;4672900;1;0;1
202101;352590;G;4530705;1;0;1
202101;352590;G;4781400;1;51;-50
202101;352590;G;4744002;5;2;3
202101;352590;G;4639701;0;4;-4
202101;352590;G;4754701;1;0;1
202101;352590;G;4663000;1;0;1
202101;352590;G;4711302;3;5;-2
202101;352590;G;4711302;0;2;-2
202101;352590;G;4637107;0;1;-1
202101;352590;G;4713004;0;2;-2
202101;352590;G;4731800;1;0;1
202101;352590;G;4711302;0;1;-1
202101;352590;G;4783101;1;0;1
202101;352590;G;4784900;1;0;1
202101;352590;G;4731800;0;1;-1
202101;352590;G;4781400;0;1;-1
202101;352590;G;4772500;1;3;-2
202101;352590;G;4511102;1;0;1
202101;352590;G;4744005;0;1;-1
202101;352590;G;4731800;1;0;1
202101;352590;G;4711302;1;0;1
202101;352590;G;4731800;1;1;0
202101;352590;G;4744099;1;1;0
202101;352590;G;4530703;4;2;2
202101;352590;G;4731800;0;1;-1
202101;352590;G;4511101;2;1;1
202101;352590;G;4721102;0;1;-1
202101;352590;G;4689399;2;1;1
202101;352590;G;4729699;0;1;-1
202101;352590;G;4511104;3;2;1
202101;352590;G;4530703;0;1;-1
202101;352590;G;4541203;0;1;-1
202101;352590;G;4731800;1;2;-1
202101;352590;G;4711302;0;1;-1
202101;352590;G;4711302;1;9;-8
202101;352590;G;4711302;2;0;2
202101;352590;G;4711302;8;7;1
202101;352590;G;4711302;1;6;-5
202101;352590;G;4711302;1;3;-2
202101;352590;G;4711302;4;13;-9
202101;352590;G;4711302;4;4;0
202101;352590;G;4711302;2;6;-4
202101;352590;G;4711302;3;8;-5
202101;352590;G;4711302;0;1;-1
202101;352590;G;4711302;1;7;-6
202101;352590;G;4711302;1;6;-5
202101;352590;G;4711302;1;13;-12
202101;352590;G;4721102;1;0;1
202101;352590;G;4511101;0;1;-1
202101;352590;G;4721102;0;1;-1
202101;352590;G;4771701;1;1;0
202101;352590;G;4530703;0;1;-1
202101;352590;G;4744099;0;1;-1
202101;352590;G;4731800;0;1;-1
202101;352590;G;4711302;2;5;-3
202101;352590;G;4711302;0;6;-6
202101;352590;G;4711302;1;4;-3
202101;352590;G;4711302;2;7;-5
202101;352590;G;4711302;0;7;-7
202101;352590;G;4633801;2;7;-5
202101;352590;G;4744099;0;1;-1
202101;352590;G;4647801;1;1;0
202101;352590;G;4661300;5;4;1
202101;352590;G;4639701;3;2;1
202101;352590;G;4744099;2;1;1
202101;352590;G;4782201;1;6;-5
202101;352590;G;4782201;2;12;-10
202101;352590;G;4771702;3;6;-3
202101;352590;G;4530703;0;1;-1
202101;352590;G;4530701;1;0;1
202101;352590;G;4721102;3;1;2
202101;352590;G;4789004;1;1;0
202101;352590;G;4669999;3;3;0
202101;352590;G;4789004;1;0;1
202101;352590;G;4722901;1;0;1
202101;352590;G;4731800;0;1;-1
202101;352590;G;4712100;1;1;0
202101;352590;G;4530705;0;2;-2
202101;352590;G;4712100;1;0;1
202101;352590;G;4520001;1;0;1
202101;352590;G;4712100;0;1;-1
202101;352590;G;4712100;4;0;4
202101;352590;G;4511101;1;0;1
202101;352590;G;4687702;1;0;1
202101;352590;G;4520001;0;1;-1
202101;352590;G;4649499;5;0;5
202101;352590;G;4661300;2;1;1
202101;352590;G;4649403;1;0;1
202101;352590;G;4781400;0;1;-1
202101;352590;G;4781400;0;1;-1
202101;352590;G;4753900;2;1;1
202101;352590;G;4511102;1;0;1
202101;352590;G;4731800;1;0;1
202101;352590;G;4763602;2;2;0
202101;352590;G;4721103;0;1;-1
202101;352590;G;4789099;1;0;1
202101;352590;G;4763601;0;1;-1
202101;352590;G;4635402;8;8;0
202101;352590;G;4689399;1;0;1
202101;352590;G;4751201;0;1;-1
202101;352590;G;4755502;2;0;2
202101;352590;G;4633802;1;0;1
202101;352590;G;4731800;0;1;-1
202101;352590;G;4633801;0;1;-1
202101;352590;G;4530701;0;1;-1
202101;352590;G;4789099;0;1;-1
202101;352590;G;4530703;1;2;-1
202101;352590;G;4744005;0;1;-1
202101;352590;G;4511104;1;0;1
202101;352590;G;4713004;3;4;-1
202101;352590;G;4713004;5;2;3
202101;352590;G;4635402;2;4;-2
202101;352590;G;4711302;0;5;-5
202101;352590;G;4771701;0;1;-1
202101;352590;G;4771701;1;1;0
202101;352590;G;4771701;1;0;1
202101;352590;G;4771701;1;1;0
202101;352590;G;4771701;0;1;-1
202101;352590;G;4771701;1;0;1
202101;352590;G;4771701;0;2;-2
202101;352590;G;4771701;1;0;1
202101;352590;G;4771701;0;1;-1
202101;352590;G;4771701;0;2;-2
202101;352590;G;4771701;0;2;-2
202101;352590;G;4771701;1;0;1
202101;352590;G;4771701;0;1;-1
202101;352590;G;4782202;1;1;0
202101;352590;G;4742300;1;0;1
202101;352590;G;4637107;3;1;2
202101;352590;G;4789099;3;0;3
202101;352590;G;4789002;8;2;6
202101;352590;G;4771701;0;1;-1
202101;352590;G;4731800;1;0;1
202101;352590;G;4530703;1;0;1
202101;352590;G;4789099;0;1;-1
202101;352590;G;4781400;0;1;-1
202101;352590;G;4711302;11;35;-24
202101;352590;G;4783101;0;1;-1
202101;352590;G;4771702;1;1;0
202101;352590;G;4684201;2;0;2
202101;352590;G;4789099;0;1;-1
202101;352590;G;4771701;3;3;0
202101;352590;G;4771701;0;1;-1
202101;352590;G;4771701;1;0;1
202101;352590;G;4530703;1;0;1
202101;352590;G;4711302;0;2;-2
202101;352590;G;4729699;0;6;-6
202101;352590;G;4520001;0;1;-1
202101;352590;G;4637199;2;0;2
202101;352590;G;4741500;0;1;-1
202101;352590;G;4744005;0;1;-1
202101;352590;G;4623199;2;0;2
202101;352590;G;4721102;1;1;0
202101;352590;G;4763601;0;1;-1
202101;352590;G;4783101;0;1;-1
202101;352590;G;4712100;0;1;-1
202101;352590;G;4637199;1;2;-1
202101;352590;G;4771702;1;6;-5
202101;352590;G;4679699;1;1;0
202101;352590;G;4744005;0;1;-1
202101;352590;G;4741500;1;0;1
202101;352590;G;4741500;1;0;1
202101;352590;G;4741500;0;1;-1
202101;352590;G;4741500;1;0;1
202101;352590;G;4741500;0;1;-1
202101;352590;G;4744005;0;1;-1
202101;352590;G;4744001;0;1;-1
202101;352590;G;4633801;1;1;0
202101;352590;G;4744002;1;0;1
202101;352590;G;4663000;2;0;2
202101;352590;G;4530703;0;1;-1
202101;352590;G;4789099;1;0;1
202101;352590;G;4692300;2;1;1
202101;352590;G;4520005;6;3;3
202101;352590;G;4635402;2;1;1
202101;352590;G;4711302;1;2;-1
202101;352590;G;4754703;1;0;1
202101;352590;G;4711301;14;20;-6
202101;352590;G;4672900;3;2;1
202101;352590;G;4530703;4;4;0
202101;352590;G;4711301;5;8;-3
202101;352590;G;4639701;0;5;-5
202101;352590;G;4679604;4;4;0
202101;352590;G;4744001;0;1;-1
202101;352590;G;4781400;3;2;1
202101;352590;G;4781400;2;3;-1
202101;352590;G;4781400;1;0;1
202105;352590;G;4751201;1;1;0
202105;352590;G;4752100;0;1;-1
202105;352590;G;4772500;1;0;1
202105;352590;G;4772500;1;1;0
202105;352590;G;4672900;2;0;2
202105;352590;G;4511102;1;0;1
202105;352590;G;4789099;0;2;-2
202105;352590;G;4753900;13;3;10
202105;352590;G;4644302;1;0;1
202105;352590;G;4649406;0;4;-4
202105;352590;G;4672900;0;1;-1
202105;352590;G;4789007;0;10;-10
202105;352590;G;4530703;1;0;1
202105;352590;G;4633801;0;2;-2
202105;352590;G;4511102;1;0;1
202105;352590;G;4771702;1;0;1
202105;352590;G;4530705;0;1;-1
202105;352590;G;4530705;1;1;0
202105;352590;G;4616800;1;2;-1
202105;352590;G;4732600;1;0;1
202105;352590;G;4711301;6;5;1
202105;352590;G;4511101;0;3;-3
202105;352590;G;4742300;4;2;2
202105;352590;G;4644301;34;36;-2
202105;352590;G;4724500;0;1;-1
202105;352590;G;4721102;1;1;0
202105;352590;G;4689399;1;1;0
202105;352590;G;4530705;0;1;-1
202105;352590;G;4751201;2;1;1
202105;352590;G;4744001;2;0;2
202105;352590;G;4639701;1;2;-1
202105;352590;G;4781400;1;0;1
202105;352590;G;4789099;0;1;-1
202105;352590;G;4530703;1;1;0
202105;352590;G;4755502;0;1;-1
202105;352590;G;4712100;1;0;1
202105;352590;G;4721104;2;0;2
202105;352590;G;4687703;1;0;1
202105;352590;G;4634601;0;11;-11
202105;352590;G;4712100;1;0;1
202105;352590;G;4530701;0;1;-1
202105;352590;G;4530701;1;0;1
202105;352590;G;4530702;3;2;1
202105;352590;G;4687701;2;0;2
202105;352590;G;4759899;4;1;3
202105;352590;G;4751201;2;1;1
202105;352590;G;4763602;2;1;1
202105;352590;G;4731800;0;1;-1
202105;352590;G;4754701;1;0;1
202105;352590;G;4781400;2;0;2
202105;352590;G;4511101;0;3;-3
202105;352590;G;4789099;1;0;1
202105;352590;G;4773300;0;2;-2
202105;352590;G;4731800;1;0;1
202105;352590;G;4763601;1;1;0
202105;352590;G;4789004;1;0;1
202105;352590;G;4511101;0;2;-2
202105;352590;G;4511101;2;1;1
202105;352590;G;4511102;1;0;1
202105;352590;G;4722901;1;2;-1
202105;352590;G;4520001;1;0;1
202105;352590;G;4772500;0;2;-2
202105;352590;G;4722901;1;0;1
202105;352590;G;4755503;1;1;0
202105;352590;G;4789001;1;0;1
202105;352590;G;4789099;4;0;4
202105;352590;G;4771702;3;0;3
202105;352590;G;4731800;1;0;1
202105;352590;G;4771701;1;0;1
202105;352590;G;4752100;1;0;1
202105;352590;G;4752100;4;2;2
202105;352590;G;4639701;4;0;4
202105;352590;G;4633801;0;1;-1
202105;352590;G;4781400;1;0;1
202105;352590;G;4646001;0;1;-1
202105;352590;G;4759899;0;2;-2
202105;352590;G;4754701;0;1;-1
202105;352590;G;4744099;4;1;3
202105;352590;G;4781400;1;4;-3
202105;352590;G;4711302;1;0;1
202105;352590;G;4711302;3;2;1
202105;352590;G;4712100;1;1;0
202105;352590;G;4520001;1;0;1
202105;352590;G;4520005;0;1;-1
202105;352590;G;4789099;0;1;-1
202105;352590;G;4722901;1;0;1
202105;352590;G;4759801;0;1;-1
202105;352590;G;4724500;2;0;2
202105;352590;G;4754701;0;1;-1
202105;352590;G;4781400;1;0;1
202105;352590;G;4744005;0;5;-5
202105;352590;G;4789099;0;1;-1
202105;352590;G;4744005;1;0;1
202105;352590;G;4637106;1;1;0
202105;352590;G;4646001;0;2;-2
202105;352590;G;4781400;1;0;1
202105;352590;G;4672900;1;6;-5
202105;352590;G;4789099;0;1;-1
202105;352590;G;4672900;1;0;1
202105;352590;G;4721102;0;1;-1
202105;352590;G;4782202;0;2;-2
202105;352590;G;4511101;1;2;-1
202105;352590;G;4639701;8;6;2
202105;352590;G;4729699;1;0;1
202105;352590;G;4731800;0;2;-2
202105;352590;G;4781400;0;1;-1
202105;352590;G;4751201;0;1;-1
202105;352590;G;4789007;0;23;-23
202105;352590;G;4771702;0;1;-1
202105;352590;G;4789099;0;1;-1
202105;352590;G;4530703;1;0;1
202105;352590;G;4530703;1;0;1
202105;352590;G;4759899;1;0;1
202105;352590;G;4520001;2;0;2
202105;352590;G;4789007;11;1;10
202105;352590;G;4753900;1;1;0
202105;352590;G;4789099;1;0;1
202105;352590;G;4771701;0;1;-1
202105;352590;G;4724500;0;4;-4
202105;352590;G;4782201;4;0;4
202105;352590;G;4511101;1;1;0
202105;352590;G;4672900;0;2;-2
202105;352590;G;4520002;2;0;2
202105;352590;G;4744005;1;0;1
202105;352590;G;4763601;1;2;-1
202105;352590;G;4744002;0;2;-2
202105;352590;G;4530703;3;4;-1
202105;352590;G;4731800;1;2;-1
202105;352590;G;4782201;3;1;2
202105;352590;G;4511101;3;5;-2
202105;352590;G;4789001;0;1;-1
202105;352590;G;4687703;0;1;-1
202105;352590;G;4722901;0;1;-1
202105;352590;G;4781400;1;0;1
202105;352590;G;4755502;3;0;3
202105;352590;G;4781400;1;0;1
202105;352590;G;4772500;0;1;-1
202105;352590;G;4541203;1;0;1
202105;352590;G;4639701;1;1;0
202105;352590;G;4721102;1;0;1
202105;352590;G;4731800;0;1;-1
202105;352590;G;4774100;1;0;1
202105;352590;G;4530703;1;0;1
202105;352590;G;4687702;2;0;2
202105;352590;G;4693100;1;1;0
202105;352590;G;4711302;5;5;0
202105;352590;G;4774100;1;1;0
202105;352590;G;4753900;1;0;1
202105;352590;G;4771701;1;1;0
202105;352590;G;4744099;1;0;1
202105;352590;G;4623109;9;0;9
202105;352590;G;4741500;0;1;-1
202105;352590;G;4639701;1;0;1
202105;352590;G;4530703;0;1;-1
202105;352590;G;4759899;0;1;-1
202105;352590;G;4649499;5;0;5
202105;352590;G;4744099;0;1;-1
202105;352590;G;4520001;1;1;0
202105;352590;G;4712100;4;4;0
202105;352590;G;4645101;2;0;2
202105;352590;G;4711302;1;4;-3
202105;352590;G;4711301;12;11;1
202105;352590;G;4711302;0;3;-3
202105;352590;G;4761001;0;2;-2
202105;352590;G;4781400;1;0;1
202105;352590;G;4530703;1;3;-2
202105;352590;G;4712100;7;1;6
202105;352590;G;4530703;1;0;1
202105;352590;G;4752100;1;0;1
202105;352590;G;4763602;5;0;5
202105;352590;G;4763601;3;1;2
202105;352590;G;4687702;1;1;0
202105;352590;G;4633801;1;0;1
202105;352590;G;4711302;8;10;-2
202105;352590;G;4713002;2;1;1
202105;352590;G;4731800;2;3;-1
202105;352590;G;4754702;1;0;1
202105;352590;G;4771701;2;1;1
202105;352590;G;4530703;0;1;-1
202105;352590;G;4781400;0;3;-3
202105;352590;G;4530703;0;2;-2
202105;352590;G;4633801;0;3;-3
202105;352590;G;4744099;1;0;1
202105;352590;G;4751201;1;1;0
202105;352590;G;4685100;1;1;0
202105;352590;G;4731800;1;1;0
202105;352590;G;4761001;1;0;1
202105;352590;G;4771701;0;1;-1
202105;352590;G;4771701;1;0;1
202105;352590;G;4789099;0;1;-1
202105;352590;G;4781400;1;2;-1
202105;352590;G;4741500;1;1;0
202105;352590;G;4741500;1;0;1
202105;352590;G;4741500;2;0;2
202105;352590;G;4731800;2;0;2
202105;352590;G;4635402;3;1;2
202105;352590;G;4520001;0;1;-1
202105;352590;G;4617600;1;0;1
202105;352590;G;4721102;1;0;1
202105;352590;G;4722901;0;1;-1
202105;352590;G;4761003;1;1;0
202105;352590;G;4752100;1;0;1
202105;352590;G;4744005;1;0;1
202105;352590;G;4712100;0;2;-2
202105;352590;G;4781400;1;0;1
202105;352590;G;4511101;0;1;-1
202105;352590;G;4782201;1;1;0
202105;352590;G;4753900;3;5;-2
202105;352590;G;4753900;0;2;-2
202105;352590;G;4789099;1;1;0
202105;352590;G;4789002;2;0;2
202105;352590;G;4639701;1;0;1
202105;352590;G;4744001;1;0;1
202105;352590;G;4530703;1;1;0
202105;352590;G;4731800;0;1;-1
202105;352590;G;4686902;1;1;0
202105;352590;G;4761001;0;1;-1
202105;352590;G;4729699;1;0;1
202105;352590;G;4744099;0;1;-1
202105;352590;G;4789004;0;1;-1
202105;352590;G;4713002;0;1;-1
202105;352590;G;4731800;1;0;1
202105;352590;G;4530703;1;3;-2
202105;352590;G;4744001;2;0;2
202105;352590;G;4789004;0;1;-1
202105;352590;G;4781400;0;1;-1
202105;352590;G;4729699;3;1;2
202105;352590;G;4663000;1;1;0
202105;352590;G;4511101;2;3;-1
202105;352590;G;4530703;1;0;1
202105;352590;G;4729699;1;9;-8
202105;352590;G;4789002;3;0;3
202105;352590;G;4754703;1;0;1
202105;352590;G;4789099;2;1;1
202105;352590;G;4686902;7;5;2
202105;352590;G;4759899;0;1;-1
202105;352590;G;4511101;2;2;0
202105;352590;G;4729699;0;1;-1
202105;352590;G;4781400;0;1;-1
202105;352590;G;4754701;5;9;-4
202105;352590;G;4754701;0;3;-3
202105;352590;G;4754701;1;5;-4
202105;352590;G;4687703;0;1;-1
202105;352590;G;4731800;4;3;1
202105;352590;G;4789005;0;1;-1
202105;352590;G;4712100;0;1;-1
202105;352590;G;4754701;1;1;0
202105;352590;G;4781400;0;1;-1
202105;352590;G;4757100;2;1;1
202105;352590;G;4771701;0;1;-1
202105;352590;G;4772500;6;4;2
202105;352590;G;4722901;1;0;1
202105;352590;G;4686902;3;1;2
202105;352590;G;4724500;5;11;-6
202105;352590;G;4633801;1;0;1
202105;352590;G;4724500;4;10;-6
202105;352590;G;4772500;0;1;-1
202105;352590;G;4691500;1;6;-5
202105;352590;G;4520006;0;1;-1
202105;352590;G;4731800;1;3;-2
202105;352590;G;4511101;0;1;-1
202105;352590;G;4511101;3;5;-2
202105;352590;G;4731800;0;1;-1
202105;352590;G;4520004;1;2;-1
202105;352590;G;4754701;53;2;51
202105;352590;G;4754701;1;0;1
202105;352590;G;4713002;1;0;1
202105;352590;G;4530703;1;0;1
202105;352590;G;4742300;1;0;1
202105;352590;G;4744003;1;2;-1
202105;352590;G;4789099;2;2;0
202105;352590;G;4771701;1;0;1
202105;352590;G;4721102;1;0;1
202105;352590;G;4789004;0;1;-1
202105;352590;G;4732600;0;1;-1
202105;352590;G;4635499;0;1;-1
202105;352590;G;4731800;2;0;2
202105;352590;G;4712100;2;2;0
202105;352590;G;4687703;0;1;-1
202105;352590;G;4651601;1;0;1
202105;352590;G;4646001;1;1;0
202105;352590;G;4712100;3;1;2
202105;352590;G;4669999;1;0;1
202105;352590;G;4623109;3;1;2
202105;352590;G;4781400;5;5;0
202105;352590;G;4511104;0;1;-1
202105;352590;G;4789099;1;2;-1
202105;352590;G;4761003;0;1;-1
202105;352590;G;4789004;1;0;1
202105;352590;G;4781400;2;1;1
202105;352590;G;4781400;2;0;2
202105;352590;G;4771701;0;1;-1
202105;352590;G;4744002;1;1;0
202105;352590;G;4751201;1;0;1
202105;352590;G;4773300;0;1;-1
202105;352590;G;4771701;1;0;1
202105;352590;G;4633801;0;1;-1
202105;352590;G;4649499;1;1;0
202105;352590;G;4520007;2;1;1
202105;352590;G;4782201;0;4;-4
202105;352590;G;4633801;0;1;-1
202105;352590;G;4713002;1;2;-1
202105;352590;G;4744001;1;0;1
202105;352590;G;4721102;2;1;1
202105;352590;G;4781400;4;1;3
202105;352590;G;4751201;1;0;1
202105;352590;G;4722901;0;1;-1
202105;352590;G;4663000;1;0;1
202105;352590;G;4789004;1;0;1
202105;352590;G;4731800;0;3;-3
202105;352590;G;4761001;0;1;-1
202105;352590;G;4782201;2;1;1
202105;352590;G;4781400;4;9;-5
202105;352590;G;4781400;1;3;-2
202105;352590;G;4712100;0;2;-2
202105;352590;G;4729602;0;1;-1
202105;352590;G;4744005;1;0;1
202105;352590;G;4744001;0;1;-1
202105;352590;G;4783101;1;0;1
202105;352590;G;4711302;1;0;1
202105;352590;G;4755503;0;1;-1
202105;352590;G;4712100;2;0;2
202105;352590;G;4781400;1;0;1
202105;352590;G;4744099;1;0;1
202105;352590;G;4759899;0;1;-1
202105;352590;G;4712100;0;1;-1
202105;352590;G;4754701;1;1;0
202105;352590;G;4761002;0;2;-2
202105;352590;G;4530701;1;0;1
202105;352590;G;4530703;1;0;1
202105;352590;G;4757100;0;1;-1
202105;352590;G;4691500;4;6;-2
202105;352590;G;4743100;1;0;1
202105;352590;G;4637199;0;1;-1
202105;352590;G;4687702;1;1;0
202105;352590;G;4663000;1;0;1
202105;352590;G;4729699;1;1;0
202105;352590;G;4637199;2;1;1
202105;352590;G;4689399;0;2;-2
202105;352590;G;4669999;5;1;4
202105;352590;G;4530703;1;0;1
202105;352590;G;4783101;1;0;1
202105;352590;G;4756300;0;1;-1
202105;352590;G;4722901;1;0;1
202105;352590;G;4781400;1;0;1
202105;352590;G;4781400;2;0;2
202105;352590;G;4686902;4;0;4
202105;352590;G;4744005;1;0;1
202105;352590;G;4731800;1;0;1
202105;352590;G;4763603;0;1;-1
202105;352590;G;4763603;0;2;-2
202105;352590;G;4646001;3;1;2
202105;352590;G;4789099;3;2;1
202105;352590;G;4530704;2;3;-1
202105;352590;G;4789099;1;1;0
202105;352590;G;4530705;0;1;-1
202105;352590;G;4781400;1;0;1
202105;352590;G;4754701;25;3;22
202105;352590;G;4771702;1;0;1
202105;352590;G;4772500;0;1;-1
202105;352590;G;4771701;0;1;-1
202105;352590;G;4530703;1;0;1
202105;352590;G;4761001;2;2;0
202105;352590;G;4789004;1;0;1
202105;352590;G;4781400;1;0;1
202105;352590;G;4724500;1;1;0
202105;352590;G;4623109;1;0;1
202105;352590;G;4623109;0;1;-1
202105;352590;G;4763601;0;1;-1
202105;352590;G;4781400;3;2;1
202105;352590;G;4772500;0;1;-1
202105;352590;G;4741500;1;1;0
202105;352590;G;4721104;4;4;0
202105;352590;G;4637107;2;0;2
202105;352590;G;4754701;0;1;-1
202105;352590;G;4744002;0;1;-1
202105;352590;G;4744005;0;4;-4
202105;352590;G;4721104;1;1;0
202105;352590;G;4781400;1;0;1
202105;352590;G;4782201;0;3;-3
202105;352590;G;4771701;1;1;0
202105;352590;G;4781400;0;1;-1
202105;352590;G;4712100;0;1;-1
202105;352590;G;4782201;3;0;3
202105;352590;G;4781400;0;1;-1
202105;352590;G;4782201;1;0;1
202105;352590;G;4759899;0;1;-1
202105;352590;G;4754701;1;0;1
202105;352590;G;4752100;2;2;0
202105;352590;G;4623101;1;0;1
202105;352590;G;4721104;1;1;0
202105;352590;G;4789099;1;0;1
202105;352590;G;4754701;2;1;1
202105;352590;G;4781400;1;0;1
202105;352590;G;4742300;1;0;1
202105;352590;G;4774100;1;1;0
202105;352590;G;4751201;1;1;0
202105;352590;G;4729699;0;1;-1
202105;352590;G;4520005;15;2;13
202105;352590;G;4721104;1;0;1
202105;352590;G;4721104;3;3;0
202105;352590;G;4744005;0;1;-1
202105;352590;G;4772500;0;2;-2
202105;352590;G;4663000;2;3;-1
202105;352590;G;4541201;0;1;-1
202105;352590;G;4752100;1;0;1
202105;352590;G;4614100;2;0;2
202105;352590;G;4771702;5;3;2
202105;352590;G;4789099;2;0;2
202105;352590;G;4782201;0;1;-1
202105;352590;G;4618499;2;0;2
202105;352590;G;4752100;3;0;3
202105;352590;G;4789002;0;1;-1
202105;352590;G;4634601;1;2;-1
202105;352590;G;4783102;1;1;0
202105;352590;G;4789004;6;3;3
202105;352590;G;4639701;0;1;-1
202105;352590;G;4713002;1;0;1
202105;352590;G;4520005;0;1;-1
202105;352590;G;4744001;1;0;1
202105;352590;G;4732600;2;1;1
202105;352590;G;4789004;2;0;2
202105;352590;G;4781400;1;0;1
202105;352590;G;4757100;0;1;-1
202105;352590;G;4724500;1;0;1
202105;352590;G;4772500;1;0;1
202105;352590;G;4782201;0;1;-1
202105;352590;G;4781400;1;0;1
202105;352590;G;4772500;1;0;1
202105;352590;G;4530703;1;1;0
202105;352590;G;4530703;1;0;1
202105;352590;G;4520001;2;0;2
202105;352590;G;4782202;1;0;1
202105;352590;G;4520002;0;3;-3
202105;352590;G;4789001;0;1;-1
202105;352590;G;4721102;1;0;1
202105;352590;G;4637199;0;2;-2
202105;352590;G;4761001;0;1;-1
202105;352590;G;4652400;4;0;4
202105;352590;G;4744002;1;1;0
202105;352590;G;4530703;1;0;1
202105;352590;G;4530705;1;0;1
202105;352590;G;4721102;8;3;5
202105;352590;G;4721102;0;1;-1
202105;352590;G;4781400;1;0;1
202105;352590;G;4789002;1;0;1
202105;352590;G;4754701;1;0;1
202105;352590;G;4642701;0;1;-1
202105;352590;G;4721102;3;0;3
202105;352590;G;4781400;0;4;-4
202105;352590;G;4752100;1;0;1
202105;352590;G;4663000;1;0;1
202105;352590;G;4781400;0;1;-1
202105;352590;G;4712100;1;1;0
202105;352590;G;4781400;1;2;-1
202105;352590;G;4782202;0;1;-1
202105;352590;G;4723700;0;1;-1
202105;352590;G;4772500;0;6;-6
202105;352590;G;4669999;17;8;9
202105;352590;G;4712100;1;1;0
202105;352590;G;4672900;1;0;1
202105;352590;G;4712100;1;0;1
202105;352590;G;4721102;1;0;1
202105;352590;G;4724500;0;1;-1
202105;352590;G;4763601;2;0;2
202105;352590;G;4744001;0;1;-1
202105;352590;G;4645101;3;3;0
202105;352590;G;4741500;1;0;1
202105;352590;G;4722901;1;0;1
202105;352590;G;4721102;0;1;-1
202105;352590;G;4789099;0;1;-1
202105;352590;G;4729699;1;0;1
202105;352590;G;4713004;5;2;3
202105;352590;G;4774100;0;1;-1
202105;352590;G;4752100;1;0;1
202105;352590;G;4754701;1;0;1
202105;352590;G;4731800;0;2;-2
202105;352590;G;4729699;0;1;-1
202105;352590;G;4781400;1;0;1
202105;352590;G;4520002;1;0;1
202105;352590;G;4712100;0;1;-1
202105;352590;G;4781400;1;0;1
202105;352590;G;4772500;0;1;-1
202105;352590;G;4771701;1;0;1
202105;352590;G;4729602;1;0;1
202105;352590;G;4530703;1;0;1
202105;352590;G;4679603;1;2;-1
202105;352590;G;4633801;0;1;-1
202105;352590;G;4530703;2;0;2
202105;352590;G;4711302;2;2;0
202105;352590;G;4751201;0;1;-1
202105;352590;G;4639701;3;3;0
202105;352590;G;4530703;1;0;1
202105;352590;G;4712100;2;1;1
202105;352590;G;4753900;2;5;-3
202105;352590;G;4530704;2;0;2
202105;352590;G;4781400;1;0;1
202105;352590;G;4753900;0;1;-1
202105;352590;G;4789001;0;1;-1
202105;352590;G;4530703;0;1;-1
202105;352590;G;4723700;1;0;1
202105;352590;G;4757100;1;0;1
202105;352590;G;4781400;1;0;1
202105;352590;G;4729699;0;1;-1
202105;352590;G;4637199;2;3;-1
202105;352590;G;4761003;0;1;-1
202105;352590;G;4754702;1;0;1
202105;352590;G;4633801;0;1;-1
202105;352590;G;4781400;1;0;1
202105;352590;G;4511102;1;0;1
202105;352590;G;4520007;0;1;-1
202105;352590;G;4771701;1;0;1
202105;352590;G;4789099;1;1;0
202105;352590;G;4729699;0;2;-2
202105;352590;G;4789099;1;0;1
202105;352590;G;4729699;1;0;1
202105;352590;G;4774100;1;0;1
202105;352590;G;4721102;2;0;2
202105;352590;G;4759899;0;2;-2
202105;352590;G;4724500;0;1;-1
202105;352590;G;4729602;3;1;2
202105;352590;G;4712100;1;1;0
202105;352590;G;4724500;0;2;-2
202105;352590;G;4721103;1;0;1
202105;352590;G;4781400;2;1;1
202105;352590;G;4520006;1;0;1
202105;352590;G;4721102;1;0;1
202105;352590;G;4729699;2;0;2
202105;352590;G;4789001;0;1;-1
202105;352590;G;4686902;1;0;1
202105;352590;G;4771701;1;0;1
202105;352590;G;4771701;1;1;0
202105;352590;G;4781400;1;0;1
202105;352590;G;4781400;1;0;1
202105;352590;G;4789004;0;2;-2
202105;352590;G;4789004;0;2;-2
202105;352590;G;4754701;2;0;2
202105;352590;G;4783101;0;1;-1
202105;352590;G;4722901;1;0;1
202105;352590;G;4722901;2;0;2
202105;352590;G;4687702;0;1;-1
202105;352590;G;4772500;1;0;1
202105;352590;G;4520003;1;0;1
202105;352590;G;4771701;1;0;1
202105;352590;G;4711302;1;0;1
202105;352590;G;4664800;0;1;-1
202105;352590;G;4721102;1;0;1
202105;352590;G;4771704;1;0;1
202105;352590;G;4633801;0;1;-1
202105;352590;G;4649410;0;1;-1
202105;352590;G;4520002;2;1;1
202105;352590;G;4729699;1;1;0
202105;352590;G;4789099;1;1;0
202105;352590;G;4729699;0;1;-1
202105;352590;G;4729699;4;0;4
202105;352590;G;4772500;1;0;1
202105;352590;G;4763601;0;1;-1
202105;352590;G;4789099;0;1;-1
202105;352590;G;4752100;1;0;1
202105;352590;G;4729699;0;1;-1
202105;352590;G;4753900;1;0;1
202105;352590;G;4789099;1;0;1
202105;352590;G;4782201;1;1;0
202105;352590;G;4781400;1;0;1
202105;352590;G;4772500;5;2;3
202105;352590;G;4637106;1;0;1
202105;352590;G;4721104;1;1;0
202105;352590;G;4789099;0;1;-1
202105;352590;G;4781400;1;1;0
202105;352590;G;4781400;1;0;1
202105;352590;G;4781400;0;1;-1
202105;352590;G;4744001;1;0;1
202105;352590;G;4755503;0;1;-1
202105;352590;G;4774100;0;1;-1
202105;352590;G;4744099;0;2;-2
202105;352590;G;4511101;1;0;1
202105;352590;G;4744003;1;1;0
202105;352590;G;4784900;1;0;1
202105;352590;G;4781400;0;1;-1
202105;352590;G;4711301;7;4;3
202105;352590;G;4511102;2;0;2
202105;352590;G;4774100;0;1;-1
202105;352590;G;4783101;4;1;3
202105;352590;G;4789004;0;1;-1
202105;352590;G;4711302;0;2;-2
202105;352590;G;4783102;0;2;-2
202105;352590;G;4754701;0;1;-1
202105;352590;G;4713002;0;1;-1
202105;352590;G;4789099;0;1;-1
202105;352590;G;4520005;0;1;-1
202105;352590;G;4781400;5;0;5
202105;352590;G;4724500;1;1;0
202105;352590;G;4782201;2;1;1
202105;352590;G;4729699;1;0;1
202105;352590;G;4789001;0;1;-1
202105;352590;G;4639701;2;4;-2
202105;352590;G;4637199;11;2;9
202105;352590;G;4744005;0;1;-1
202105;352590;G;4789099;1;0;1
202105;352590;G;4721104;3;1;2
202105;352590;G;4724500;0;1;-1
202105;352590;G;4713002;2;0;2
202105;352590;G;4789002;1;3;-2
202105;352590;G;4781400;0;1;-1
202105;352590;G;4781400;0;1;-1
202105;352590;G;4781400;0;1;-1
202105;352590;G;4712100;3;0;3
202105;352590;G;4781400;1;0;1
202105;352590;G;4761003;0;1;-1
202105;352590;G;4782201;1;0;1
202105;352590;G;4711302;0;3;-3
202105;352590;G;4520005;1;0;1
202105;352590;G;4773300;4;1;3
202105;352590;G;4530703;1;0;1
202105;352590;G;4752100;1;1;0
202105;352590;G;4711302;4;3;1
202105;352590;G;4753900;37;13;24
202105;352590;G;4753900;0;1;-1
202105;352590;G;4753900;1;4;-3
202105;352590;G;4753900;9;13;-4
202105;352590;G;4753900;0;1;-1
202105;352590;G;4753900;0;1;-1
202105;352590;G;4712100;3;1;2
202105;352590;G;4712100;1;0;1
202105;352590;G;4781400;2;4;-2
202105;352590;G;4781400;14;3;11
202105;352590;G;4752100;1;2;-1
202105;352590;G;4520005;0;1;-1
202105;352590;G;4781400;0;1;-1
202105;352590;G;4742300;0;1;-1
202105;352590;G;4752100;1;0;1
202105;352590;G;4752100;1;0;1
202105;352590;G;4637199;0;1;-1
202105;352590;G;4724500;2;1;1
202105;352590;G;4789005;1;1;0
202105;352590;G;4752100;1;0;1
202105;352590;G;4782201;0;1;-1
202105;352590;G;4783101;1;0;1
202105;352590;G;4520002;1;0;1
202105;352590;G;4763602;5;0;5
202105;352590;G;4785799;4;0;4
202105;352590;G;4771701;0;1;-1
202105;352590;G;4789004;0;2;-2
202105;352590;G;4669999;4;6;-2
202105;352590;G;4669999;3;2;1
202105;352590;G;4729602;2;1;1
202105;352590;G;4754702;0;1;-1
202105;352590;G;4619200;0;1;-1
202105;352590;G;4782201;1;1;0
202105;352590;G;4722901;0;1;-1
202105;352590;G;4511101;0;1;-1
202105;352590;G;4763602;1;0;1
202105;352590;G;4520003;1;0;1
202105;352590;G;4774100;0;1;-1
202105;352590;G;4774100;1;0;1
202105;352590;G;4781400;3;1;2
202105;352590;G;4721102;0;1;-1
202105;352590;G;4781400;1;0;1
202105;352590;G;4731800;3;1;2
202105;352590;G;4781400;1;0;1
202105;352590;G;4781400;2;1;1
202105;352590;G;4781400;1;0;1
202105;352590;G;4520005;1;0;1
202105;352590;G;4774100;3;1;2
202105;352590;G;4723700;1;0;1
202105;352590;G;4789099;2;0;2
202105;352590;G;4781400;0;4;-4
202105;352590;G;4520001;0;1;-1
202105;352590;G;4771701;1;0;1
202105;352590;G;4782201;1;0;1
202105;352590;G;4530703;0;2;-2
202105;352590;G;4723700;0;1;-1
202105;352590;G;4781400;1;0;1
202105;352590;G;4789099;2;0;2
202105;352590;G;4781400;3;0;3
202105;352590;G;4781400;1;0;1
202105;352590;G;4759899;1;2;-1
202105;352590;G;4744005;0;3;-3
202105;352590;G;4782201;1;1;0
202105;352590;G;4783101;0;1;-1
202105;352590;G;4772500;0;1;-1
202105;352590;G;4686902;15;1;14
202105;352590;G;4541203;0;1;-1
202105;352590;G;4723700;1;0;1
202105;352590;G;4637106;0;1;-1
202105;352590;G;4713001;2;1;1
202105;352590;G;4744005;1;1;0
202105;352590;G;4744001;1;0;1
202105;352590;G;4772500;1;1;0
202105;352590;G;4635499;6;2;4
202105;352590;G;4633801;1;2;-1
202105;352590;G;4637107;0;1;-1
202105;352590;G;4669999;3;0;3
202105;352590;G;4669999;0;1;-1
202105;352590;G;4772500;2;0;2
202105;352590;G;4520005;1;0;1
202105;352590;G;4763602;5;0;5
202105;352590;G;4721102;0;1;-1
202105;352590;G;4721104;3;0;3
202105;352590;G;4789001;1;0;1
202105;352590;G;4752100;4;0;4
202105;352590;G;4774100;1;2;-1
202105;352590;G;4753900;0;1;-1
202105;352590;G;4772500;1;2;-1
202105;352590;G;4744005;0;1;-1
202105;352590;G;4530703;0;1;-1
202105;352590;G;4530703;0;1;-1
202105;352590;G;4781400;0;3;-3
202105;352590;G;4781400;4;0;4
202105;352590;G;4781400;2;1;1
202105;352590;G;4530703;1;0;1
202105;352590;G;4782201;0;1;-1
202105;352590;G;4782201;2;1;1
202105;352590;G;4711301;12;6;6
202105;352590;G;4731800;5;4;1
202105;352590;G;4771701;0;1;-1
202105;352590;G;4744005;0;1;-1
202105;352590;G;4781400;2;1;1
202105;352590;G;4744002;1;0;1
202105;352590;G;4639701;2;2;0
202105;352590;G;4731800;0;1;-1
202105;352590;G;4781400;0;1;-1
202105;352590;G;4781400;1;0;1
202105;352590;G;4711302;1;0;1
202105;352590;G;4711302;5;4;1
202105;352590;G;4789002;1;0;1
202105;352590;G;4713004;1;2;-1
202105;352590;G;4713004;1;0;1
202105;352590;G;4731800;0;1;-1
202105;352590;G;4731800;0;1;-1
202105;352590;G;4711302;1;0;1
202105;352590;G;4530703;0;1;-1
202105;352590;G;4712100;1;0;1
202105;352590;G;4731800;1;0;1
202105;352590;G;4781400;1;0;1
202105;352590;G;4772500;0;1;-1
202105;352590;G;4530703;0;1;-1
202105;352590;G;4755503;1;0;1
202105;352590;G;4731800;2;2;0
202105;352590;G;4616800;0;3;-3
202105;352590;G;4711302;2;1;1
202105;352590;G;4731800;2;0;2
202105;352590;G;4530703;1;0;1
202105;352590;G;4731800;0;1;-1
202105;352590;G;4511101;0;1;-1
202105;352590;G;4689399;0;1;-1
202105;352590;G;4729699;1;1;0
202105;352590;G;4672900;0;2;-2
202105;352590;G;4744005;1;0;1
202105;352590;G;4721102;1;0;1
202105;352590;G;4731800;2;1;1
202105;352590;G;4711302;1;0;1
202105;352590;G;4711302;6;4;2
202105;352590;G;4711302;2;4;-2
202105;352590;G;4711302;10;5;5
202105;352590;G;4731800;5;0;5
202105;352590;G;4711302;9;5;4
202105;352590;G;4711302;1;2;-1
202105;352590;G;4711302;16;7;9
202105;352590;G;4711302;8;2;6
202105;352590;G;4711302;7;7;0
202105;352590;G;4639701;3;1;2
202105;352590;G;4711302;7;8;-1
202105;352590;G;4711302;2;1;1
202105;352590;G;4711302;5;9;-4
202105;352590;G;4711302;2;6;-4
202105;352590;G;4711302;3;7;-4
202105;352590;G;4511101;2;2;0
202105;352590;G;4771701;1;1;0
202105;352590;G;4711302;5;4;1
202105;352590;G;4711302;8;3;5
202105;352590;G;4711302;0;3;-3
202105;352590;G;4711302;2;1;1
202105;352590;G;4711302;6;5;1
202105;352590;G;4633801;6;3;3
202105;352590;G;4759899;0;1;-1
202105;352590;G;4541203;1;0;1
202105;352590;G;4647801;3;2;1
202105;352590;G;4661300;5;7;-2
202105;352590;G;4771702;0;1;-1
202105;352590;G;4744099;1;0;1
202105;352590;G;4782201;1;0;1
202105;352590;G;4771702;5;3;2
202105;352590;G;4755502;0;1;-1
202105;352590;G;4744001;0;1;-1
202105;352590;G;4721102;4;3;1
202105;352590;G;4789004;6;2;4
202105;352590;G;4669999;1;2;-1
202105;352590;G;4761003;0;1;-1
202105;352590;G;4520006;2;1;1
202105;352590;G;4781400;1;0;1
202105;352590;G;4530705;0;1;-1
202105;352590;G;4520001;2;1;1
202105;352590;G;4712100;2;0;2
202105;352590;G;4520001;0;1;-1
202105;352590;G;4744002;0;2;-2
202105;352590;G;4729699;1;1;0
202105;352590;G;4712100;0;2;-2
202105;352590;G;4712100;1;5;-4
202105;352590;G;4530703;1;1;0
202105;352590;G;4511101;14;10;4
202105;352590;G;4687702;0;1;-1
202105;352590;G;4789007;2;0;2
202105;352590;G;4520001;1;0;1
202105;352590;G;4744005;1;0;1
202105;352590;G;4789099;1;0;1
202105;352590;G;4721102;0;1;-1
202105;352590;G;4781400;0;1;-1
202105;352590;G;4753900;2;2;0
202105;352590;G;4744005;1;0;1
202105;352590;G;4530703;0;1;-1
202105;352590;G;4541205;1;1;0
202105;352590;G;4774100;1;0;1
202105;352590;G;4771701;1;1;0
202105;352590;G;4712100;0;1;-1
202105;352590;G;4530703;0;2;-2
202105;352590;G;4761003;2;1;1
202105;352590;G;4789099;0;2;-2
202105;352590;G;4763601;0;2;-2
202105;352590;G;4771702;1;0;1
202105;352590;G;4763601;1;1;0
202105;352590;G;4635402;8;7;1
202105;352590;G;4520001;0;1;-1
202105;352590;G;4689399;1;1;0
202105;352590;G;4721102;2;1;1
202105;352590;G;4751201;0;1;-1
202105;352590;G;4731800;0;2;-2
202105;352590;G;4530703;1;0;1
202105;352590;G;4743100;0;1;-1
202105;352590;G;4729699;1;0;1
202105;352590;G;4530701;1;0;1
202105;352590;G;4771701;1;0;1
202105;352590;G;4744005;0;1;-1
202105;352590;G;4633802;2;1;1
202105;352590;G;4713004;4;5;-1
202105;352590;G;4635402;0;1;-1
202105;352590;G;4647801;5;0;5
202105;352590;G;4711302;6;4;2
202105;352590;G;4771701;1;1;0
202105;352590;G;4771701;3;3;0
202105;352590;G;4771701;1;1;0
202105;352590;G;4771701;0;1;-1
202105;352590;G;4771701;1;1;0
202105;352590;G;4771701;2;0;2
202105;352590;G;4771701;1;0;1
202105;352590;G;4771701;1;1;0
202105;352590;G;4771701;2;0;2
202105;352590;G;4771701;1;0;1
202105;352590;G;4771701;1;0;1
202105;352590;G;4771701;0;1;-1
202105;352590;G;4771701;1;2;-1
202105;352590;G;4771701;2;1;1
202105;352590;G;4771701;0;1;-1
202105;352590;G;4771701;1;0;1
202105;352590;G;4771701;1;0;1
202105;352590;G;4771701;1;1;0
202105;352590;G;4771701;1;0;1
202105;352590;G;4743100;1;0;1
202105;352590;G;4782202;3;5;-2
202105;352590;G;4759899;2;1;1
202105;352590;G;4637107;1;1;0
202105;352590;G;4789002;15;4;11
202105;352590;G;4744099;1;0;1
202105;352590;G;4530701;1;2;-1
202105;352590;G;4755503;1;0;1
202105;352590;G;4530703;0;1;-1
202105;352590;G;4771701;0;1;-1
202105;352590;G;4759899;2;0;2
202105;352590;G;4789099;0;1;-1
202105;352590;G;4731800;1;0;1
202105;352590;G;4782201;0;1;-1
202105;352590;G;4530701;1;0;1
202105;352590;G;4711302;25;33;-8
202105;352590;G;4783101;0;1;-1
202105;352590;G;4771702;3;0;3
202105;352590;G;4684201;0;1;-1
202105;352590;G;4771701;1;1;0
202105;352590;G;4771701;0;1;-1
202105;352590;G;4771701;2;1;1
202105;352590;G;4754701;1;0;1
202105;352590;G;4744005;1;0;1
202105;352590;G;4530703;0;1;-1
202105;352590;G;4711302;2;1;1
202105;352590;G;4729699;5;1;4
202105;352590;G;4721102;0;2;-2
202105;352590;G;4781400;1;0;1
202105;352590;G;4623199;0;2;-2
202105;352590;G;4530703;0;1;-1
202105;352590;G;4763601;2;1;1
202105;352590;G;4520007;1;0;1
202105;352590;G;4712100;1;0;1
202105;352590;G;4722901;1;0;1
202105;352590;G;4771702;3;2;1
202105;352590;G;4771701;0;1;-1
202105;352590;G;4744005;1;0;1
202105;352590;G;4741500;2;1;1
202105;352590;G;4741500;3;1;2
202105;352590;G;4741500;0;1;-1
202105;352590;G;4741500;4;1;3
202105;352590;G;4744005;1;0;1
202105;352590;G;4663000;1;0;1
202105;352590;G;4761001;1;0;1
202105;352590;G;4789099;0;1;-1
202105;352590;G;4731800;0;1;-1
202105;352590;G;4692300;6;7;-1
202105;352590;G;4761002;2;0;2
202105;352590;G;4635402;0;1;-1
202105;352590;G;4711302;2;1;1
202105;352590;G;4729699;1;0;1
202105;352590;G;4711301;7;4;3
202105;352590;G;4672900;5;4;1
202105;352590;G;4757100;1;0;1
202105;352590;G;4781400;1;1;0
202105;352590;G;4530703;2;2;0
202105;352590;G;4711301;13;8;5
202105;352590;G;4639701;9;1;8
202105;352590;G;4679604;9;5;4
202105;352590;G;4541201;3;1;2
202105;352590;G;4783101;0;1;-1
202105;352590;G;4781400;1;1;0
202105;352590;G;4752100;1;1;0
202011;352590;G;4751201;1;1;0
202011;352590;G;4752100;1;0;1
202011;352590;G;4744005;1;1;0
202011;352590;G;4744001;1;0;1
202011;352590;G;4789099;0;2;-2
202011;352590;G;4753900;5;0;5
202011;352590;G;4721102;0;1;-1
202011;352590;G;4672900;1;0;1
202011;352590;G;4731800;0;1;-1
202011;352590;G;4721102;1;0;1
202011;352590;G;4772500;1;0;1
202011;352590;G;4633801;0;2;-2
202011;352590;G;4771702;1;0;1
202011;352590;G;4616800;1;0;1
202011;352590;G;4772500;0;1;-1
202011;352590;G;4732600;0;1;-1
202011;352590;G;4693100;14;10;4
202011;352590;G;4511101;1;2;-1
202011;352590;G;4742300;2;1;1
202011;352590;G;4644301;22;24;-2
202011;352590;G;4781400;1;0;1
202011;352590;G;4771701;0;1;-1
202011;352590;G;4752100;0;1;-1
202011;352590;G;4789099;0;1;-1
202011;352590;G;4721102;0;1;-1
202011;352590;G;4689399;1;2;-1
202011;352590;G;4652400;2;1;1
202011;352590;G;4772500;1;0;1
202011;352590;G;4530703;1;0;1
202011;352590;G;4744001;0;1;-1
202011;352590;G;4639701;1;1;0
202011;352590;G;4755502;0;1;-1
202011;352590;G;4721104;0;1;-1
202011;352590;G;4634601;66;20;46
202011;352590;G;4712100;0;1;-1
202011;352590;G;4763603;0;1;-1
202011;352590;G;4744005;1;2;-1
202011;352590;G;4530701;2;1;1
202011;352590;G;4530702;1;3;-2
202011;352590;G;4687703;1;2;-1
202011;352590;G;4763601;2;0;2
202011;352590;G;4639701;8;6;2
202011;352590;G;4751201;0;1;-1
202011;352590;G;4763602;1;2;-1
202011;352590;G;4781400;2;0;2
202011;352590;G;4511101;4;3;1
202011;352590;G;4731800;1;0;1
202011;352590;G;4619200;0;1;-1
202011;352590;G;4731800;0;2;-2
202011;352590;G;4541205;1;0;1
202011;352590;G;4511101;4;5;-1
202011;352590;G;4511101;1;2;-1
202011;352590;G;4511102;0;1;-1
202011;352590;G;4721104;1;1;0
202011;352590;G;4744005;0;1;-1
202011;352590;G;4684299;0;1;-1
202011;352590;G;4772500;3;0;3
202011;352590;G;4781400;4;0;4
202011;352590;G;4731800;0;1;-1
202011;352590;G;4754701;1;0;1
202011;352590;G;4789099;0;1;-1
202011;352590;G;4754702;0;1;-1
202011;352590;G;4713001;2;0;2
202011;352590;G;4679601;5;0;5
202011;352590;G;4789001;2;0;2
202011;352590;G;4789001;2;0;2
202011;352590;G;4789001;0;2;-2
202011;352590;G;4789099;0;1;-1
202011;352590;G;4771701;1;0;1
202011;352590;G;4752100;4;4;0
202011;352590;G;4752100;2;1;1
202011;352590;G;4724500;0;1;-1
202011;352590;G;4724500;0;1;-1
202011;352590;G;4771701;0;1;-1
202011;352590;G;4639701;1;0;1
202011;352590;G;4744002;0;1;-1
202011;352590;G;4646001;7;7;0
202011;352590;G;4772500;3;0;3
202011;352590;G;4744099;2;1;1
202011;352590;G;4781400;1;0;1
202011;352590;G;4754701;1;0;1
202011;352590;G;4711302;1;0;1
202011;352590;G;4711302;0;2;-2
202011;352590;G;4520005;2;0;2
202011;352590;G;4520001;2;0;2
202011;352590;G;4744001;1;0;1
202011;352590;G;4751201;0;2;-2
202011;352590;G;4724500;0;1;-1
202011;352590;G;4754701;0;1;-1
202011;352590;G;4633801;0;3;-3
202011;352590;G;4781400;0;1;-1
202011;352590;G;4744005;1;0;1
202011;352590;G;4789099;0;2;-2
202011;352590;G;4637106;4;7;-3
202011;352590;G;4774100;1;0;1
202011;352590;G;4649499;3;0;3
202011;352590;G;4781400;1;0;1
202011;352590;G;4530703;4;1;3
202011;352590;G;4774100;0;1;-1
202011;352590;G;4661300;0;1;-1
202011;352590;G;4742300;2;0;2
202011;352590;G;4530703;1;0;1
202011;352590;G;4520001;2;0;2
202011;352590;G;4782202;1;0;1
202011;352590;G;4782202;1;0;1
202011;352590;G;4511101;1;0;1
202011;352590;G;4743100;1;2;-1
202011;352590;G;4731800;5;2;3
202011;352590;G;4639701;6;8;-2
202011;352590;G;4731800;1;0;1
202011;352590;G;4789007;1;0;1
202011;352590;G;4731800;0;1;-1
202011;352590;G;4789099;0;2;-2
202011;352590;G;4731800;1;1;0
202011;352590;G;4520001;1;0;1
202011;352590;G;4789007;8;1;7
202011;352590;G;4686902;0;1;-1
202011;352590;G;4753900;1;1;0
202011;352590;G;4724500;19;4;15
202011;352590;G;4712100;1;1;0
202011;352590;G;4511101;1;1;0
202011;352590;G;4712100;0;1;-1
202011;352590;G;4731800;0;1;-1
202011;352590;G;4789099;1;0;1
202011;352590;G;4520002;0;1;-1
202011;352590;G;4729699;2;3;-1
202011;352590;G;4729699;1;0;1
202011;352590;G;4530703;2;3;-1
202011;352590;G;4782201;16;5;11
202011;352590;G;4784900;0;1;-1
202011;352590;G;4724500;0;1;-1
202011;352590;G;4789099;1;0;1
202011;352590;G;4511101;3;2;1
202011;352590;G;4789001;1;0;1
202011;352590;G;4729699;1;1;0
202011;352590;G;4722901;0;1;-1
202011;352590;G;4781400;1;1;0
202011;352590;G;4755502;2;0;2
202011;352590;G;4755502;0;1;-1
202011;352590;G;4731800;2;0;2
202011;352590;G;4752100;1;0;1
202011;352590;G;4639701;1;0;1
202011;352590;G;4712100;1;0;1
202011;352590;G;4774100;2;0;2
202011;352590;G;4744003;0;1;-1
202011;352590;G;4693100;2;2;0
202011;352590;G;4711302;11;15;-4
202011;352590;G;4774100;2;0;2
202011;352590;G;4753900;1;0;1
202011;352590;G;4649499;1;1;0
202011;352590;G;4771701;1;1;0
202011;352590;G;4721104;1;0;1
202011;352590;G;4772500;3;0;3
202011;352590;G;4772500;3;0;3
202011;352590;G;4781400;1;1;0
202011;352590;G;4639701;2;0;2
202011;352590;G;4759899;6;4;2
202011;352590;G;4759899;1;0;1
202011;352590;G;4649499;2;0;2
202011;352590;G;4520001;1;1;0
202011;352590;G;4753900;0;1;-1
202011;352590;G;4645101;3;0;3
202011;352590;G;4711302;12;6;6
202011;352590;G;4711301;29;12;17
202011;352590;G;4711302;0;1;-1
202011;352590;G;4511102;1;0;1
202011;352590;G;4530703;1;1;0
202011;352590;G;4761001;3;1;2
202011;352590;G;4530703;1;0;1
202011;352590;G;4530703;1;0;1
202011;352590;G;4721102;1;0;1
202011;352590;G;4753900;1;0;1
202011;352590;G;4712100;4;2;2
202011;352590;G;4789002;3;5;-2
202011;352590;G;4763602;2;2;0
202011;352590;G;4781400;3;0;3
202011;352590;G;4687702;0;1;-1
202011;352590;G;4520001;1;1;0
202011;352590;G;4633801;1;0;1
202011;352590;G;4711302;11;7;4
202011;352590;G;4731800;1;1;0
202011;352590;G;4649410;1;0;1
202011;352590;G;4771701;1;0;1
202011;352590;G;4771701;0;1;-1
202011;352590;G;4729699;1;1;0
202011;352590;G;4781400;0;3;-3
202011;352590;G;4530703;1;1;0
202011;352590;G;4774100;1;0;1
202011;352590;G;4722901;2;0;2
202011;352590;G;4633801;5;11;-6
202011;352590;G;4687703;1;0;1
202011;352590;G;4685100;1;1;0
202011;352590;G;4713002;1;0;1
202011;352590;G;4731800;1;1;0
202011;352590;G;4530703;0;1;-1
202011;352590;G;4771701;4;2;2
202011;352590;G;4744003;0;1;-1
202011;352590;G;4652400;1;0;1
202011;352590;G;4744003;1;0;1
202011;352590;G;4722901;0;1;-1
202011;352590;G;4781400;1;0;1
202011;352590;G;4741500;0;2;-2
202011;352590;G;4741500;1;0;1
202011;352590;G;4741500;1;1;0
202011;352590;G;4731800;1;2;-1
202011;352590;G;4635402;4;11;-7
202011;352590;G;4744002;0;1;-1
202011;352590;G;4520001;1;0;1
202011;352590;G;4772500;0;2;-2
202011;352590;G;4520001;1;0;1
202011;352590;G;4754703;4;0;4
202011;352590;G;4617600;0;2;-2
202011;352590;G;4721102;3;1;2
202011;352590;G;4731800;1;1;0
202011;352590;G;4722901;2;0;2
202011;352590;G;4771702;1;2;-1
202011;352590;G;4761003;0;1;-1
202011;352590;G;4712100;1;1;0
202011;352590;G;4712100;0;1;-1
202011;352590;G;4789099;2;0;2
202011;352590;G;4781400;1;0;1
202011;352590;G;4511101;1;1;0
202011;352590;G;4782201;1;0;1
202011;352590;G;4782201;1;0;1
202011;352590;G;4729699;1;0;1
202011;352590;G;4530703;1;0;1
202011;352590;G;4753900;10;0;10
202011;352590;G;4753900;1;0;1
202011;352590;G;4789002;0;1;-1
202011;352590;G;4639701;1;1;0
202011;352590;G;4781400;1;0;1
202011;352590;G;4731800;0;1;-1
202011;352590;G;4744001;1;1;0
202011;352590;G;4755502;1;0;1
202011;352590;G;4520001;1;0;1
202011;352590;G;4729699;0;1;-1
202011;352590;G;4761001;0;1;-1
202011;352590;G;4729699;1;1;0
202011;352590;G;4723700;1;0;1
202011;352590;G;4752100;0;1;-1
202011;352590;G;4752100;1;0;1
202011;352590;G;4731800;1;0;1
202011;352590;G;4771701;0;1;-1
202011;352590;G;4530703;3;6;-3
202011;352590;G;4744001;4;2;2
202011;352590;G;4763603;1;0;1
202011;352590;G;4729699;1;1;0
202011;352590;G;4721104;0;2;-2
202011;352590;G;4511101;1;0;1
202011;352590;G;4782201;2;1;1
202011;352590;G;4729699;1;2;-1
202011;352590;G;4789002;1;0;1
202011;352590;G;4774100;0;1;-1
202011;352590;G;4744001;1;0;1
202011;352590;G;4686902;5;7;-2
202011;352590;G;4759899;2;1;1
202011;352590;G;4781400;0;1;-1
202011;352590;G;4511101;9;2;7
202011;352590;G;4789099;0;1;-1
202011;352590;G;4774100;0;1;-1
202011;352590;G;4754701;0;3;-3
202011;352590;G;4754701;3;0;3
202011;352590;G;4759899;1;1;0
202011;352590;G;4789005;3;1;2
202011;352590;G;4754701;0;1;-1
202011;352590;G;4782201;0;1;-1
202011;352590;G;4530703;1;0;1
202011;352590;G;4663000;1;0;1
202011;352590;G;4713002;2;0;2
202011;352590;G;4711302;1;0;1
202011;352590;G;4511102;0;1;-1
202011;352590;G;4511101;2;0;2
202011;352590;G;4686902;2;0;2
202011;352590;G;4724500;13;14;-1
202011;352590;G;4633801;2;3;-1
202011;352590;G;4724500;14;16;-2
202011;352590;G;4781400;1;0;1
202011;352590;G;4721102;0;2;-2
202011;352590;G;4772500;1;0;1
202011;352590;G;4691500;5;3;2
202011;352590;G;4721103;0;1;-1
202011;352590;G;4689399;0;1;-1
202011;352590;G;4761003;1;0;1
202011;352590;G;4520007;1;0;1
202011;352590;G;4520005;0;1;-1
202011;352590;G;4618402;13;3;10
202011;352590;G;4771701;0;1;-1
202011;352590;G;4712100;2;0;2
202011;352590;G;4511101;1;2;-1
202011;352590;G;4731800;1;1;0
202011;352590;G;4782201;3;0;3
202011;352590;G;4754701;52;7;45
202011;352590;G;4789004;0;1;-1
202011;352590;G;4772500;1;0;1
202011;352590;G;4789099;1;0;1
202011;352590;G;4771701;1;0;1
202011;352590;G;4731800;2;0;2
202011;352590;G;4712100;0;2;-2
202011;352590;G;4645101;1;1;0
202011;352590;G;4646001;1;1;0
202011;352590;G;4530703;1;0;1
202011;352590;G;4712100;0;1;-1
202011;352590;G;4520001;0;1;-1
202011;352590;G;4623109;3;2;1
202011;352590;G;4623109;2;0;2
202011;352590;G;4781400;0;13;-13
202011;352590;G;4511104;3;1;2
202011;352590;G;4789099;4;3;1
202011;352590;G;4761003;0;1;-1
202011;352590;G;4782201;3;0;3
202011;352590;G;4781400;6;0;6
202011;352590;G;4781400;7;0;7
202011;352590;G;4633801;0;1;-1
202011;352590;G;4744002;1;0;1
202011;352590;G;4663000;0;3;-3
202011;352590;G;4789005;1;0;1
202011;352590;G;4744005;0;2;-2
202011;352590;G;4773300;1;0;1
202011;352590;G;4781400;1;0;1
202011;352590;G;4633801;1;0;1
202011;352590;G;4771701;0;1;-1
202011;352590;G;4731800;0;1;-1
202011;352590;G;4649499;1;3;-2
202011;352590;G;4649401;0;1;-1
202011;352590;G;4782201;3;1;2
202011;352590;G;4782201;5;0;5
202011;352590;G;4782201;9;0;9
202011;352590;G;4721102;0;1;-1
202011;352590;G;4789002;0;1;-1
202011;352590;G;4781400;0;1;-1
202011;352590;G;4722901;1;0;1
202011;352590;G;4781400;1;0;1
202011;352590;G;4789004;1;0;1
202011;352590;G;4511102;1;1;0
202011;352590;G;4713002;0;1;-1
202011;352590;G;4729699;0;1;-1
202011;352590;G;4530703;1;0;1
202011;352590;G;4781400;3;1;2
202011;352590;G;4761001;3;0;3
202011;352590;G;4781400;7;1;6
202011;352590;G;4781400;28;7;21
202011;352590;G;4781400;8;3;5
202011;352590;G;4712100;0;1;-1
202011;352590;G;4772500;2;0;2
202011;352590;G;4752100;1;0;1
202011;352590;G;4783101;1;1;0
202011;352590;G;4711302;2;0;2
202011;352590;G;4755503;1;0;1
202011;352590;G;4772500;1;2;-1
202011;352590;G;4781400;1;0;1
202011;352590;G;4744099;2;0;2
202011;352590;G;4520005;0;2;-2
202011;352590;G;4771701;0;1;-1
202011;352590;G;4729699;0;2;-2
202011;352590;G;4743100;1;0;1
202011;352590;G;4781400;1;0;1
202011;352590;G;4772500;1;0;1
202011;352590;G;4772500;1;0;1
202011;352590;G;4530701;1;1;0
202011;352590;G;4691500;10;8;2
202011;352590;G;4743100;0;1;-1
202011;352590;G;4637199;1;0;1
202011;352590;G;4637199;0;3;-3
202011;352590;G;4619200;1;0;1
202011;352590;G;4712100;1;1;0
202011;352590;G;4761003;6;0;6
202011;352590;G;4689399;4;0;4
202011;352590;G;4520002;1;0;1
202011;352590;G;4669999;4;2;2
202011;352590;G;4763601;0;1;-1
202011;352590;G;4781400;1;0;1
202011;352590;G;4744005;1;0;1
202011;352590;G;4781400;1;1;0
202011;352590;G;4781400;2;0;2
202011;352590;G;4686902;2;0;2
202011;352590;G;4772500;5;2;3
202011;352590;G;4530703;1;1;0
202011;352590;G;4731800;0;1;-1
202011;352590;G;4763603;2;1;1
202011;352590;G;4763603;2;1;1
202011;352590;G;4646001;1;0;1
202011;352590;G;4763601;0;1;-1
202011;352590;G;4789099;4;2;2
202011;352590;G;4672900;1;0;1
202011;352590;G;4530704;5;1;4
202011;352590;G;4530705;1;0;1
202011;352590;G;4771701;1;1;0
202011;352590;G;4744001;0;1;-1
202011;352590;G;4754701;29;11;18
202011;352590;G;4771702;2;1;1
202011;352590;G;4759899;6;0;6
202011;352590;G;4781400;1;0;1
202011;352590;G;4721102;1;0;1
202011;352590;G;4530703;1;1;0
202011;352590;G;4761001;3;3;0
202011;352590;G;4724500;0;1;-1
202011;352590;G;4623109;1;1;0
202011;352590;G;4763601;1;3;-2
202011;352590;G;4772500;0;2;-2
202011;352590;G;4741500;1;0;1
202011;352590;G;4774100;1;0;1
202011;352590;G;4520001;1;0;1
202011;352590;G;4721104;1;5;-4
202011;352590;G;4754701;0;2;-2
202011;352590;G;4752100;3;0;3
202011;352590;G;4757100;0;1;-1
202011;352590;G;4721104;1;0;1
202011;352590;G;4783101;1;0;1
202011;352590;G;4772500;1;0;1
202011;352590;G;4782201;1;4;-3
202011;352590;G;4771701;4;0;4
202011;352590;G;4781400;1;0;1
202011;352590;G;4520002;2;1;1
202011;352590;G;4712100;1;0;1
202011;352590;G;4782201;5;0;5
202011;352590;G;4782201;3;2;1
202011;352590;G;4759899;0;1;-1
202011;352590;G;4721102;0;1;-1
202011;352590;G;4789099;1;0;1
202011;352590;G;4774100;2;0;2
202011;352590;G;4751201;1;0;1
202011;352590;G;4781400;1;0;1
202011;352590;G;4520005;0;3;-3
202011;352590;G;4781400;1;0;1
202011;352590;G;4721104;1;0;1
202011;352590;G;4721104;1;0;1
202011;352590;G;4752100;1;0;1
202011;352590;G;4741500;1;0;1
202011;352590;G;4614100;1;0;1
202011;352590;G;4771702;1;2;-1
202011;352590;G;4789099;1;1;0
202011;352590;G;4744002;1;0;1
202011;352590;G;4618499;0;1;-1
202011;352590;G;4789099;1;0;1
202011;352590;G;4754701;0;1;-1
202011;352590;G;4789004;4;2;2
202011;352590;G;4687702;1;1;0
202011;352590;G;4732600;2;2;0
202011;352590;G;4782201;0;1;-1
202011;352590;G;4782201;1;1;0
202011;352590;G;4642701;1;0;1
202011;352590;G;4751201;1;0;1
202011;352590;G;4530703;1;0;1
202011;352590;G;4774100;2;0;2
202011;352590;G;4722901;1;1;0
202011;352590;G;4724500;2;1;1
202011;352590;G;4772500;1;0;1
202011;352590;G;4772500;2;0;2
202011;352590;G;4781400;1;0;1
202011;352590;G;4781400;0;1;-1
202011;352590;G;4789004;1;0;1
202011;352590;G;4721102;1;0;1
202011;352590;G;4530703;1;1;0
202011;352590;G;4771701;1;1;0
202011;352590;G;4752100;0;1;-1
202011;352590;G;4520001;1;1;0
202011;352590;G;4753900;1;1;0
202011;352590;G;4789001;3;0;3
202011;352590;G;4637199;1;1;0
202011;352590;G;4722901;0;1;-1
202011;352590;G;4752100;2;0;2
202011;352590;G;4752100;3;1;2
202011;352590;G;4530703;1;0;1
202011;352590;G;4729699;1;0;1
202011;352590;G;4530705;1;0;1
202011;352590;G;4721102;2;1;1
202011;352590;G;4721102;1;0;1
202011;352590;G;4781400;2;2;0
202011;352590;G;4781400;1;0;1
202011;352590;G;4781400;2;1;1
202011;352590;G;4752100;1;0;1
202011;352590;G;4781400;4;0;4
202011;352590;G;4781400;0;1;-1
202011;352590;G;4782202;1;0;1
202011;352590;G;4731800;3;1;2
202011;352590;G;4713002;0;1;-1
202011;352590;G;4669999;7;4;3
202011;352590;G;4712100;0;1;-1
202011;352590;G;4754701;1;0;1
202011;352590;G;4712100;0;1;-1
202011;352590;G;4789001;1;0;1
202011;352590;G;4712100;1;0;1
202011;352590;G;4789003;1;0;1
202011;352590;G;4530703;1;3;-2
202011;352590;G;4789002;2;0;2
202011;352590;G;4645101;1;3;-2
202011;352590;G;4741500;1;0;1
202011;352590;G;4722901;2;0;2
202011;352590;G;4721102;2;0;2
202011;352590;G;4530703;2;0;2
202011;352590;G;4744099;0;1;-1
202011;352590;G;4731800;2;0;2
202011;352590;G;4713001;22;4;18
202011;352590;G;4783101;0;1;-1
202011;352590;G;4731800;0;2;-2
202011;352590;G;4751201;1;0;1
202011;352590;G;4520001;1;0;1
202011;352590;G;4729699;12;44;-32
202011;352590;G;4520001;3;0;3
202011;352590;G;4789099;0;1;-1
202011;352590;G;4744003;0;1;-1
202011;352590;G;4742300;3;0;3
202011;352590;G;4729699;2;0;2
202011;352590;G;4782201;3;2;1
202011;352590;G;4781400;1;2;-1
202011;352590;G;4783101;0;1;-1
202011;352590;G;4772500;0;1;-1
202011;352590;G;4633801;0;1;-1
202011;352590;G;4530703;1;0;1
202011;352590;G;4781400;1;0;1
202011;352590;G;4711302;1;2;-1
202011;352590;G;4639701;22;7;15
202011;352590;G;4520007;0;1;-1
202011;352590;G;4712100;1;1;0
202011;352590;G;4753900;3;5;-2
202011;352590;G;4753900;1;0;1
202011;352590;G;4731800;1;0;1
202011;352590;G;4520005;0;1;-1
202011;352590;G;4781400;9;0;9
202011;352590;G;4712100;0;1;-1
202011;352590;G;4789002;2;1;1
202011;352590;G;4782201;1;1;0
202011;352590;G;4723700;1;0;1
202011;352590;G;4722901;0;1;-1
202011;352590;G;4744099;2;0;2
202011;352590;G;4633801;0;1;-1
202011;352590;G;4781400;1;1;0
202011;352590;G;4755502;2;0;2
202011;352590;G;4744099;2;0;2
202011;352590;G;4722901;1;0;1
202011;352590;G;4781400;1;0;1
202011;352590;G;4781400;0;1;-1
202011;352590;G;4789099;1;0;1
202011;352590;G;4646001;3;1;2
202011;352590;G;4530703;2;1;1
202011;352590;G;4755502;2;1;1
202011;352590;G;4789099;1;0;1
202011;352590;G;4729699;1;1;0
202011;352590;G;4774100;2;1;1
202011;352590;G;4530703;0;1;-1
202011;352590;G;4759899;3;0;3
202011;352590;G;4724500;1;0;1
202011;352590;G;4729699;2;1;1
202011;352590;G;4713002;0;1;-1
202011;352590;G;4721103;2;0;2
202011;352590;G;4781400;3;1;2
202011;352590;G;4729699;0;1;-1
202011;352590;G;4721104;0;1;-1
202011;352590;G;4520006;0;2;-2
202011;352590;G;4721102;1;2;-1
202011;352590;G;4686902;2;0;2
202011;352590;G;4781400;1;0;1
202011;352590;G;4781400;1;0;1
202011;352590;G;4789004;2;1;1
202011;352590;G;4782201;1;0;1
202011;352590;G;4687702;3;0;3
202011;352590;G;4772500;1;1;0
202011;352590;G;4713001;1;0;1
202011;352590;G;4783101;3;0;3
202011;352590;G;4520003;0;1;-1
202011;352590;G;4789004;0;1;-1
202011;352590;G;4729699;1;0;1
202011;352590;G;4543900;1;0;1
202011;352590;G;4729699;3;0;3
202011;352590;G;4729699;0;5;-5
202011;352590;G;4722901;0;1;-1
202011;352590;G;4732600;1;0;1
202011;352590;G;4789099;1;0;1
202011;352590;G;4729699;1;0;1
202011;352590;G;4721104;1;1;0
202011;352590;G;4783102;1;0;1
202011;352590;G;4772500;1;0;1
202011;352590;G;4520002;1;0;1
202011;352590;G;4789099;1;0;1
202011;352590;G;4752100;1;0;1
202011;352590;G;4781400;0;1;-1
202011;352590;G;4782201;3;0;3
202011;352590;G;4772500;4;0;4
202011;352590;G;4789099;2;3;-1
202011;352590;G;4789004;0;1;-1
202011;352590;G;4781400;1;0;1
202011;352590;G;4721102;1;2;-1
202011;352590;G;4763601;1;0;1
202011;352590;G;4511101;1;2;-1
202011;352590;G;4530705;2;3;-1
202011;352590;G;4721104;1;0;1
202011;352590;G;4772500;1;0;1
202011;352590;G;4723700;2;2;0
202011;352590;G;4784900;0;1;-1
202011;352590;G;4692300;1;0;1
202011;352590;G;4781400;1;0;1
202011;352590;G;4781400;1;0;1
202011;352590;G;4729699;0;1;-1
202011;352590;G;4771701;1;0;1
202011;352590;G;4711301;6;6;0
202011;352590;G;4781400;1;1;0
202011;352590;G;4783101;1;0;1
202011;352590;G;4789004;1;1;0
202011;352590;G;4711302;2;1;1
202011;352590;G;4712100;0;1;-1
202011;352590;G;4731800;1;2;-1
202011;352590;G;4520005;2;4;-2
202011;352590;G;4781400;0;1;-1
202011;352590;G;4781400;1;1;0
202011;352590;G;4782202;1;1;0
202011;352590;G;4530703;1;1;0
202011;352590;G;4781400;1;1;0
202011;352590;G;4774100;1;0;1
202011;352590;G;4520001;0;1;-1
202011;352590;G;4637199;7;0;7
202011;352590;G;4723700;1;0;1
202011;352590;G;4744005;1;0;1
202011;352590;G;4729699;0;1;-1
202011;352590;G;4511101;0;1;-1
202011;352590;G;4781400;0;1;-1
202011;352590;G;4642701;1;0;1
202011;352590;G;4713002;1;1;0
202011;352590;G;4789002;3;0;3
202011;352590;G;4781400;3;0;3
202011;352590;G;4781400;1;0;1
202011;352590;G;4781400;1;0;1
202011;352590;G;4742300;2;1;1
202011;352590;G;4530703;0;1;-1
202011;352590;G;4712100;1;0;1
202011;352590;G;4771701;2;0;2
202011;352590;G;4742300;4;0;4
202011;352590;G;4711302;0;1;-1
202011;352590;G;4520005;1;0;1
202011;352590;G;4773300;2;0;2
202011;352590;G;4530703;1;0;1
202011;352590;G;4744099;1;0;1
202011;352590;G;4729699;1;0;1
202011;352590;G;4520006;4;0;4
202011;352590;G;4711302;11;1;10
202011;352590;G;4711302;5;0;5
202011;352590;G;4753900;1;1;0
202011;352590;G;4753900;49;56;-7
202011;352590;G;4753900;9;1;8
202011;352590;G;4753900;11;5;6
202011;352590;G;4753900;2;1;1
202011;352590;G;4753900;17;20;-3
202011;352590;G;4753900;2;0;2
202011;352590;G;4753900;2;1;1
202011;352590;G;4712100;1;0;1
202011;352590;G;4712100;3;2;1
202011;352590;G;4781400;3;3;0
202011;352590;G;4781400;5;2;3
202011;352590;G;4744001;0;1;-1
202011;352590;G;4781400;1;0;1
202011;352590;G;4752100;2;2;0
202011;352590;G;4781400;5;0;5
202011;352590;G;4773300;1;1;0
202011;352590;G;4530703;1;0;1
202011;352590;G;4781400;0;1;-1
202011;352590;G;4721104;1;0;1
202011;352590;G;4752100;2;0;2
202011;352590;G;4782201;1;0;1
202011;352590;G;4731800;2;1;1
202011;352590;G;4763602;4;2;2
202011;352590;G;4785799;1;1;0
202011;352590;G;4781400;1;2;-1
202011;352590;G;4511102;1;0;1
202011;352590;G;4753900;1;0;1
202011;352590;G;4781400;3;0;3
202011;352590;G;4669999;3;6;-3
202011;352590;G;4669999;2;0;2
202011;352590;G;4729602;1;0;1
202011;352590;G;4772500;2;1;1
202011;352590;G;4782201;1;0;1
202011;352590;G;4771701;0;1;-1
202011;352590;G;4763602;1;1;0
202011;352590;G;4771701;1;0;1
202011;352590;G;4774100;0;1;-1
202011;352590;G;4713002;0;1;-1
202011;352590;G;4774100;2;0;2
202011;352590;G;4774100;2;0;2
202011;352590;G;4781400;3;0;3
202011;352590;G;4721102;0;1;-1
202011;352590;G;4731800;2;0;2
202011;352590;G;4723700;2;0;2
202011;352590;G;4633801;3;0;3
202011;352590;G;4772500;2;0;2
202011;352590;G;4712100;0;1;-1
202011;352590;G;4781400;1;0;1
202011;352590;G;4713002;1;0;1
202011;352590;G;4520007;0;1;-1
202011;352590;G;4723700;3;4;-1
202011;352590;G;4761003;1;0;1
202011;352590;G;4781400;3;0;3
202011;352590;G;4520001;0;1;-1
202011;352590;G;4721104;0;1;-1
202011;352590;G;4771701;2;0;2
202011;352590;G;4771701;1;0;1
202011;352590;G;4723700;0;1;-1
202011;352590;G;4744001;3;1;2
202011;352590;G;4781400;0;1;-1
202011;352590;G;4789099;1;0;1
202011;352590;G;4789001;0;1;-1
202011;352590;G;4721104;1;0;1
202011;352590;G;4752100;1;0;1
202011;352590;G;4763601;0;2;-2
202011;352590;G;4729602;0;2;-2
202011;352590;G;4744005;5;0;5
202011;352590;G;4781400;2;2;0
202011;352590;G;4783101;1;0;1
202011;352590;G;4744001;1;0;1
202011;352590;G;4686902;5;0;5
202011;352590;G;4530703;1;1;0
202011;352590;G;4781400;1;0;1
202011;352590;G;4782201;4;0;4
202011;352590;G;4761001;2;0;2
202011;352590;G;4637106;2;0;2
202011;352590;G;4781400;0;1;-1
202011;352590;G;4789099;0;1;-1
202011;352590;G;4781400;3;0;3
202011;352590;G;4729699;4;0;4
202011;352590;G;4755501;2;0;2
202011;352590;G;4771701;1;0;1
202011;352590;G;4721104;0;1;-1
202011;352590;G;4753900;5;1;4
202011;352590;G;4753900;1;1;0
202011;352590;G;4744005;2;2;0
202011;352590;G;4755502;0;1;-1
202011;352590;G;4781400;9;7;2
202011;352590;G;4781400;8;4;4
202011;352590;G;4782201;3;2;1
202011;352590;G;4782201;4;0;4
202011;352590;G;4782201;1;1;0
202011;352590;G;4782201;0;5;-5
202011;352590;G;4782201;1;1;0
202011;352590;G;4711301;13;15;-2
202011;352590;G;4731800;2;2;0
202011;352590;G;4771701;0;1;-1
202011;352590;G;4672900;0;1;-1
202011;352590;G;4713002;1;0;1
202011;352590;G;4781400;4;1;3
202011;352590;G;4646001;1;0;1
202011;352590;G;4744002;3;0;3
202011;352590;G;4639701;2;1;1
202011;352590;G;4754701;1;0;1
202011;352590;G;4781400;2;0;2
202011;352590;G;4781400;6;1;5
202011;352590;G;4711302;1;2;-1
202011;352590;G;4711302;0;2;-2
202011;352590;G;4789002;1;2;-1
202011;352590;G;4713001;4;0;4
202011;352590;G;4713001;4;1;3
202011;352590;G;4530703;1;0;1
202011;352590;G;4774100;1;0;1
202011;352590;G;4774100;1;0;1
202011;352590;G;4731800;2;0;2
202011;352590;G;4784900;1;0;1
202011;352590;G;4731800;1;0;1
202011;352590;G;4781400;3;1;2
202011;352590;G;4789099;0;1;-1
202011;352590;G;4530703;1;0;1
202011;352590;G;4755503;1;0;1
202011;352590;G;4711302;2;0;2
202011;352590;G;4731800;1;0;1
202011;352590;G;4783101;1;0;1
202011;352590;G;4744099;0;1;-1
202011;352590;G;4530703;1;1;0
202011;352590;G;4731800;0;1;-1
202011;352590;G;4511101;1;1;0
202011;352590;G;4721102;1;0;1
202011;352590;G;4689399;3;1;2
202011;352590;G;4729699;0;2;-2
202011;352590;G;4672900;0;3;-3
202011;352590;G;4711302;6;0;6
202011;352590;G;4711302;21;1;20
202011;352590;G;4711302;4;3;1
202011;352590;G;4711302;4;11;-7
202011;352590;G;4711302;9;8;1
202011;352590;G;4711302;2;2;0
202011;352590;G;4711302;19;11;8
202011;352590;G;4711302;4;3;1
202011;352590;G;4711302;10;12;-2
202011;352590;G;4711302;5;4;1
202011;352590;G;4711302;1;1;0
202011;352590;G;4711302;3;4;-1
202011;352590;G;4711302;5;4;1
202011;352590;G;4711302;11;8;3
202011;352590;G;4511101;4;7;-3
202011;352590;G;4721102;2;0;2
202011;352590;G;4711302;1;9;-8
202011;352590;G;4711302;2;0;2
202011;352590;G;4711302;3;3;0
202011;352590;G;4711302;4;2;2
202011;352590;G;4711302;2;1;1
202011;352590;G;4633801;0;2;-2
202011;352590;G;4771701;1;0;1
202011;352590;G;4789099;1;0;1
202011;352590;G;4541203;2;0;2
202011;352590;G;4744099;0;1;-1
202011;352590;G;4647801;3;2;1
202011;352590;G;4771701;0;1;-1
202011;352590;G;4661300;10;4;6
202011;352590;G;4639701;4;1;3
202011;352590;G;4744099;2;0;2
202011;352590;G;4782201;3;0;3
202011;352590;G;4782201;8;2;6
202011;352590;G;4771702;8;3;5
202011;352590;G;4744001;1;0;1
202011;352590;G;4530703;1;0;1
202011;352590;G;4530701;0;1;-1
202011;352590;G;4530701;3;0;3
202011;352590;G;4721102;2;1;1
202011;352590;G;4789004;1;1;0
202011;352590;G;4669999;0;1;-1
202011;352590;G;4789004;1;1;0
202011;352590;G;4663000;0;1;-1
202011;352590;G;4663000;1;0;1
202011;352590;G;4771703;0;1;-1
202011;352590;G;4712100;0;1;-1
202011;352590;G;4781400;0;3;-3
202011;352590;G;4520001;1;0;1
202011;352590;G;4520001;1;1;0
202011;352590;G;4712100;0;2;-2
202011;352590;G;4712100;2;1;1
202011;352590;G;4530703;0;1;-1
202011;352590;G;4511101;3;0;3
202011;352590;G;4687702;0;1;-1
202011;352590;G;4761001;0;1;-1
202011;352590;G;4781400;1;0;1
202011;352590;G;4731800;1;1;0
202011;352590;G;4712100;0;1;-1
202011;352590;G;4649499;2;0;2
202011;352590;G;4661300;3;1;2
202011;352590;G;4763604;1;0;1
202011;352590;G;4721102;1;1;0
202011;352590;G;4753900;0;2;-2
202011;352590;G;4753900;2;1;1
202011;352590;G;4744005;1;1;0
202011;352590;G;4761003;1;0;1
202011;352590;G;4731800;1;0;1
202011;352590;G;4783101;1;0;1
202011;352590;G;4774100;1;1;0
202011;352590;G;4530703;0;1;-1
202011;352590;G;4781400;2;0;2
202011;352590;G;4781400;0;1;-1
202011;352590;G;4761003;1;1;0
202011;352590;G;4763601;1;0;1
202011;352590;G;4635402;8;10;-2
202011;352590;G;4744099;0;1;-1
202011;352590;G;4721102;1;0;1
202011;352590;G;4751201;0;1;-1
202011;352590;G;4755502;1;1;0
202011;352590;G;4741500;1;1;0
202011;352590;G;4530703;0;1;-1
202011;352590;G;4530701;1;0;1
202011;352590;G;4744005;0;1;-1
202011;352590;G;4511104;2;1;1
202011;352590;G;4633802;0;1;-1
202011;352590;G;4713001;5;1;4
202011;352590;G;4713004;7;4;3
202011;352590;G;4646001;0;1;-1
202011;352590;G;4635402;3;2;1
202011;352590;G;4781400;2;3;-1
202011;352590;G;4711302;6;7;-1
202011;352590;G;4771701;1;0;1
202011;352590;G;4771701;1;0;1
202011;352590;G;4771701;1;1;0
202011;352590;G;4771701;0;1;-1
202011;352590;G;4771701;1;0;1
202011;352590;G;4645101;1;0;1
202011;352590;G;4771701;2;1;1
202011;352590;G;4771701;2;0;2
202011;352590;G;4771701;0;2;-2
202011;352590;G;4771701;1;0;1
202011;352590;G;4771701;1;0;1
202011;352590;G;4771701;0;1;-1
202011;352590;G;4771701;2;1;1
202011;352590;G;4771701;0;1;-1
202011;352590;G;4771701;1;0;1
202011;352590;G;4771701;0;1;-1
202011;352590;G;4771701;2;0;2
202011;352590;G;4635402;2;3;-1
202011;352590;G;4782202;1;1;0
202011;352590;G;4782202;2;1;1
202011;352590;G;4633801;0;1;-1
202011;352590;G;4789002;9;5;4
202011;352590;G;4744099;4;2;2
202011;352590;G;4530701;1;1;0
202011;352590;G;4771701;2;0;2
202011;352590;G;4731800;1;1;0
202011;352590;G;4789099;3;0;3
202011;352590;G;4752100;0;1;-1
202011;352590;G;4789099;1;0;1
202011;352590;G;4711302;41;32;9
202011;352590;G;4783101;0;1;-1
202011;352590;G;4771702;1;0;1
202011;352590;G;4684201;1;0;1
202011;352590;G;4773300;1;0;1
202011;352590;G;4771701;1;3;-2
202011;352590;G;4771701;0;1;-1
202011;352590;G;4771701;1;0;1
202011;352590;G;4771701;0;1;-1
202011;352590;G;4744005;2;2;0
202011;352590;G;4722901;3;2;1
202011;352590;G;4729699;8;2;6
202011;352590;G;4637199;1;0;1
202011;352590;G;4530703;0;1;-1
202011;352590;G;4744005;2;0;2
202011;352590;G;4623199;2;0;2
202011;352590;G;4530703;1;0;1
202011;352590;G;4763601;2;0;2
202011;352590;G;4530703;0;1;-1
202011;352590;G;4712100;1;0;1
202011;352590;G;4712100;0;1;-1
202011;352590;G;4712100;0;4;-4
202011;352590;G;4771702;2;1;1
202011;352590;G;4511101;0;1;-1
202011;352590;G;4771701;0;1;-1
202011;352590;G;4741500;1;1;0
202011;352590;G;4741500;1;2;-1
202011;352590;G;4741500;1;0;1
202011;352590;G;4741500;1;2;-1
202011;352590;G;4741500;4;1;3
202011;352590;G;4744002;1;0;1
202011;352590;G;4530703;0;1;-1
202011;352590;G;4774100;1;0;1
202011;352590;G;4731800;1;0;1
202011;352590;G;4692300;1;3;-2
202011;352590;G;4692300;2;0;2
202011;352590;G;4520005;16;1;15
202011;352590;G;4781400;2;0;2
202011;352590;G;4635402;1;3;-2
202011;352590;G;4711302;1;1;0
202011;352590;G;4729699;0;1;-1
202011;352590;G;4721102;2;0;2
202011;352590;G;4711301;9;16;-7
202011;352590;G;4672900;1;4;-3
202011;352590;G;4757100;0;2;-2
202011;352590;G;4781400;1;1;0
202011;352590;G;4530703;4;4;0
202011;352590;G;4711301;10;6;4
202011;352590;G;4645101;1;0;1
202011;352590;G;4639701;0;2;-2
202011;352590;G;4679604;12;12;0
202011;352590;G;4541201;0;1;-1
202011;352590;G;4783101;1;0;1
202011;352590;G;4661300;0;3;-3
202011;352590;G;4744001;3;2;1
202011;352590;G;4781400;1;1;0
202011;352590;G;4781400;2;1;1
202011;352590;G;4759801;0;2;-2
202011;352590;G;4771702;1;0;1
202011;352590;G;4752100;2;0;2
